filename,box_topleft_x,box_topleft_y,box_width,box_height,image_width,image_height,box_bottomright_x,box_bottomright_y,max_box_dim,file_path,face_number,face_img
Image_10.jpg,3232,777,874,848,5616,2633,4106,1625,874,daskShared_local/images/Image_10.jpg,10,"[array([[[  0, 196, 244],
        [  0, 196, 244],
        [  0, 197, 245],
        ...,
        [  0, 208, 255],
        [  1, 208, 255],
        [  1, 208, 255]],

       [[  0, 196, 244],
        [  0, 196, 244],
        [  0, 197, 245],
        ...,
        [  0, 208, 255],
        [  0, 208, 255],
        [  0, 208, 255]],

       [[  0, 195, 243],
        [  0, 195, 243],
        [  0, 196, 244],
        ...,
        [  0, 208, 255],
        [  0, 208, 255],
        [  0, 209, 255]],

       ...,

       [[  0, 133, 180],
        [  1, 133, 181],
        [  1, 133, 181],
        ...,
        [181, 140, 122],
        [198, 135, 110],
        [223, 157, 134]],

       [[  0, 135, 179],
        [  1, 134, 181],
        [  1, 134, 181],
        ...,
        [148, 103,  84],
        [181, 118,  96],
        [204, 139, 120]],

       [[  0, 136, 179],
        [  0, 135, 180],
        [  0, 133, 179],
        ...,
        [146,  96,  72],
        [167, 103,  81],
        [184, 121,  98]]], dtype=uint8)]"
Image_100.jpg,283,136,158,120,800,505,441,256,158,daskShared_local/images/Image_100.jpg,100,"[array([[[ 52,  68,  65],
        [ 49,  66,  61],
        [ 48,  68,  61],
        ...,
        [  1,  17,  32],
        [  1,  16,  31],
        [  3,  19,  32]],

       [[ 52,  68,  66],
        [ 49,  67,  63],
        [ 49,  72,  65],
        ...,
        [  4,  20,  35],
        [  1,  16,  32],
        [  2,  19,  33]],

       [[ 45,  63,  62],
        [ 46,  68,  64],
        [ 53,  80,  73],
        ...,
        [ 12,  28,  44],
        [  4,  21,  36],
        [  6,  24,  38]],

       ...,

       [[129, 121,  84],
        [125, 117,  81],
        [118, 111,  77],
        ...,
        [ 95,  89,  69],
        [127, 119,  98],
        [155, 146, 124]],

       [[116, 109,  72],
        [115, 109,  73],
        [114, 109,  75],
        ...,
        [125, 118,  97],
        [173, 163, 141],
        [183, 171, 149]],

       [[104,  99,  61],
        [107, 102,  66],
        [111, 107,  73],
        ...,
        [152, 144, 122],
        [213, 202, 179],
        [222, 208, 185]]], dtype=uint8)]"
Image_1000.jpg,228,184,156,160,500,559,384,344,160,daskShared_local/images/Image_1000.jpg,1000,"[array([[[ 78, 180, 182],
        [ 77, 180, 181],
        [ 76, 180, 181],
        ...,
        [123, 216, 206],
        [129, 214, 209],
        [129, 214, 207]],

       [[ 79, 181, 183],
        [ 78, 181, 183],
        [ 77, 181, 182],
        ...,
        [123, 218, 207],
        [127, 217, 210],
        [127, 216, 208]],

       [[ 78, 180, 182],
        [ 77, 180, 182],
        [ 76, 180, 181],
        ...,
        [122, 217, 206],
        [123, 218, 208],
        [123, 217, 206]],

       ...,

       [[103,  91,  37],
        [127, 115,  52],
        [135, 123,  41],
        ...,
        [124, 116,  63],
        [155, 144,  69],
        [132, 120,  41]],

       [[ 88,  78,  14],
        [106,  96,  34],
        [114, 104,  37],
        ...,
        [130, 129,  57],
        [138, 133,  52],
        [ 95,  88,   8]],

       [[118, 109,  34],
        [100,  90,  25],
        [ 79,  69,  13],
        ...,
        [124, 126,  40],
        [119, 117,  35],
        [ 92,  87,   8]]], dtype=uint8)]"
Image_1001.jpg,1721,517,1552,1636,4631,3087,3273,2153,1636,daskShared_local/images/Image_1001.jpg,1001,"[array([[[ 20,  94, 240],
        [ 20,  94, 240],
        [ 20,  94, 240],
        ...,
        [  0,  58, 193],
        [  0,  58, 193],
        [  0,  57, 192]],

       [[ 21,  93, 240],
        [ 21,  93, 240],
        [ 20,  93, 240],
        ...,
        [  0,  58, 192],
        [  0,  57, 192],
        [  0,  56, 191]],

       [[ 21,  93, 240],
        [ 21,  92, 240],
        [ 21,  92, 240],
        ...,
        [  0,  58, 191],
        [  0,  57, 191],
        [  0,  57, 190]],

       ...,

       [[108, 111,  85],
        [103,  93,  58],
        [ 82,  65,  41],
        ...,
        [ 44,  54,  30],
        [ 44,  52,  29],
        [ 47,  54,  32]],

       [[100, 102,  88],
        [102, 103,  69],
        [ 88,  74,  45],
        ...,
        [ 41,  50,  29],
        [ 42,  48,  27],
        [ 53,  62,  35]],

       [[ 97,  93,  78],
        [ 93,  97,  74],
        [ 90,  80,  51],
        ...,
        [ 34,  42,  24],
        [ 34,  42,  24],
        [ 54,  64,  35]]], dtype=uint8)]"
Image_1002.jpg,517,239,340,224,1200,900,857,463,340,daskShared_local/images/Image_1002.jpg,1002,"[array([[[ 59, 179, 196],
        [ 50, 177, 196],
        [ 36, 173, 187],
        ...,
        [110, 196, 207],
        [ 92, 190, 206],
        [ 91, 190, 208]],

       [[ 54, 178, 191],
        [ 49, 175, 187],
        [ 39, 172, 187],
        ...,
        [ 76, 185, 198],
        [ 99, 193, 213],
        [ 90, 190, 208]],

       [[ 67, 179, 192],
        [ 49, 171, 185],
        [ 53, 173, 188],
        ...,
        [ 78, 186, 210],
        [ 84, 187, 212],
        [ 87, 189, 212]],

       ...,

       [[225, 240, 241],
        [221, 240, 241],
        [194, 227, 230],
        ...,
        [175, 220, 232],
        [152, 210, 225],
        [139, 206, 221]],

       [[229, 242, 246],
        [226, 241, 244],
        [199, 229, 234],
        ...,
        [160, 212, 225],
        [156, 209, 227],
        [144, 207, 223]],

       [[224, 240, 241],
        [219, 238, 242],
        [219, 237, 243],
        ...,
        [165, 214, 228],
        [156, 210, 225],
        [153, 208, 225]]], dtype=uint8)]"
Image_1003.jpg,672,652,427,282,2793,2090,1099,934,427,daskShared_local/images/Image_1003.jpg,1003,"[array([[[  5,  69, 195],
        [  5,  69, 195],
        [  5,  69, 195],
        ...,
        [  5,  69, 192],
        [  4,  68, 191],
        [  3,  67, 190]],

       [[  5,  69, 195],
        [  5,  69, 195],
        [  5,  69, 195],
        ...,
        [  5,  69, 192],
        [  4,  68, 191],
        [  3,  67, 190]],

       [[  5,  69, 195],
        [  5,  69, 195],
        [  5,  69, 195],
        ...,
        [  3,  67, 190],
        [  3,  67, 190],
        [  3,  67, 190]],

       ...,

       [[  3,  50, 154],
        [  3,  50, 154],
        [  3,  50, 154],
        ...,
        [194, 203, 162],
        [188, 201, 165],
        [154, 172, 141]],

       [[  3,  50, 154],
        [  3,  50, 154],
        [  3,  50, 154],
        ...,
        [190, 198, 157],
        [173, 185, 148],
        [183, 201, 170]],

       [[  3,  50, 154],
        [  3,  50, 154],
        [  3,  50, 154],
        ...,
        [189, 197, 158],
        [150, 161, 124],
        [180, 197, 166]]], dtype=uint8)]"
Image_1004.jpg,645,116,211,187,1156,650,856,303,211,daskShared_local/images/Image_1004.jpg,1004,"[array([[[ 13, 148, 167],
        [  1, 143, 157],
        [ 10, 153, 166],
        ...,
        [ 37, 148, 166],
        [ 65, 177, 189],
        [ 51, 164, 172]],

       [[ 16, 146, 166],
        [  4, 139, 156],
        [  5, 142, 158],
        ...,
        [ 43, 154, 174],
        [ 47, 157, 173],
        [ 66, 173, 186]],

       [[ 17, 136, 158],
        [ 13, 137, 155],
        [ 12, 139, 155],
        ...,
        [ 38, 152, 175],
        [ 40, 146, 167],
        [ 59, 158, 177]],

       ...,

       [[ 85,  91,  65],
        [118, 118,  92],
        [ 96,  96,  69],
        ...,
        [  0, 132, 177],
        [  0, 132, 176],
        [  0, 132, 176]],

       [[ 44,  48,  32],
        [ 72,  70,  54],
        [ 75,  70,  54],
        ...,
        [  0, 131, 177],
        [  0, 131, 175],
        [  0, 131, 175]],

       [[ 10,  11,   6],
        [ 22,  19,  13],
        [ 37,  31,  24],
        ...,
        [  3, 129, 177],
        [  3, 130, 175],
        [  3, 130, 175]]], dtype=uint8)]"
Image_1005.jpg,335,132,270,217,845,563,605,349,270,daskShared_local/images/Image_1005.jpg,1005,"[array([[[ 82, 195, 199],
        [105, 200, 202],
        [115, 209, 213],
        ...,
        [ 78, 193, 190],
        [ 74, 191, 188],
        [ 69, 189, 187]],

       [[ 96, 192, 201],
        [111, 201, 203],
        [119, 206, 209],
        ...,
        [ 77, 192, 188],
        [ 73, 190, 186],
        [ 70, 189, 185]],

       [[115, 195, 206],
        [119, 204, 207],
        [120, 203, 207],
        ...,
        [ 80, 195, 190],
        [ 76, 192, 187],
        [ 75, 192, 186]],

       ...,

       [[ 54,  77,  23],
        [ 54,  84,  24],
        [ 68,  98,  38],
        ...,
        [ 44, 200, 189],
        [ 49, 201, 190],
        [ 55, 202, 191]],

       [[ 60,  90,  27],
        [ 55,  87,  27],
        [ 69, 102,  41],
        ...,
        [ 43, 200, 189],
        [ 51, 202, 191],
        [ 58, 203, 193]],

       [[ 57, 102,  25],
        [ 56,  94,  31],
        [ 58,  97,  35],
        ...,
        [ 40, 199, 189],
        [ 50, 202, 193],
        [ 59, 204, 195]]], dtype=uint8)]"
Image_1006.jpg,349,91,163,208,728,486,512,299,208,daskShared_local/images/Image_1006.jpg,1006,"[array([[[  1,  66, 254],
        [  1,  64, 253],
        [  1,  64, 255],
        ...,
        [  0, 114, 255],
        [  0, 111, 253],
        [  1, 114, 255]],

       [[  1,  66, 254],
        [  1,  64, 253],
        [  1,  69, 253],
        ...,
        [  1, 112, 254],
        [  1, 114, 254],
        [  2, 113, 255]],

       [[  0,  63, 254],
        [  0,  63, 253],
        [  0,  67, 254],
        ...,
        [  1, 110, 253],
        [  2, 113, 254],
        [  1, 112, 254]],

       ...,

       [[135,  90,  50],
        [156, 107,  74],
        [211, 160, 128],
        ...,
        [171, 175, 175],
        [227, 224, 213],
        [221, 204, 181]],

       [[119,  82,  52],
        [180, 128,  96],
        [217, 175, 147],
        ...,
        [118, 119, 110],
        [217, 215, 201],
        [203, 187, 164]],

       [[130,  85,  62],
        [205, 160, 138],
        [220, 187, 172],
        ...,
        [123, 124, 109],
        [216, 209, 189],
        [203, 188, 167]]], dtype=uint8)]"
Image_1007.png,390,186,309,277,900,600,699,463,309,daskShared_local/images/Image_1007.png,1007,"[array([[[112, 128, 140],
        [133, 137, 145],
        [144, 144, 150],
        ...,
        [ 18, 151, 182],
        [ 13, 151, 185],
        [ 21, 148, 180]],

       [[141, 140, 135],
        [136, 135, 135],
        [146, 141, 141],
        ...,
        [ 32, 150, 181],
        [ 20, 154, 180],
        [ 20, 149, 181]],

       [[121, 113, 112],
        [132, 124, 126],
        [133, 136, 142],
        ...,
        [ 19, 151, 179],
        [ 25, 151, 180],
        [ 23, 153, 186]],

       ...,

       [[ 66, 116,  74],
        [ 67, 117,  72],
        [ 70, 118,  79],
        ...,
        [ 83, 158, 136],
        [ 85, 160, 144],
        [ 93, 162, 148]],

       [[ 71, 123,  75],
        [ 67, 120,  79],
        [ 66, 115,  85],
        ...,
        [ 80, 157, 137],
        [ 84, 154, 139],
        [ 90, 159, 146]],

       [[ 40, 105,  95],
        [ 42,  92,  87],
        [ 25,  77,  79],
        ...,
        [ 81, 152, 139],
        [ 81, 148, 138],
        [ 87, 152, 137]]], dtype=uint8)]"
Image_1008.jpg,277,163,182,173,800,533,459,336,182,daskShared_local/images/Image_1008.jpg,1008,"[array([[[253, 253, 250],
        [254, 253, 252],
        [253, 254, 252],
        ...,
        [ 51,  57,  71],
        [ 63,  68,  82],
        [ 79,  85,  99]],

       [[253, 245, 218],
        [250, 244, 216],
        [248, 244, 216],
        ...,
        [ 56,  57,  66],
        [ 65,  66,  76],
        [ 80,  81,  91]],

       [[219, 207, 175],
        [217, 206, 174],
        [217, 207, 175],
        ...,
        [ 72,  72,  80],
        [ 51,  51,  61],
        [ 53,  53,  63]],

       ...,

       [[114,  78,  62],
        [132,  96,  80],
        [155, 119, 103],
        ...,
        [103,  89,  80],
        [107,  93,  84],
        [106,  92,  83]],

       [[113,  78,  58],
        [133,  98,  79],
        [167, 132, 113],
        ...,
        [107,  93,  84],
        [108,  94,  85],
        [106,  92,  83]],

       [[144, 109,  89],
        [155, 120, 100],
        [179, 144, 124],
        ...,
        [124, 110, 101],
        [117, 103,  94],
        [107,  93,  84]]], dtype=uint8)]"
Image_1009.jpg,311,210,193,198,1000,600,504,408,198,daskShared_local/images/Image_1009.jpg,1009,"[array([[[  1, 146, 193],
        [  1, 146, 193],
        [  1, 146, 193],
        ...,
        [  1, 158, 201],
        [  1, 158, 201],
        [  1, 158, 201]],

       [[  1, 146, 193],
        [  1, 146, 193],
        [  1, 146, 193],
        ...,
        [  1, 158, 201],
        [  1, 158, 201],
        [  1, 158, 201]],

       [[  1, 146, 193],
        [  1, 146, 193],
        [  1, 146, 193],
        ...,
        [  1, 158, 201],
        [  1, 158, 201],
        [  1, 158, 201]],

       ...,

       [[204, 176,  69],
        [183, 156,  51],
        [135, 110,   9],
        ...,
        [243, 213, 140],
        [247, 217, 145],
        [251, 221, 151]],

       [[236, 201, 107],
        [227, 192,  90],
        [200, 163,  57],
        ...,
        [248, 221, 150],
        [250, 223, 154],
        [252, 224, 159]],

       [[231, 192, 117],
        [224, 179,  94],
        [226, 181,  88],
        ...,
        [249, 224, 157],
        [250, 225, 159],
        [250, 225, 161]]], dtype=uint8)]"
Image_101.jpg,429,216,123,170,900,600,552,386,170,daskShared_local/images/Image_101.jpg,101,"[array([[[  5, 109, 164],
        [  4, 108, 163],
        [  4, 108, 163],
        ...,
        [  5, 119, 171],
        [  5, 119, 171],
        [  5, 119, 171]],

       [[  5, 109, 164],
        [  4, 108, 163],
        [  4, 108, 163],
        ...,
        [  4, 118, 170],
        [  5, 119, 171],
        [  5, 119, 171]],

       [[  5, 109, 164],
        [  4, 108, 163],
        [  4, 108, 163],
        ...,
        [  4, 118, 170],
        [  4, 118, 170],
        [  5, 119, 171]],

       ...,

       [[ 73,  68,  31],
        [ 68,  64,  30],
        [ 78,  74,  42],
        ...,
        [  5,  92, 143],
        [  5,  92, 144],
        [  5,  92, 144]],

       [[ 75,  67,  42],
        [ 70,  62,  39],
        [ 70,  62,  40],
        ...,
        [  3,  93, 147],
        [  3,  92, 150],
        [  3,  92, 150]],

       [[ 96,  88,  53],
        [ 78,  69,  38],
        [ 63,  55,  26],
        ...,
        [  3,  93, 146],
        [  3,  92, 149],
        [  3,  92, 150]]], dtype=uint8)]"
Image_1010.jpg,423,144,250,263,1200,822,673,407,263,daskShared_local/images/Image_1010.jpg,1010,"[array([[[  4, 149, 176],
        [  2, 146, 173],
        [  0, 143, 170],
        ...,
        [  1, 160, 189],
        [  1, 161, 189],
        [  0, 161, 189]],

       [[  2, 147, 174],
        [  0, 145, 172],
        [  0, 144, 171],
        ...,
        [  2, 161, 190],
        [  1, 161, 190],
        [  1, 162, 190]],

       [[  0, 144, 171],
        [  0, 144, 171],
        [  0, 145, 172],
        ...,
        [  1, 160, 189],
        [  0, 160, 188],
        [  0, 159, 187]],

       ...,

       [[ 87, 107,  51],
        [ 76,  93,  44],
        [ 69,  84,  44],
        ...,
        [188, 164, 110],
        [200, 170, 119],
        [197, 159, 104]],

       [[ 93, 109,  52],
        [ 80,  96,  46],
        [ 67,  83,  41],
        ...,
        [131, 111,  55],
        [125,  98,  48],
        [125,  89,  39]],

       [[ 94, 110,  50],
        [ 86, 101,  49],
        [ 70,  87,  42],
        ...,
        [ 94,  77,  28],
        [ 86,  65,  24],
        [ 95,  67,  27]]], dtype=uint8)]"
Image_1011.jpg,34,71,243,200,800,600,277,271,243,daskShared_local/images/Image_1011.jpg,1011,"[array([[[  0, 150, 203],
        [  5, 155, 207],
        [  5, 155, 205],
        ...,
        [ 17, 177, 225],
        [ 20, 177, 225],
        [ 20, 176, 227]],

       [[  2, 151, 207],
        [  7, 158, 209],
        [ 12, 163, 211],
        ...,
        [ 14, 175, 221],
        [ 19, 178, 225],
        [ 21, 179, 227]],

       [[  3, 153, 207],
        [  5, 157, 206],
        [ 15, 166, 213],
        ...,
        [ 19, 177, 223],
        [ 21, 179, 224],
        [ 22, 180, 227]],

       ...,

       [[ 74, 140, 110],
        [ 69, 137, 103],
        [ 66, 136, 100],
        ...,
        [ 83,  42,  32],
        [ 77,  37,  29],
        [ 75,  36,  26]],

       [[ 72, 136, 108],
        [ 67, 134, 101],
        [ 62, 132,  97],
        ...,
        [ 61,  12,   6],
        [ 55,   6,   1],
        [ 58,  10,   4]],

       [[ 67, 128, 102],
        [ 68, 133, 102],
        [ 63, 130,  97],
        ...,
        [ 71,  13,  10],
        [ 61,   6,   2],
        [ 59,   6,   0]]], dtype=uint8)]"
Image_1012.jpg,965,124,286,382,1686,1216,1251,506,382,daskShared_local/images/Image_1012.jpg,1012,"[array([[[122, 181, 213],
        [123, 182, 214],
        [124, 183, 215],
        ...,
        [164, 201, 227],
        [163, 202, 228],
        [163, 203, 229]],

       [[122, 182, 214],
        [123, 182, 214],
        [124, 183, 215],
        ...,
        [164, 201, 227],
        [163, 202, 228],
        [163, 203, 229]],

       [[120, 181, 212],
        [120, 181, 212],
        [121, 181, 213],
        ...,
        [164, 203, 229],
        [163, 203, 228],
        [163, 203, 228]],

       ...,

       [[211, 223, 208],
        [210, 223, 209],
        [213, 225, 212],
        ...,
        [ 78, 162, 199],
        [ 78, 162, 199],
        [ 76, 160, 197]],

       [[209, 218, 204],
        [212, 224, 210],
        [212, 224, 212],
        ...,
        [ 77, 161, 198],
        [ 76, 161, 198],
        [ 77, 161, 198]],

       [[199, 206, 193],
        [196, 206, 194],
        [203, 214, 205],
        ...,
        [ 76, 161, 198],
        [ 74, 159, 197],
        [ 75, 160, 198]]], dtype=uint8)]"
Image_1013.jpg,688,249,471,532,1920,1080,1159,781,532,daskShared_local/images/Image_1013.jpg,1013,"[array([[[  1, 120, 202],
        [  1, 120, 202],
        [  1, 120, 202],
        ...,
        [  1, 117, 202],
        [  1, 117, 202],
        [  1, 117, 202]],

       [[  1, 120, 202],
        [  1, 120, 202],
        [  1, 120, 202],
        ...,
        [  1, 117, 202],
        [  1, 117, 202],
        [  1, 117, 202]],

       [[  1, 120, 202],
        [  1, 120, 202],
        [  1, 120, 202],
        ...,
        [  1, 116, 201],
        [  1, 117, 201],
        [  1, 117, 201]],

       ...,

       [[ 55,  70,  55],
        [ 78,  98,  77],
        [122, 145, 122],
        ...,
        [156, 142, 111],
        [152, 138, 103],
        [149, 138,  97]],

       [[ 75,  92,  77],
        [ 90, 108,  86],
        [111, 129, 103],
        ...,
        [177, 165, 131],
        [178, 165, 131],
        [165, 153, 119]],

       [[102, 119,  99],
        [111, 123,  99],
        [133, 143, 114],
        ...,
        [193, 185, 148],
        [194, 186, 150],
        [192, 183, 151]]], dtype=uint8)]"
Image_1014.jpg,253,368,854,681,1512,1231,1107,1049,854,daskShared_local/images/Image_1014.jpg,1014,"[array([[[ 78,  88,  80],
        [ 75,  86,  78],
        [ 74,  85,  77],
        ...,
        [ 77, 114,  80],
        [ 77, 111,  79],
        [ 76, 108,  79]],

       [[ 77,  86,  78],
        [ 74,  84,  76],
        [ 74,  84,  76],
        ...,
        [ 82, 119,  83],
        [ 78, 111,  78],
        [ 76, 107,  79]],

       [[ 75,  85,  76],
        [ 73,  85,  76],
        [ 75,  87,  78],
        ...,
        [ 85, 121,  86],
        [ 81, 114,  81],
        [ 78, 109,  80]],

       ...,

       [[255, 238, 215],
        [254, 238, 216],
        [255, 240, 215],
        ...,
        [228, 197, 155],
        [236, 210, 168],
        [230, 205, 166]],

       [[254, 236, 213],
        [254, 237, 216],
        [254, 238, 215],
        ...,
        [239, 216, 181],
        [244, 224, 189],
        [238, 217, 181]],

       [[254, 235, 211],
        [254, 237, 212],
        [253, 236, 215],
        ...,
        [244, 223, 194],
        [241, 222, 192],
        [241, 226, 193]]], dtype=uint8)]"
Image_1015.jpg,411,160,832,655,1500,1000,1243,815,832,daskShared_local/images/Image_1015.jpg,1015,"[array([[[  4,  57,  65],
        [  3,  58,  65],
        [  3,  58,  65],
        ...,
        [170, 163, 174],
        [123, 120, 152],
        [105, 105, 145]],

       [[  4,  57,  65],
        [  3,  58,  65],
        [  3,  58,  65],
        ...,
        [142, 138, 161],
        [101, 103, 141],
        [ 89,  95, 138]],

       [[  4,  59,  64],
        [  3,  58,  65],
        [  2,  57,  65],
        ...,
        [117, 117, 148],
        [ 94,  98, 138],
        [ 78,  84, 130]],

       ...,

       [[ 94, 118, 162],
        [127, 147, 184],
        [181, 190, 204],
        ...,
        [ 60,  87,  58],
        [ 58,  88,  57],
        [ 58,  88,  57]],

       [[ 89, 112, 158],
        [106, 128, 174],
        [157, 171, 196],
        ...,
        [ 61,  87,  58],
        [ 60,  89,  59],
        [ 58,  89,  58]],

       [[ 88, 112, 157],
        [ 97, 124, 170],
        [138, 158, 191],
        ...,
        [ 63,  89,  59],
        [ 60,  88,  59],
        [ 58,  89,  57]]], dtype=uint8)]"
Image_1016.jpg,472,116,281,322,1600,1019,753,438,322,daskShared_local/images/Image_1016.jpg,1016,"[array([[[ 30, 107, 213],
        [ 30, 107, 213],
        [ 30, 107, 213],
        ...,
        [ 28, 116, 213],
        [ 28, 116, 213],
        [ 28, 116, 213]],

       [[ 30, 107, 213],
        [ 30, 107, 213],
        [ 30, 107, 213],
        ...,
        [ 28, 116, 213],
        [ 28, 116, 213],
        [ 28, 116, 213]],

       [[ 30, 107, 213],
        [ 30, 107, 213],
        [ 30, 107, 213],
        ...,
        [ 28, 116, 213],
        [ 28, 116, 213],
        [ 28, 116, 213]],

       ...,

       [[188, 191, 172],
        [215, 217, 203],
        [220, 222, 210],
        ...,
        [134, 149, 145],
        [159, 179, 173],
        [169, 188, 183]],

       [[217, 220, 201],
        [234, 237, 222],
        [230, 232, 220],
        ...,
        [147, 150, 147],
        [168, 178, 172],
        [151, 160, 154]],

       [[232, 235, 220],
        [236, 238, 225],
        [224, 226, 214],
        ...,
        [150, 137, 134],
        [185, 180, 174],
        [204, 198, 193]]], dtype=uint8)]"
Image_1017.jpg,458,283,160,167,850,567,618,450,167,daskShared_local/images/Image_1017.jpg,1017,"[array([[[202, 165, 135],
        [209, 162, 137],
        [167, 119, 102],
        ...,
        [ 40,  47,  67],
        [ 36,  41,  64],
        [ 48,  50,  65]],

       [[197, 153, 116],
        [190, 136, 110],
        [135,  83,  66],
        ...,
        [ 39,  44,  62],
        [ 44,  45,  64],
        [ 64,  60,  70]],

       [[190, 130, 102],
        [147,  83,  66],
        [122,  66,  52],
        ...,
        [ 43,  44,  60],
        [ 58,  51,  65],
        [ 89,  76,  77]],

       ...,

       [[  9, 124, 235],
        [ 10, 126, 237],
        [ 10, 126, 237],
        ...,
        [ 10, 128, 234],
        [ 10, 128, 234],
        [  9, 127, 233]],

       [[  9, 125, 236],
        [  9, 125, 236],
        [  9, 125, 236],
        ...,
        [ 11, 129, 235],
        [ 10, 128, 234],
        [  9, 127, 233]],

       [[ 10, 126, 237],
        [ 10, 126, 237],
        [ 10, 126, 237],
        ...,
        [ 10, 128, 234],
        [ 11, 129, 235],
        [ 10, 128, 234]]], dtype=uint8)]"
Image_1018.jpg,650,279,320,337,1600,1000,970,616,337,daskShared_local/images/Image_1018.jpg,1018,"[array([[[  1,  72, 164],
        [  0,  71, 163],
        [  0,  71, 163],
        ...,
        [  0,  68, 161],
        [  0,  69, 162],
        [  0,  69, 162]],

       [[  0,  71, 163],
        [  0,  71, 163],
        [  0,  71, 163],
        ...,
        [  1,  67, 161],
        [  2,  68, 162],
        [  2,  68, 162]],

       [[  0,  71, 162],
        [  0,  71, 163],
        [  0,  71, 163],
        ...,
        [  1,  68, 159],
        [  2,  69, 160],
        [  2,  69, 160]],

       ...,

       [[ 30,  36,  21],
        [ 44,  57,  38],
        [ 36,  52,  29],
        ...,
        [100,  85,  59],
        [ 94,  82,  39],
        [ 96,  83,  43]],

       [[ 25,  33,  20],
        [ 36,  50,  33],
        [ 27,  41,  25],
        ...,
        [132, 115,  86],
        [105,  89,  56],
        [100,  84,  50]],

       [[ 26,  34,  20],
        [ 28,  42,  25],
        [ 62,  77,  62],
        ...,
        [154, 138,  95],
        [144, 128,  94],
        [113,  97,  64]]], dtype=uint8)]"
Image_1019.jpg,2409,874,634,620,3840,2160,3043,1494,634,daskShared_local/images/Image_1019.jpg,1019,"[array([[[171, 148, 129],
        [162, 139, 121],
        [162, 140, 125],
        ...,
        [  1, 131, 176],
        [  1, 131, 175],
        [  1, 134, 177]],

       [[126, 104,  83],
        [120,  97,  78],
        [160, 139, 122],
        ...,
        [  1, 131, 177],
        [  0, 131, 177],
        [  2, 135, 178]],

       [[163, 141, 120],
        [184, 162, 141],
        [207, 186, 168],
        ...,
        [  1, 130, 178],
        [  0, 131, 178],
        [  1, 134, 178]],

       ...,

       [[  2, 140, 166],
        [  1, 139, 167],
        [  3, 137, 166],
        ...,
        [  0, 121, 166],
        [  0, 121, 166],
        [  2, 121, 164]],

       [[  1, 141, 166],
        [  0, 140, 167],
        [  2, 138, 167],
        ...,
        [  0, 121, 166],
        [  0, 121, 166],
        [  2, 121, 164]],

       [[  0, 143, 167],
        [  0, 143, 169],
        [  2, 141, 169],
        ...,
        [  0, 121, 166],
        [  0, 121, 166],
        [  2, 121, 163]]], dtype=uint8)]"
Image_102.jpg,738,162,264,194,1050,700,1002,356,264,daskShared_local/images/Image_102.jpg,102,"[array([[[  2, 144, 131],
        [ 24, 160, 151],
        [ 22, 144, 135],
        ...,
        [ 95, 102, 110],
        [ 36,  37,  53],
        [ 30,  36,  49]],

       [[  3, 143, 129],
        [ 16, 155, 140],
        [ 13, 143, 128],
        ...,
        [155, 183, 173],
        [ 43,  75,  85],
        [ 19,  37,  52]],

       [[ 10, 140, 119],
        [  2,  99,  88],
        [  4,  81,  77],
        ...,
        [ 71,  92,  96],
        [ 26,  47,  60],
        [ 22,  35,  47]],

       ...,

       [[ 32,  46,  49],
        [ 34,  48,  51],
        [ 33,  47,  50],
        ...,
        [155, 196, 196],
        [119, 166, 168],
        [ 82, 125, 121]],

       [[ 31,  45,  48],
        [ 32,  46,  49],
        [ 32,  46,  49],
        ...,
        [199, 231, 224],
        [162, 209, 208],
        [ 99, 155, 156]],

       [[ 28,  43,  46],
        [ 31,  46,  49],
        [ 31,  46,  49],
        ...,
        [205, 239, 228],
        [182, 245, 238],
        [124, 202, 204]]], dtype=uint8)]"
Image_1020.jpg,216,439,175,198,2015,1510,391,637,198,daskShared_local/images/Image_1020.jpg,1020,"[array([[[ 45,  42,  33],
        [ 44,  41,  32],
        [ 43,  40,  31],
        ...,
        [ 37,  32,  28],
        [ 31,  26,  22],
        [ 28,  23,  19]],

       [[ 66,  63,  56],
        [ 63,  60,  53],
        [ 61,  58,  51],
        ...,
        [ 45,  40,  36],
        [ 34,  29,  25],
        [ 22,  17,  13]],

       [[ 67,  64,  57],
        [ 57,  54,  47],
        [ 37,  34,  27],
        ...,
        [ 34,  29,  25],
        [ 25,  20,  16],
        [ 16,  11,   7]],

       ...,

       [[144, 142, 130],
        [127, 127, 115],
        [119, 119, 109],
        ...,
        [144, 148, 151],
        [140, 144, 147],
        [135, 139, 142]],

       [[133, 131, 119],
        [116, 116, 106],
        [116, 118, 107],
        ...,
        [137, 141, 142],
        [147, 151, 152],
        [151, 155, 156]],

       [[ 94,  94,  82],
        [ 86,  88,  77],
        [ 96,  98,  87],
        ...,
        [131, 136, 132],
        [141, 146, 142],
        [143, 148, 144]]], dtype=uint8)]"
Image_1021.jpg,903,447,644,547,3008,2000,1547,994,644,daskShared_local/images/Image_1021.jpg,1021,"[array([[[148, 187, 194],
        [148, 187, 194],
        [148, 187, 194],
        ...,
        [140, 182, 194],
        [140, 182, 194],
        [139, 181, 193]],

       [[148, 187, 194],
        [148, 187, 194],
        [148, 187, 194],
        ...,
        [140, 182, 194],
        [140, 182, 194],
        [140, 182, 194]],

       [[148, 187, 194],
        [148, 187, 194],
        [148, 187, 194],
        ...,
        [140, 182, 194],
        [140, 182, 194],
        [140, 182, 194]],

       ...,

       [[128, 181, 189],
        [125, 178, 186],
        [122, 175, 183],
        ...,
        [ 74,  87,  93],
        [ 78,  91,  97],
        [ 83,  96, 102]],

       [[127, 181, 189],
        [125, 178, 186],
        [122, 175, 183],
        ...,
        [ 79,  92,  98],
        [ 83,  96, 102],
        [ 85,  98, 104]],

       [[122, 180, 187],
        [120, 178, 184],
        [118, 175, 181],
        ...,
        [ 78,  89,  91],
        [ 81,  93,  96],
        [ 86,  99, 103]]], dtype=uint8)]"
Image_1022.jpg,349,119,205,196,1280,720,554,315,205,daskShared_local/images/Image_1022.jpg,1022,"[array([[[ 11, 100, 190],
        [  9,  98, 188],
        [ 10, 100, 190],
        ...,
        [ 22, 133, 215],
        [ 19, 130, 212],
        [ 18, 129, 211]],

       [[  9,  98, 188],
        [  8,  97, 187],
        [ 12, 101, 191],
        ...,
        [ 21, 132, 214],
        [ 16, 127, 209],
        [ 17, 128, 210]],

       [[  8,  97, 187],
        [ 13, 102, 192],
        [ 19, 108, 198],
        ...,
        [ 18, 129, 211],
        [ 16, 127, 209],
        [ 18, 129, 211]],

       ...,

       [[ 17,  82, 174],
        [ 17,  82, 174],
        [ 15,  81, 172],
        ...,
        [232, 235, 225],
        [225, 227, 213],
        [213, 214, 198]],

       [[ 17,  82, 174],
        [ 17,  82, 174],
        [ 15,  80, 172],
        ...,
        [203, 207, 192],
        [148, 151, 132],
        [101, 104,  85]],

       [[ 15,  80, 172],
        [ 13,  78, 170],
        [ 11,  77, 168],
        ...,
        [ 76,  80,  63],
        [ 48,  51,  32],
        [ 20,  23,   2]]], dtype=uint8)]"
Image_1023.jpg,411,3,417,543,1280,720,828,546,543,daskShared_local/images/Image_1023.jpg,1023,"[array([[[159, 227, 238],
        [161, 228, 238],
        [162, 229, 238],
        ...,
        [ 72, 186, 216],
        [ 71, 187, 214],
        [ 78, 189, 218]],

       [[166, 232, 241],
        [170, 234, 243],
        [167, 231, 240],
        ...,
        [ 72, 185, 214],
        [ 59, 186, 212],
        [ 72, 189, 215]],

       [[176, 238, 244],
        [172, 236, 243],
        [168, 233, 241],
        ...,
        [ 66, 185, 212],
        [ 56, 183, 211],
        [ 68, 186, 213]],

       ...,

       [[110,  85,  38],
        [110,  86,  43],
        [ 89,  68,  24],
        ...,
        [  3,  58,  77],
        [  3,  62,  81],
        [  2,  65,  84]],

       [[102,  78,  33],
        [104,  80,  40],
        [ 84,  63,  20],
        ...,
        [  4,  62,  74],
        [  3,  64,  80],
        [  3,  66,  84]],

       [[101,  77,  33],
        [103,  80,  40],
        [ 87,  65,  26],
        ...,
        [  3,  53,  57],
        [  4,  64,  72],
        [  2,  64,  77]]], dtype=uint8)]"
Image_1024.jpg,621,309,187,156,1400,933,808,465,187,daskShared_local/images/Image_1024.jpg,1024,"[array([[[  0, 173, 229],
        [  0, 173, 229],
        [  0, 173, 229],
        ...,
        [  3, 221, 255],
        [  2, 222, 255],
        [  0, 223, 255]],

       [[  0, 173, 229],
        [  0, 173, 229],
        [  0, 173, 229],
        ...,
        [  0, 219, 253],
        [  0, 219, 252],
        [  0, 220, 252]],

       [[  1, 174, 230],
        [  0, 172, 228],
        [  0, 171, 227],
        ...,
        [  2, 210, 251],
        [  2, 210, 251],
        [  2, 211, 251]],

       ...,

       [[112,  98,  71],
        [169, 160, 129],
        [234, 232, 201],
        ...,
        [  1, 185, 237],
        [  1, 185, 237],
        [  1, 185, 237]],

       [[102,  88,  59],
        [131, 122,  91],
        [157, 151, 120],
        ...,
        [  1, 185, 237],
        [  1, 185, 237],
        [  1, 185, 237]],

       [[ 99,  83,  40],
        [ 80,  73,  38],
        [ 65,  66,  40],
        ...,
        [  0, 184, 236],
        [  0, 184, 236],
        [  0, 184, 236]]], dtype=uint8)]"
Image_1025.jpg,389,974,802,647,4601,3200,1191,1621,802,daskShared_local/images/Image_1025.jpg,1025,"[array([[[ 40, 153, 226],
        [ 36, 158, 231],
        [ 19, 167, 244],
        ...,
        [ 50, 153, 222],
        [ 52, 155, 232],
        [ 55, 164, 241]],

       [[ 40, 158, 233],
        [ 35, 159, 233],
        [ 18, 165, 242],
        ...,
        [ 52, 158, 226],
        [ 51, 157, 229],
        [ 54, 160, 236]],

       [[ 32, 161, 236],
        [ 28, 153, 231],
        [ 26, 162, 241],
        ...,
        [ 45, 158, 229],
        [ 45, 159, 230],
        [ 46, 158, 229]],

       ...,

       [[ 14, 161, 221],
        [ 16, 158, 219],
        [ 25, 156, 220],
        ...,
        [ 43, 153, 215],
        [ 43, 154, 214],
        [ 41, 150, 208]],

       [[ 26, 168, 231],
        [ 24, 159, 224],
        [ 35, 155, 230],
        ...,
        [ 43, 158, 215],
        [ 44, 160, 212],
        [ 38, 151, 197]],

       [[ 25, 164, 226],
        [ 25, 157, 223],
        [ 25, 142, 217],
        ...,
        [ 39, 159, 216],
        [ 42, 161, 218],
        [ 41, 152, 207]]], dtype=uint8)]"
Image_1026.jpg,102,257,158,121,900,600,260,378,158,daskShared_local/images/Image_1026.jpg,1026,"[array([[[  1,  69,  81],
        [  3,  71,  83],
        [  2,  72,  84],
        ...,
        [  1,  86, 101],
        [  1,  87, 102],
        [  1,  86, 100]],

       [[  6,  81,  89],
        [  3,  72,  81],
        [  1,  70,  80],
        ...,
        [  0,  87, 101],
        [  1,  88, 101],
        [  3,  88, 102]],

       [[ 15,  94, 101],
        [  9,  82,  88],
        [  3,  74,  82],
        ...,
        [  1,  89, 101],
        [  2,  89, 101],
        [  3,  89, 102]],

       ...,

       [[  0,  66,  75],
        [  0,  66,  75],
        [  0,  66,  76],
        ...,
        [ 16,  44,  38],
        [ 16,  44,  39],
        [ 16,  44,  39]],

       [[  0,  66,  75],
        [  0,  66,  75],
        [  0,  65,  76],
        ...,
        [ 15,  44,  39],
        [ 16,  45,  40],
        [ 16,  45,  40]],

       [[  0,  66,  75],
        [  1,  65,  75],
        [  1,  65,  76],
        ...,
        [ 15,  44,  39],
        [ 16,  45,  40],
        [ 16,  45,  40]]], dtype=uint8)]"
Image_1027.jpg,210,30,212,192,900,521,422,222,212,daskShared_local/images/Image_1027.jpg,1027,"[array([[[ 16,  58, 170],
        [ 16,  58, 170],
        [ 16,  58, 170],
        ...,
        [ 32,  69, 184],
        [ 32,  69, 184],
        [ 32,  69, 184]],

       [[ 16,  58, 170],
        [ 16,  58, 170],
        [ 16,  58, 170],
        ...,
        [ 32,  69, 184],
        [ 32,  69, 184],
        [ 32,  69, 184]],

       [[ 16,  58, 170],
        [ 16,  58, 170],
        [ 16,  58, 170],
        ...,
        [ 32,  69, 184],
        [ 32,  69, 184],
        [ 32,  69, 184]],

       ...,

       [[  0,  54, 140],
        [  0,  54, 140],
        [  0,  54, 140],
        ...,
        [213, 229, 226],
        [220, 236, 233],
        [206, 222, 221]],

       [[  0,  54, 140],
        [  0,  54, 140],
        [  0,  54, 140],
        ...,
        [217, 233, 230],
        [220, 236, 233],
        [208, 224, 223]],

       [[  0,  54, 140],
        [  0,  54, 140],
        [  0,  54, 140],
        ...,
        [211, 227, 224],
        [203, 219, 216],
        [188, 204, 203]]], dtype=uint8)]"
Image_1028.jpg,713,181,175,149,1000,600,888,330,175,daskShared_local/images/Image_1028.jpg,1028,"[array([[[  3, 157, 207],
        [  6, 159, 209],
        [  6, 160, 210],
        ...,
        [  5, 151, 208],
        [  5, 151, 208],
        [  5, 151, 208]],

       [[  5, 157, 206],
        [  6, 159, 208],
        [  7, 159, 208],
        ...,
        [  5, 152, 206],
        [  5, 152, 206],
        [  5, 152, 206]],

       [[  9, 158, 207],
        [ 10, 159, 208],
        [ 10, 159, 207],
        ...,
        [  5, 152, 206],
        [  5, 152, 206],
        [  5, 152, 206]],

       ...,

       [[178, 156,  83],
        [149, 128,  54],
        [135, 118,  38],
        ...,
        [219, 236, 127],
        [194, 207, 130],
        [147, 156, 103]],

       [[183, 163,  63],
        [166, 147,  53],
        [187, 169,  78],
        ...,
        [208, 221, 135],
        [184, 191, 144],
        [147, 151, 127]],

       [[196, 176,  66],
        [201, 181,  83],
        [212, 194, 101],
        ...,
        [217, 225, 168],
        [217, 220, 201],
        [212, 212, 213]]], dtype=uint8)]"
Image_1029.jpg,382,317,348,249,1904,803,730,566,348,daskShared_local/images/Image_1029.jpg,1029,"[array([[[  5,  96, 107],
        [  8,  88, 116],
        [  9, 104, 122],
        ...,
        [ 52, 176, 183],
        [ 57, 155, 168],
        [120, 179, 195]],

       [[  0,  82,  95],
        [  9,  84, 114],
        [  1,  91, 110],
        ...,
        [ 49, 163, 174],
        [ 78, 159, 175],
        [179, 218, 237]],

       [[  8,  66, 100],
        [  1,  78,  87],
        [  0,  84,  89],
        ...,
        [106, 141, 154],
        [182, 193, 206],
        [235, 243, 250]],

       ...,

       [[  1, 141, 156],
        [  7, 138, 158],
        [ 26, 152, 168],
        ...,
        [130, 202, 207],
        [100, 183, 191],
        [ 50, 134, 151]],

       [[  0, 125, 154],
        [ 20, 135, 172],
        [ 17, 134, 167],
        ...,
        [ 87, 187, 189],
        [100, 203, 209],
        [ 39, 137, 151]],

       [[  0, 107, 152],
        [ 10, 104, 155],
        [  3, 106, 150],
        ...,
        [ 28, 138, 143],
        [ 32, 138, 149],
        [  7, 100, 117]]], dtype=uint8)]"
Image_103.jpg,348,105,314,284,1024,670,662,389,314,daskShared_local/images/Image_103.jpg,103,"[array([[[  3,  60, 113],
        [  4,  63, 117],
        [  3,  66, 118],
        ...,
        [  7,  19,  33],
        [  6,  18,  32],
        [  5,  17,  31]],

       [[  2,  59, 109],
        [  4,  61, 114],
        [  3,  63, 115],
        ...,
        [  6,  18,  32],
        [  6,  18,  32],
        [  7,  19,  33]],

       [[  0,  60, 108],
        [  1,  62, 110],
        [  1,  63, 112],
        ...,
        [  7,  19,  33],
        [  5,  17,  31],
        [  6,  18,  32]],

       ...,

       [[ 45, 118,  66],
        [ 34,  96,  52],
        [ 23,  70,  30],
        ...,
        [  6,  17,  20],
        [ 11,  22,  25],
        [ 13,  25,  28]],

       [[ 68, 152,  98],
        [ 45, 109,  76],
        [ 21,  63,  33],
        ...,
        [  8,  20,  21],
        [ 14,  26,  28],
        [ 18,  29,  31]],

       [[ 67, 140,  89],
        [ 20,  76,  44],
        [  6,  45,  16],
        ...,
        [  5,  19,  20],
        [ 11,  25,  26],
        [ 12,  26,  27]]], dtype=uint8)]"
Image_1030.jpg,265,199,202,132,1000,667,467,331,202,daskShared_local/images/Image_1030.jpg,1030,"[array([[[  0,  72, 174],
        [  0,  71, 177],
        [  3,  71, 178],
        ...,
        [  1,  49, 133],
        [  2,  50, 134],
        [  2,  50, 132]],

       [[  0,  71, 179],
        [  0,  68, 179],
        [  2,  70, 179],
        ...,
        [  2,  48, 134],
        [  0,  46, 132],
        [  1,  47, 132]],

       [[  2,  70, 177],
        [  1,  69, 176],
        [  1,  70, 174],
        ...,
        [  0,  47, 137],
        [  0,  48, 133],
        [  1,  49, 133]],

       ...,

       [[ 99, 129, 100],
        [ 95, 126,  88],
        [ 72, 105,  76],
        ...,
        [ 92,  97,  60],
        [ 97, 105,  75],
        [ 79,  93,  65]],

       [[ 95, 112,  85],
        [ 95, 128, 115],
        [101, 145, 114],
        ...,
        [ 95, 102,  85],
        [137, 147, 111],
        [105, 103,  70]],

       [[105, 119,  93],
        [ 99, 123,  95],
        [115, 146, 103],
        ...,
        [ 88,  90,  79],
        [133, 132, 111],
        [118, 114,  79]]], dtype=uint8)]"
Image_1031.jpg,509,81,151,190,1200,630,660,271,190,daskShared_local/images/Image_1031.jpg,1031,"[array([[[  3, 156, 223],
        [  3, 156, 223],
        [  3, 156, 223],
        ...,
        [  4, 156, 223],
        [  4, 156, 223],
        [  4, 156, 223]],

       [[  2, 155, 222],
        [  2, 155, 222],
        [  2, 155, 222],
        ...,
        [  3, 155, 222],
        [  3, 155, 222],
        [  3, 155, 222]],

       [[  2, 155, 222],
        [  2, 155, 222],
        [  2, 155, 222],
        ...,
        [  3, 155, 222],
        [  3, 155, 222],
        [  3, 155, 222]],

       ...,

       [[ 29,  18,  22],
        [ 22,  13,  14],
        [ 22,  14,  13],
        ...,
        [  1,  83, 121],
        [  1,  83, 121],
        [  0,  81, 119]],

       [[ 26,  15,  21],
        [ 23,  14,  17],
        [ 26,  17,  18],
        ...,
        [  1,  83, 121],
        [  0,  82, 120],
        [  0,  79, 117]],

       [[ 19,   7,  17],
        [ 23,  13,  21],
        [ 27,  17,  23],
        ...,
        [  1,  80, 119],
        [  2,  81, 120],
        [  2,  81, 120]]], dtype=uint8)]"
Image_1032.jpg,366,23,149,127,550,380,515,150,149,daskShared_local/images/Image_1032.jpg,1032,"[array([[[ 75,  94, 150],
        [ 75,  94, 150],
        [ 76,  96, 150],
        ...,
        [ 69,  84, 143],
        [ 70,  85, 144],
        [ 71,  86, 145]],

       [[ 75,  94, 150],
        [ 75,  94, 150],
        [ 76,  96, 150],
        ...,
        [ 69,  84, 143],
        [ 70,  85, 144],
        [ 70,  85, 144]],

       [[ 75,  94, 150],
        [ 75,  94, 150],
        [ 76,  96, 150],
        ...,
        [ 69,  84, 143],
        [ 69,  84, 143],
        [ 70,  85, 144]],

       ...,

       [[165, 149, 125],
        [156, 141, 116],
        [147, 130, 102],
        ...,
        [ 65,  79, 140],
        [ 64,  78, 139],
        [ 64,  78, 139]],

       [[174, 153, 129],
        [156, 134, 110],
        [135, 112,  86],
        ...,
        [ 65,  78, 140],
        [ 65,  78, 140],
        [ 65,  78, 139]],

       [[168, 139, 115],
        [146, 115,  89],
        [123,  93,  67],
        ...,
        [ 66,  77, 139],
        [ 66,  78, 139],
        [ 67,  78, 140]]], dtype=uint8)]"
Image_1033.jpg,114,146,357,280,1152,768,471,426,357,daskShared_local/images/Image_1033.jpg,1033,"[array([[[180, 233, 225],
        [180, 233, 225],
        [181, 234, 226],
        ...,
        [175, 236, 228],
        [175, 236, 229],
        [177, 238, 230]],

       [[180, 233, 225],
        [180, 233, 225],
        [181, 234, 226],
        ...,
        [171, 234, 226],
        [172, 235, 227],
        [172, 236, 228]],

       [[180, 233, 223],
        [181, 234, 224],
        [181, 234, 224],
        ...,
        [167, 232, 226],
        [167, 232, 226],
        [167, 232, 226]],

       ...,

       [[ 72, 162, 168],
        [ 78, 165, 171],
        [ 86, 166, 173],
        ...,
        [ 93, 112, 126],
        [ 64,  81,  93],
        [100, 116, 132]],

       [[ 78, 167, 173],
        [ 81, 169, 173],
        [ 86, 169, 175],
        ...,
        [ 99, 124, 141],
        [ 84, 105, 119],
        [102, 122, 140]],

       [[ 88, 171, 178],
        [ 88, 172, 178],
        [ 90, 174, 180],
        ...,
        [ 70, 100, 109],
        [ 74, 103, 113],
        [ 88, 117, 129]]], dtype=uint8)]"
Image_1034.jpg,1266,1034,386,416,2592,1944,1652,1450,416,daskShared_local/images/Image_1034.jpg,1034,"[array([[[ 85,  58,  29],
        [ 99,  70,  42],
        [101,  70,  49],
        ...,
        [ 39, 119, 172],
        [ 41, 120, 172],
        [ 44, 120, 171]],

       [[106,  76,  46],
        [ 87,  56,  26],
        [141, 112,  87],
        ...,
        [ 39, 119, 172],
        [ 40, 118, 170],
        [ 44, 116, 168]],

       [[117,  87,  58],
        [105,  76,  43],
        [209, 182, 155],
        ...,
        [ 39, 119, 172],
        [ 40, 117, 170],
        [ 46, 117, 171]],

       ...,

       [[ 39, 117, 165],
        [ 39, 117, 165],
        [ 39, 117, 165],
        ...,
        [ 39, 121, 168],
        [ 40, 122, 169],
        [ 37, 119, 167]],

       [[ 39, 117, 163],
        [ 39, 117, 163],
        [ 39, 117, 163],
        ...,
        [ 39, 121, 168],
        [ 39, 121, 168],
        [ 38, 120, 166]],

       [[ 39, 117, 164],
        [ 40, 118, 164],
        [ 39, 117, 164],
        ...,
        [ 38, 120, 167],
        [ 38, 121, 167],
        [ 38, 121, 165]]], dtype=uint8)]"
Image_1035.jpg,972,388,205,189,2000,1000,1177,577,205,daskShared_local/images/Image_1035.jpg,1035,"[array([[[197, 173, 135],
        [199, 175, 137],
        [202, 178, 142],
        ...,
        [215, 196, 166],
        [213, 193, 166],
        [209, 193, 159]],

       [[198, 173, 133],
        [197, 171, 134],
        [196, 170, 133],
        ...,
        [209, 190, 159],
        [212, 193, 163],
        [210, 191, 159]],

       [[201, 176, 141],
        [199, 173, 138],
        [200, 174, 139],
        ...,
        [209, 189, 156],
        [215, 196, 164],
        [212, 193, 161]],

       ...,

       [[167, 165, 152],
        [190, 187, 172],
        [186, 183, 168],
        ...,
        [181, 144, 105],
        [206, 169, 128],
        [225, 202, 161]],

       [[165, 163, 150],
        [189, 187, 173],
        [183, 179, 166],
        ...,
        [159, 116,  66],
        [176, 130,  79],
        [216, 193, 151]],

       [[122, 120, 105],
        [162, 159, 144],
        [182, 179, 164],
        ...,
        [175, 125,  77],
        [163, 105,  55],
        [212, 163, 122]]], dtype=uint8)]"
Image_1036.jpg,509,72,315,453,1600,900,824,525,453,daskShared_local/images/Image_1036.jpg,1036,"[array([[[  0, 153, 207],
        [  0, 154, 208],
        [  1, 155, 209],
        ...,
        [158, 203, 244],
        [157, 202, 243],
        [158, 203, 244]],

       [[  0, 154, 208],
        [  0, 153, 207],
        [  0, 154, 208],
        ...,
        [158, 203, 244],
        [157, 202, 243],
        [157, 202, 243]],

       [[  2, 153, 208],
        [  0, 152, 206],
        [  0, 152, 206],
        ...,
        [158, 203, 244],
        [158, 203, 244],
        [157, 202, 243]],

       ...,

       [[  0, 138, 201],
        [  1, 139, 202],
        [  1, 139, 202],
        ...,
        [141, 113,  83],
        [141, 114,  71],
        [155, 130,  82]],

       [[  0, 138, 201],
        [  0, 138, 201],
        [  1, 139, 202],
        ...,
        [162, 127,  91],
        [161, 129,  84],
        [165, 135,  89]],

       [[  0, 138, 201],
        [  0, 138, 201],
        [  1, 139, 202],
        ...,
        [149, 117,  86],
        [158, 130,  94],
        [168, 143, 105]]], dtype=uint8)]"
Image_1037.jpg,1097,148,2480,2622,4608,3072,3577,2770,2622,daskShared_local/images/Image_1037.jpg,1037,"[array([[[ 31,  32,  30],
        [ 30,  30,  28],
        [ 29,  29,  28],
        ...,
        [167, 161, 121],
        [168, 162, 119],
        [168, 162, 116]],

       [[ 32,  33,  32],
        [ 31,  32,  28],
        [ 29,  30,  27],
        ...,
        [159, 156, 121],
        [164, 160, 118],
        [166, 161, 117]],

       [[ 31,  33,  32],
        [ 34,  35,  32],
        [ 43,  43,  44],
        ...,
        [149, 149, 122],
        [157, 155, 120],
        [163, 159, 118]],

       ...,

       [[ 96,  79,  46],
        [ 97,  80,  49],
        [ 96,  79,  50],
        ...,
        [153, 140,  97],
        [155, 138,  93],
        [155, 132,  84]],

       [[ 94,  76,  43],
        [ 94,  76,  42],
        [ 92,  75,  45],
        ...,
        [139, 123,  91],
        [147, 131,  94],
        [156, 138,  88]],

       [[ 90,  73,  41],
        [ 90,  73,  41],
        [ 89,  72,  44],
        ...,
        [165, 131,  72],
        [164, 137,  89],
        [169, 148,  98]]], dtype=uint8)]"
Image_1038.jpg,611,217,147,116,1000,667,758,333,147,daskShared_local/images/Image_1038.jpg,1038,"[array([[[  3, 120, 137],
        [  2, 112, 128],
        [  2, 101, 115],
        ...,
        [  0,  72,  88],
        [  1,  80,  96],
        [  3,  85, 101]],

       [[  6, 127, 144],
        [  6, 119, 136],
        [  5, 108, 123],
        ...,
        [  1,  74,  90],
        [  2,  81,  97],
        [  2,  84, 100]],

       [[ 14, 138, 156],
        [ 14, 132, 150],
        [ 14, 121, 138],
        ...,
        [  3,  79,  94],
        [  3,  84,  98],
        [  2,  86, 100]],

       ...,

       [[149, 170, 148],
        [155, 176, 153],
        [160, 180, 157],
        ...,
        [ 55, 107, 111],
        [ 47,  93, 100],
        [ 42,  85,  92]],

       [[157, 181, 159],
        [157, 181, 158],
        [161, 184, 161],
        ...,
        [ 46,  93,  98],
        [ 38,  79,  86],
        [ 34,  71,  78]],

       [[174, 198, 176],
        [170, 194, 172],
        [167, 191, 169],
        ...,
        [ 41,  84,  90],
        [ 33,  70,  77],
        [ 28,  62,  69]]], dtype=uint8)]"
Image_1039.jpg,217,202,141,171,800,600,358,373,171,daskShared_local/images/Image_1039.jpg,1039,"[array([[[ 90, 192, 214],
        [ 91, 192, 215],
        [ 92, 192, 215],
        ...,
        [ 32, 167, 196],
        [ 29, 167, 195],
        [ 29, 167, 195]],

       [[ 86, 192, 212],
        [ 88, 192, 213],
        [ 88, 192, 213],
        ...,
        [ 31, 167, 196],
        [ 29, 167, 195],
        [ 28, 168, 195]],

       [[ 81, 191, 211],
        [ 82, 191, 212],
        [ 82, 191, 212],
        ...,
        [ 31, 167, 196],
        [ 29, 167, 195],
        [ 27, 167, 194]],

       ...,

       [[ 16, 105,  96],
        [ 17, 106,  97],
        [ 18, 107,  98],
        ...,
        [228, 199, 123],
        [221, 181,  91],
        [226, 186, 125]],

       [[ 18, 105,  96],
        [ 17, 104,  96],
        [ 17, 104,  95],
        ...,
        [224, 194, 128],
        [223, 183, 101],
        [223, 182, 109]],

       [[ 20, 107,  99],
        [ 16, 103,  95],
        [ 14, 101,  93],
        ...,
        [220, 190, 125],
        [221, 181, 102],
        [218, 175,  97]]], dtype=uint8)]"
Image_104.jpg,266,335,146,108,900,599,412,443,146,daskShared_local/images/Image_104.jpg,104,"[array([[[ 66, 133, 211],
        [ 66, 133, 211],
        [ 66, 133, 211],
        ...,
        [ 81, 143, 180],
        [ 89, 143, 172],
        [100, 149, 173]],

       [[ 66, 133, 211],
        [ 66, 133, 211],
        [ 66, 133, 211],
        ...,
        [ 81, 140, 175],
        [106, 157, 184],
        [134, 179, 201]],

       [[ 66, 133, 211],
        [ 66, 133, 211],
        [ 66, 133, 211],
        ...,
        [ 98, 153, 184],
        [142, 189, 211],
        [175, 215, 233]],

       ...,

       [[ 46,  85, 164],
        [ 46,  85, 164],
        [ 46,  85, 164],
        ...,
        [ 47,  90, 168],
        [ 47,  90, 168],
        [ 47,  90, 168]],

       [[ 46,  85, 164],
        [ 46,  85, 164],
        [ 46,  85, 164],
        ...,
        [ 47,  90, 168],
        [ 47,  90, 168],
        [ 47,  90, 168]],

       [[ 45,  84, 163],
        [ 45,  84, 163],
        [ 45,  84, 163],
        ...,
        [ 47,  90, 168],
        [ 47,  90, 168],
        [ 47,  90, 168]]], dtype=uint8)]"
Image_1040.png,365,51,193,150,600,600,558,201,193,daskShared_local/images/Image_1040.png,1040,"[array([[[  1, 101, 249],
        [  0, 100, 248],
        [  0, 100, 248],
        ...,
        [  0, 117, 253],
        [  0, 118, 254],
        [  0, 118, 254]],

       [[  0, 100, 248],
        [  0, 100, 248],
        [  0, 100, 248],
        ...,
        [  0, 117, 253],
        [  0, 118, 254],
        [  0, 118, 254]],

       [[  0,  99, 247],
        [  0, 100, 248],
        [  1, 101, 249],
        ...,
        [  1, 119, 255],
        [  1, 119, 255],
        [  1, 119, 255]],

       ...,

       [[234, 225, 190],
        [181, 142,  94],
        [165, 101,  23],
        ...,
        [247, 249, 207],
        [244, 250, 189],
        [242, 251, 172]],

       [[241, 236, 153],
        [244, 218, 147],
        [207, 155,  65],
        ...,
        [247, 249, 199],
        [246, 251, 184],
        [244, 253, 170]],

       [[215, 207, 100],
        [253, 251, 234],
        [254, 252, 210],
        ...,
        [247, 249, 198],
        [246, 252, 181],
        [246, 255, 166]]], dtype=uint8)]"
Image_1041.jpg,597,79,217,169,1068,601,814,248,217,daskShared_local/images/Image_1041.jpg,1041,"[array([[[  0,  72, 254],
        [  0,  71, 253],
        [  0,  71, 253],
        ...,
        [  0,  86, 254],
        [  0,  87, 255],
        [  0,  87, 255]],

       [[  0,  72, 254],
        [  0,  72, 254],
        [  0,  72, 254],
        ...,
        [  0,  87, 255],
        [  0,  87, 255],
        [  0,  87, 255]],

       [[  1,  74, 255],
        [  1,  74, 255],
        [  1,  74, 255],
        ...,
        [  0,  87, 255],
        [  0,  87, 255],
        [  0,  87, 255]],

       ...,

       [[217, 199, 167],
        [221, 202, 176],
        [189, 173, 144],
        ...,
        [201, 219, 232],
        [198, 225, 249],
        [189, 225, 255]],

       [[209, 194, 184],
        [204, 189, 181],
        [178, 166, 146],
        ...,
        [214, 225, 237],
        [208, 225, 242],
        [205, 231, 251]],

       [[201, 186, 192],
        [148, 134, 138],
        [ 94,  85,  71],
        ...,
        [207, 214, 227],
        [211, 223, 233],
        [206, 225, 233]]], dtype=uint8)]"
Image_1042.jpg,428,141,233,186,1000,667,661,327,233,daskShared_local/images/Image_1042.jpg,1042,"[array([[[ 59, 194, 255],
        [ 53, 191, 253],
        [ 54, 189, 253],
        ...,
        [  8, 152, 231],
        [  7, 152, 231],
        [ 11, 153, 235]],

       [[ 54, 191, 254],
        [ 50, 189, 253],
        [ 49, 187, 251],
        ...,
        [  5, 151, 230],
        [  9, 153, 232],
        [  8, 153, 232]],

       [[ 48, 187, 252],
        [ 47, 186, 251],
        [ 46, 185, 252],
        ...,
        [  3, 150, 228],
        [  3, 151, 229],
        [  3, 151, 228]],

       ...,

       [[169, 143,  90],
        [176, 156, 103],
        [183, 167, 113],
        ...,
        [  0,  63, 108],
        [  0,  63, 107],
        [  0,  63, 109]],

       [[200, 188, 142],
        [206, 197, 151],
        [205, 195, 148],
        ...,
        [  0,  64, 108],
        [  0,  63, 106],
        [  1,  62, 107]],

       [[205, 194, 148],
        [204, 198, 147],
        [198, 188, 136],
        ...,
        [  0,  63, 106],
        [  0,  62, 105],
        [  0,  61, 106]]], dtype=uint8)]"
Image_1043.jpg,426,146,726,617,1152,763,1152,763,726,daskShared_local/images/Image_1043.jpg,1043,"[array([[[  0, 178, 234],
        [  1, 179, 235],
        [  0, 180, 236],
        ...,
        [  0, 183, 237],
        [  0, 184, 238],
        [  0, 184, 238]],

       [[  0, 179, 235],
        [  0, 179, 235],
        [  0, 179, 235],
        ...,
        [  0, 183, 237],
        [  0, 184, 238],
        [  0, 184, 238]],

       [[  0, 179, 235],
        [  0, 179, 235],
        [  0, 179, 235],
        ...,
        [  0, 183, 237],
        [  0, 183, 237],
        [  0, 183, 237]],

       ...,

       [[145, 170, 138],
        [142, 168, 133],
        [142, 169, 133],
        ...,
        [190, 203, 181],
        [169, 191, 177],
        [151, 179, 149]],

       [[150, 175, 144],
        [147, 172, 140],
        [147, 172, 142],
        ...,
        [169, 191, 183],
        [154, 183, 164],
        [142, 175, 145]],

       [[156, 180, 151],
        [153, 177, 148],
        [153, 176, 148],
        ...,
        [149, 181, 174],
        [133, 169, 160],
        [128, 162, 130]]], dtype=uint8)]"
Image_1044.jpg,540,235,157,193,990,681,697,428,193,daskShared_local/images/Image_1044.jpg,1044,"[array([[[ 38,  34,  22],
        [ 40,  36,  24],
        [ 40,  37,  22],
        ...,
        [ 35,  28,  12],
        [ 37,  26,   8],
        [ 40,  25,   6]],

       [[ 33,  29,  17],
        [ 36,  32,  20],
        [ 37,  34,  19],
        ...,
        [ 37,  31,   9],
        [ 40,  29,   7],
        [ 44,  29,   6]],

       [[ 32,  26,  14],
        [ 34,  28,  16],
        [ 35,  29,  15],
        ...,
        [ 42,  34,  11],
        [ 45,  35,   8],
        [ 50,  36,  10]],

       ...,

       [[119, 114,  82],
        [157, 151, 117],
        [168, 163, 125],
        ...,
        [ 38,  45,  29],
        [ 42,  49,  31],
        [ 53,  60,  42]],

       [[ 92,  86,  54],
        [132, 126,  90],
        [145, 137, 100],
        ...,
        [ 35,  42,  26],
        [ 39,  46,  28],
        [ 52,  59,  41]],

       [[ 83,  74,  41],
        [118, 108,  72],
        [128, 119,  78],
        ...,
        [ 33,  40,  24],
        [ 38,  45,  27],
        [ 50,  57,  39]]], dtype=uint8)]"
Image_1045.jpg,496,158,99,88,660,438,595,246,99,daskShared_local/images/Image_1045.jpg,1045,"[array([[[  5,  32,  72],
        [  5,  32,  72],
        [  9,  36,  75],
        ...,
        [  2,  13,  55],
        [  1,  10,  51],
        [  1,  10,  51]],

       [[  5,  32,  72],
        [  5,  32,  72],
        [  9,  36,  75],
        ...,
        [  2,  13,  55],
        [  1,  10,  51],
        [  1,  10,  51]],

       [[ 11,  35,  76],
        [ 11,  35,  76],
        [ 14,  37,  78],
        ...,
        [  1,  10,  53],
        [  0,  10,  52],
        [  0,  10,  52]],

       ...,

       [[220, 168, 111],
        [220, 168, 111],
        [237, 175, 130],
        ...,
        [ 45,  36,  50],
        [ 50,  39,  56],
        [ 50,  39,  56]],

       [[229, 168, 116],
        [229, 168, 116],
        [238, 173, 129],
        ...,
        [ 57,  47,  58],
        [ 62,  51,  65],
        [ 62,  51,  65]],

       [[229, 168, 116],
        [229, 168, 116],
        [238, 173, 129],
        ...,
        [ 57,  47,  58],
        [ 62,  51,  65],
        [ 62,  51,  65]]], dtype=uint8)]"
Image_1046.jpg,375,150,131,129,900,600,506,279,131,daskShared_local/images/Image_1046.jpg,1046,"[array([[[ 89, 120, 184],
        [ 89, 121, 184],
        [ 90, 123, 185],
        ...,
        [ 91, 140, 205],
        [ 66, 135, 205],
        [ 51, 132, 204]],

       [[ 75, 117, 183],
        [ 74, 118, 184],
        [ 74, 120, 185],
        ...,
        [ 82, 140, 207],
        [ 61, 136, 207],
        [ 47, 133, 206]],

       [[ 46, 112, 181],
        [ 44, 113, 182],
        [ 41, 115, 184],
        ...,
        [ 62, 140, 209],
        [ 50, 137, 209],
        [ 38, 133, 207]],

       ...,

       [[  0,  92, 170],
        [  0,  91, 170],
        [  0,  88, 169],
        ...,
        [122,  96, 122],
        [125,  98, 123],
        [127,  99, 125]],

       [[  1,  89, 168],
        [  1,  88, 167],
        [  0,  85, 166],
        ...,
        [126,  99, 124],
        [127,  99, 124],
        [128, 100, 125]],

       [[  1,  88, 167],
        [  1,  87, 166],
        [  1,  84, 164],
        ...,
        [128, 100, 125],
        [128, 100, 125],
        [129, 101, 126]]], dtype=uint8)]"
Image_1047.jpg,412,128,118,97,759,422,530,225,118,daskShared_local/images/Image_1047.jpg,1047,"[array([[[100, 170, 170],
        [100, 170, 170],
        [100, 170, 170],
        ...,
        [  3, 134, 152],
        [  1, 133, 151],
        [  1, 132, 150]],

       [[106, 176, 176],
        [106, 176, 176],
        [107, 177, 177],
        ...,
        [  2, 133, 151],
        [  1, 133, 151],
        [  0, 133, 151]],

       [[122, 192, 192],
        [124, 194, 194],
        [129, 199, 199],
        ...,
        [  0, 131, 149],
        [  0, 135, 153],
        [  0, 136, 154]],

       ...,

       [[  0, 155, 186],
        [  0, 155, 186],
        [  0, 155, 186],
        ...,
        [  3, 139, 161],
        [  3, 139, 161],
        [  3, 139, 161]],

       [[  0, 155, 186],
        [  0, 155, 186],
        [  1, 156, 187],
        ...,
        [  4, 139, 161],
        [  3, 139, 161],
        [  3, 139, 161]],

       [[  0, 155, 186],
        [  0, 155, 186],
        [  1, 156, 187],
        ...,
        [  4, 139, 161],
        [  3, 139, 161],
        [  3, 138, 160]]], dtype=uint8)]"
Image_1048.jpg,474,155,235,282,981,650,709,437,282,daskShared_local/images/Image_1048.jpg,1048,"[array([[[244, 244, 244],
        [244, 244, 244],
        [244, 244, 244],
        ...,
        [243, 243, 243],
        [243, 243, 243],
        [243, 243, 243]],

       [[244, 244, 244],
        [244, 244, 244],
        [244, 244, 244],
        ...,
        [243, 243, 243],
        [243, 243, 243],
        [243, 243, 243]],

       [[244, 244, 244],
        [244, 244, 244],
        [244, 244, 244],
        ...,
        [243, 243, 243],
        [243, 243, 243],
        [243, 243, 243]],

       ...,

       [[ 19,  90, 172],
        [ 18,  89, 171],
        [ 18,  89, 171],
        ...,
        [ 28,  98, 169],
        [ 33, 103, 176],
        [ 34, 104, 176]],

       [[ 19,  90, 172],
        [ 19,  90, 172],
        [ 19,  90, 172],
        ...,
        [ 36, 106, 179],
        [ 38, 107, 183],
        [ 35, 104, 180]],

       [[ 19,  90, 172],
        [ 20,  91, 173],
        [ 20,  91, 173],
        ...,
        [ 26,  95, 173],
        [ 24,  92, 173],
        [ 21,  90, 168]]], dtype=uint8)]"
Image_1049.jpg,403,301,254,239,1500,1000,657,540,254,daskShared_local/images/Image_1049.jpg,1049,"[array([[[  0, 127, 152],
        [  1, 128, 153],
        [  2, 128, 153],
        ...,
        [  0, 113, 132],
        [  0, 113, 132],
        [  2, 120, 140]],

       [[  0, 128, 153],
        [  1, 128, 153],
        [  3, 129, 154],
        ...,
        [  1, 112, 132],
        [  2, 112, 132],
        [  6, 121, 141]],

       [[  0, 128, 151],
        [  0, 128, 152],
        [  1, 130, 154],
        ...,
        [  4, 115, 134],
        [  5, 116, 136],
        [  2, 115, 135]],

       ...,

       [[ 44,  80,  62],
        [ 42,  79,  61],
        [ 55,  93,  74],
        ...,
        [144, 118,  69],
        [ 70,  42,   7],
        [ 40,  22,   0]],

       [[ 43,  77,  60],
        [ 37,  73,  55],
        [ 44,  80,  62],
        ...,
        [153, 129,  79],
        [ 86,  58,  17],
        [ 36,  20,   0]],

       [[ 37,  68,  52],
        [ 31,  64,  47],
        [ 34,  67,  50],
        ...,
        [ 73,  50,   9],
        [ 60,  34,   2],
        [ 48,  31,   3]]], dtype=uint8)]"
Image_105.jpg,277,166,267,252,1000,541,544,418,267,daskShared_local/images/Image_105.jpg,105,"[array([[[  1, 132, 164],
        [  1, 140, 172],
        [  1, 141, 178],
        ...,
        [ 22, 106, 125],
        [ 26, 119, 139],
        [ 27, 126, 148]],

       [[  0, 131, 163],
        [  2, 138, 172],
        [  3, 141, 181],
        ...,
        [ 19, 150, 172],
        [ 21, 157, 181],
        [ 32, 161, 188]],

       [[  0, 131, 166],
        [  0, 135, 171],
        [  2, 140, 176],
        ...,
        [ 53, 176, 197],
        [ 58, 178, 203],
        [ 70, 179, 210]],

       ...,

       [[  3,  64,  81],
        [  2,  55,  67],
        [  1,  45,  55],
        ...,
        [ 46,  84, 110],
        [ 41,  80, 102],
        [ 42,  85, 103]],

       [[  4,  70,  92],
        [  7,  66,  86],
        [  1,  52,  65],
        ...,
        [ 41,  83, 114],
        [ 45,  85, 112],
        [ 43,  83, 104]],

       [[  2,  69,  89],
        [  1,  62,  85],
        [  1,  55,  69],
        ...,
        [ 34,  91, 120],
        [ 42,  84, 107],
        [ 48,  79,  95]]], dtype=uint8)]"
Image_1050.jpg,1267,624,210,178,2304,1536,1477,802,210,daskShared_local/images/Image_1050.jpg,1050,"[array([[[  4, 111, 153],
        [  1, 108, 150],
        [  0, 107, 149],
        ...,
        [  0, 120, 150],
        [  0, 123, 151],
        [  0, 123, 151]],

       [[  4, 111, 153],
        [  2, 109, 151],
        [  0, 107, 149],
        ...,
        [  2, 123, 152],
        [  2, 123, 152],
        [  0, 124, 152]],

       [[  2, 109, 151],
        [  1, 108, 149],
        [  0, 108, 147],
        ...,
        [  6, 125, 155],
        [  5, 126, 155],
        [  3, 127, 155]],

       ...,

       [[136, 176, 170],
        [146, 181, 169],
        [144, 176, 160],
        ...,
        [ 18,  19,  39],
        [ 19,  18,  36],
        [ 20,  19,  35]],

       [[151, 184, 169],
        [133, 173, 153],
        [135, 186, 165],
        ...,
        [ 17,  20,  39],
        [ 20,  21,  39],
        [ 22,  23,  40]],

       [[147, 186, 165],
        [137, 180, 152],
        [123, 167, 141],
        ...,
        [ 21,  24,  41],
        [ 27,  28,  48],
        [ 30,  31,  51]]], dtype=uint8)]"
Image_1051.jpg,180,96,361,294,1024,670,541,390,361,daskShared_local/images/Image_1051.jpg,1051,"[array([[[ 44,  55,  68],
        [ 53,  61,  75],
        [ 47,  55,  67],
        ...,
        [ 25,  99, 115],
        [ 34, 123, 137],
        [ 23, 108, 121]],

       [[ 38,  52,  61],
        [ 30,  42,  52],
        [ 26,  38,  48],
        ...,
        [ 20,  85, 105],
        [  8,  72,  88],
        [ 17,  78,  90]],

       [[ 35,  51,  64],
        [ 17,  31,  44],
        [ 12,  26,  39],
        ...,
        [ 29,  97, 120],
        [ 11,  74,  95],
        [ 26,  84, 103]],

       ...,

       [[ 62, 164, 176],
        [ 72, 164, 185],
        [ 87, 196, 222],
        ...,
        [ 42, 158, 175],
        [ 51, 158, 176],
        [ 61, 171, 184]],

       [[ 81, 180, 195],
        [ 67, 166, 188],
        [ 67, 183, 206],
        ...,
        [ 42, 157, 177],
        [ 40, 149, 174],
        [ 29, 143, 165]],

       [[ 84, 183, 204],
        [ 75, 185, 205],
        [ 66, 195, 210],
        ...,
        [ 43, 151, 174],
        [ 55, 153, 182],
        [ 36, 136, 164]]], dtype=uint8)]"
Image_1052.jpg,247,215,141,150,775,518,388,365,150,daskShared_local/images/Image_1052.jpg,1052,"[array([[[ 45,  45,  31],
        [ 24,  23,  16],
        [ 44,  40,  34],
        ...,
        [133, 106,  79],
        [129, 103,  76],
        [120,  94,  68]],

       [[ 31,  32,  18],
        [ 34,  32,  22],
        [ 85,  79,  71],
        ...,
        [134, 107,  78],
        [127, 100,  71],
        [125,  99,  71]],

       [[ 48,  47,  34],
        [ 83,  80,  67],
        [146, 139, 128],
        ...,
        [141, 112,  81],
        [137, 110,  79],
        [129, 103,  72]],

       ...,

       [[156, 118,  71],
        [157, 120,  73],
        [149, 113,  67],
        ...,
        [162, 118,  79],
        [160, 115,  76],
        [154, 110,  70]],

       [[150, 112,  66],
        [153, 116,  71],
        [147, 111,  66],
        ...,
        [164, 120,  81],
        [164, 120,  81],
        [159, 115,  76]],

       [[137,  99,  54],
        [144, 106,  62],
        [143, 108,  63],
        ...,
        [158, 114,  75],
        [164, 120,  81],
        [164, 120,  81]]], dtype=uint8)]"
Image_1053.jpg,305,302,157,139,966,642,462,441,157,daskShared_local/images/Image_1053.jpg,1053,"[array([[[ 10, 100,  83],
        [  9, 100,  80],
        [ 10,  99,  77],
        ...,
        [ 18,  10,   4],
        [ 26,  15,   4],
        [ 37,  24,  10]],

       [[ 14,  98,  93],
        [ 16,  99,  91],
        [ 17,  99,  89],
        ...,
        [ 16,   4,   4],
        [ 20,   5,   1],
        [ 26,   8,   3]],

       [[ 13, 121, 123],
        [ 16, 124, 123],
        [ 17, 123, 119],
        ...,
        [ 18,   2,   5],
        [ 17,   0,   1],
        [ 20,   0,   1]],

       ...,

       [[ 24, 195, 213],
        [ 23, 196, 211],
        [ 23, 196, 209],
        ...,
        [ 75, 238, 253],
        [ 71, 235, 251],
        [ 67, 233, 249]],

       [[ 19, 194, 207],
        [ 20, 198, 207],
        [ 23, 199, 207],
        ...,
        [ 69, 237, 249],
        [ 68, 235, 249],
        [ 69, 236, 252]],

       [[ 19, 193, 206],
        [ 21, 198, 207],
        [ 24, 201, 209],
        ...,
        [ 66, 232, 245],
        [ 66, 232, 247],
        [ 69, 235, 251]]], dtype=uint8)]"
Image_1054.jpg,731,339,195,168,1600,1000,926,507,195,daskShared_local/images/Image_1054.jpg,1054,"[array([[[  2,  83, 165],
        [  2,  83, 165],
        [  2,  83, 165],
        ...,
        [  0,  81, 163],
        [  0,  81, 163],
        [  0,  81, 163]],

       [[  2,  83, 165],
        [  2,  83, 165],
        [  2,  83, 165],
        ...,
        [  0,  81, 163],
        [  0,  81, 163],
        [  0,  81, 163]],

       [[  0,  81, 163],
        [  0,  81, 163],
        [  0,  81, 163],
        ...,
        [  0,  79, 161],
        [  0,  79, 161],
        [  0,  79, 161]],

       ...,

       [[116, 115,  96],
        [102, 114, 102],
        [134, 160, 150],
        ...,
        [196, 196, 194],
        [206, 203, 197],
        [201, 191, 182]],

       [[145, 154, 139],
        [156, 177, 164],
        [193, 227, 211],
        ...,
        [174, 162, 158],
        [216, 199, 192],
        [214, 192, 181]],

       [[159, 170, 162],
        [190, 212, 200],
        [182, 213, 198],
        ...,
        [212, 195, 187],
        [237, 217, 206],
        [217, 191, 176]]], dtype=uint8)]"
Image_1055.jpg,405,325,140,136,800,600,545,461,140,daskShared_local/images/Image_1055.jpg,1055,"[array([[[213, 213, 179],
        [212, 208, 177],
        [208, 198, 170],
        ...,
        [  1,  87,  97],
        [  1,  85,  96],
        [  1,  84,  95]],

       [[217, 208, 175],
        [220, 211, 180],
        [221, 211, 182],
        ...,
        [  2,  87,  97],
        [  2,  85,  96],
        [  2,  84,  96]],

       [[223, 203, 172],
        [229, 213, 183],
        [231, 222, 192],
        ...,
        [  2,  86,  97],
        [  2,  86,  97],
        [  3,  86,  97]],

       ...,

       [[ 20,  51,  46],
        [ 21,  52,  47],
        [ 22,  52,  48],
        ...,
        [ 60, 143,  88],
        [ 45, 122,  74],
        [ 33, 107,  63]],

       [[ 21,  52,  47],
        [ 22,  53,  48],
        [ 22,  53,  48],
        ...,
        [ 51, 132,  76],
        [ 40, 117,  67],
        [ 30, 104,  59]],

       [[ 22,  53,  48],
        [ 22,  53,  48],
        [ 23,  54,  49],
        ...,
        [ 42, 120,  70],
        [ 34, 110,  63],
        [ 26, 101,  57]]], dtype=uint8)]"
Image_1056.jpg,684,285,532,503,1920,1080,1216,788,532,daskShared_local/images/Image_1056.jpg,1056,"[array([[[ 42,  62,  55],
        [ 39,  59,  52],
        [ 39,  59,  52],
        ...,
        [ 23,  62,  69],
        [ 33,  71,  79],
        [ 20,  57,  65]],

       [[ 43,  63,  54],
        [ 39,  60,  50],
        [ 36,  57,  48],
        ...,
        [ 28,  63,  69],
        [ 24,  61,  67],
        [ 19,  54,  60]],

       [[ 37,  56,  50],
        [ 40,  62,  52],
        [ 41,  62,  53],
        ...,
        [ 22,  52,  55],
        [ 24,  57,  59],
        [ 30,  61,  64]],

       ...,

       [[ 28,  94, 144],
        [ 29,  95, 145],
        [ 28,  95, 145],
        ...,
        [ 25,  41,  37],
        [ 26,  43,  38],
        [ 27,  43,  39]],

       [[ 28,  94, 144],
        [ 29,  94, 144],
        [ 28,  95, 145],
        ...,
        [ 25,  41,  36],
        [ 29,  43,  38],
        [ 30,  44,  39]],

       [[ 29,  95, 145],
        [ 28,  94, 143],
        [ 28,  94, 143],
        ...,
        [ 22,  40,  36],
        [ 25,  43,  37],
        [ 25,  44,  38]]], dtype=uint8)]"
Image_1057.jpg,160,174,186,145,728,500,346,319,186,daskShared_local/images/Image_1057.jpg,1057,"[array([[[  1,  72, 224],
        [  0,  71, 221],
        [  3,  73, 223],
        ...,
        [  1,  81, 228],
        [  1,  81, 228],
        [  1,  82, 226]],

       [[  1,  72, 222],
        [  3,  73, 223],
        [  2,  72, 221],
        ...,
        [  1,  82, 226],
        [  0,  80, 224],
        [  1,  80, 225]],

       [[  0,  72, 221],
        [  1,  72, 222],
        [  0,  71, 221],
        ...,
        [  1,  82, 226],
        [  1,  80, 225],
        [  1,  80, 225]],

       ...,

       [[ 31, 149, 156],
        [ 31, 154, 157],
        [ 30, 150, 154],
        ...,
        [236, 218, 168],
        [246, 237, 198],
        [245, 233, 189]],

       [[ 27, 139, 150],
        [ 35, 148, 154],
        [ 33, 151, 155],
        ...,
        [218, 176, 141],
        [226, 200, 176],
        [226, 193, 163]],

       [[ 36, 147, 156],
        [ 55, 156, 162],
        [ 68, 157, 170],
        ...,
        [208, 158, 101],
        [223, 188, 129],
        [239, 209, 148]]], dtype=uint8)]"
Image_1058.jpg,809,326,156,138,1536,1024,965,464,156,daskShared_local/images/Image_1058.jpg,1058,"[array([[[ 43, 123, 210],
        [ 43, 123, 210],
        [ 43, 123, 210],
        ...,
        [ 48, 125, 213],
        [ 48, 125, 213],
        [ 47, 124, 212]],

       [[ 43, 123, 210],
        [ 43, 123, 210],
        [ 43, 123, 210],
        ...,
        [ 48, 125, 213],
        [ 48, 125, 213],
        [ 48, 125, 213]],

       [[ 43, 123, 210],
        [ 43, 123, 210],
        [ 42, 124, 210],
        ...,
        [ 48, 125, 213],
        [ 48, 125, 213],
        [ 48, 125, 213]],

       ...,

       [[ 22, 118, 205],
        [ 22, 118, 205],
        [ 20, 117, 204],
        ...,
        [ 18, 113, 203],
        [ 16, 114, 203],
        [ 14, 114, 202]],

       [[ 21, 116, 204],
        [ 20, 117, 204],
        [ 19, 116, 203],
        ...,
        [ 16, 114, 203],
        [ 14, 114, 203],
        [ 12, 115, 202]],

       [[ 17, 115, 202],
        [ 16, 115, 201],
        [ 15, 116, 201],
        ...,
        [ 12, 116, 204],
        [ 10, 116, 204],
        [  7, 116, 203]]], dtype=uint8)]"
Image_1059.jpg,1863,2539,464,464,2720,4080,2327,3003,464,daskShared_local/images/Image_1059.jpg,1059,"[array([[[  3, 124, 190],
        [  4, 127, 193],
        [  6, 130, 196],
        ...,
        [  3, 120, 194],
        [  7, 125, 199],
        [  3, 118, 192]],

       [[  8, 132, 198],
        [  8, 132, 198],
        [  3, 124, 190],
        ...,
        [  9, 125, 199],
        [  3, 120, 194],
        [  3, 119, 193]],

       [[  9, 132, 196],
        [  3, 123, 187],
        [  7, 128, 193],
        ...,
        [  6, 119, 195],
        [  2, 116, 191],
        [  3, 118, 193]],

       ...,

       [[  6, 117, 191],
        [  6, 118, 192],
        [  2, 112, 186],
        ...,
        [  7, 116, 193],
        [  2, 109, 186],
        [  2, 110, 187]],

       [[  7, 118, 192],
        [  3, 110, 184],
        [  9, 120, 194],
        ...,
        [  4, 111, 188],
        [  4, 112, 189],
        [  6, 115, 192]],

       [[  3, 115, 189],
        [ 10, 122, 196],
        [  9, 121, 195],
        ...,
        [  3, 111, 188],
        [  3, 109, 186],
        [  1, 108, 185]]], dtype=uint8)]"
Image_106.jpg,390,187,158,122,770,578,548,309,158,daskShared_local/images/Image_106.jpg,106,"[array([[[102, 109, 106],
        [100, 108, 104],
        [ 95, 104,  98],
        ...,
        [ 66,  67,  52],
        [ 70,  71,  58],
        [ 74,  76,  63]],

       [[106, 112, 108],
        [103, 110, 106],
        [ 96, 104,  99],
        ...,
        [ 59,  60,  45],
        [ 66,  67,  54],
        [ 71,  73,  61]],

       [[108, 113, 110],
        [105, 110, 107],
        [ 95, 103,  99],
        ...,
        [ 57,  57,  44],
        [ 65,  65,  54],
        [ 70,  71,  62]],

       ...,

       [[121, 125, 126],
        [106, 110, 111],
        [ 99, 103, 104],
        ...,
        [ 63,  64,  56],
        [ 57,  57,  50],
        [ 41,  42,  35]],

       [[118, 122, 123],
        [109, 113, 114],
        [107, 111, 112],
        ...,
        [134, 134, 124],
        [ 93,  92,  83],
        [ 60,  59,  51]],

       [[113, 117, 118],
        [114, 118, 119],
        [115, 119, 120],
        ...,
        [189, 189, 177],
        [117, 116, 105],
        [ 73,  71,  62]]], dtype=uint8)]"
Image_1060.jpg,73,84,118,130,637,450,191,214,130,daskShared_local/images/Image_1060.jpg,1060,"[array([[[  2, 173, 253],
        [  2, 173, 253],
        [  2, 173, 253],
        ...,
        [  0, 175, 254],
        [  1, 175, 254],
        [  2, 175, 254]],

       [[  2, 173, 253],
        [  2, 173, 253],
        [  2, 173, 253],
        ...,
        [  0, 175, 254],
        [  1, 175, 254],
        [  2, 175, 254]],

       [[  1, 172, 252],
        [  1, 172, 252],
        [  1, 172, 252],
        ...,
        [  0, 175, 254],
        [  1, 175, 254],
        [  2, 175, 254]],

       ...,

       [[  3, 131, 238],
        [  3, 131, 238],
        [  4, 132, 239],
        ...,
        [ 97, 134, 115],
        [108, 148, 128],
        [112, 153, 133]],

       [[  3, 131, 238],
        [  3, 131, 238],
        [  4, 132, 239],
        ...,
        [ 82, 124, 109],
        [ 98, 142, 125],
        [104, 148, 131]],

       [[  3, 131, 238],
        [  3, 131, 238],
        [  4, 132, 239],
        ...,
        [ 73, 119, 105],
        [ 91, 137, 122],
        [ 98, 144, 128]]], dtype=uint8)]"
Image_1061.jpg,280,124,108,127,775,518,388,251,127,daskShared_local/images/Image_1061.jpg,1061,"[array([[[ 91, 164, 179],
        [ 90, 162, 178],
        [ 87, 158, 176],
        ...,
        [ 93, 164, 182],
        [ 98, 170, 187],
        [101, 172, 189]],

       [[ 90, 162, 178],
        [ 90, 162, 178],
        [ 90, 161, 179],
        ...,
        [ 94, 166, 182],
        [ 98, 170, 187],
        [100, 172, 188]],

       [[ 88, 160, 176],
        [ 90, 162, 179],
        [ 94, 165, 183],
        ...,
        [ 95, 167, 182],
        [ 97, 169, 184],
        [ 98, 169, 184]],

       ...,

       [[170, 127,  95],
        [168, 125,  96],
        [166, 124,  99],
        ...,
        [ 41,  18,  19],
        [ 23,   4,  14],
        [ 20,   3,  16]],

       [[168, 127,  94],
        [161, 120,  89],
        [150, 108,  83],
        ...,
        [ 56,  33,  31],
        [ 30,  11,  18],
        [ 23,   5,  15]],

       [[166, 125,  92],
        [157, 116,  85],
        [141,  99,  74],
        ...,
        [ 64,  40,  37],
        [ 34,  14,  19],
        [ 24,   6,  15]]], dtype=uint8)]"
Image_1062.jpg,624,309,159,150,1440,960,783,459,159,daskShared_local/images/Image_1062.jpg,1062,"[array([[[  1, 147, 207],
        [  0, 146, 206],
        [  0, 146, 206],
        ...,
        [  2, 145, 215],
        [  2, 145, 215],
        [  1, 144, 214]],

       [[  0, 145, 206],
        [  0, 145, 205],
        [  0, 145, 205],
        ...,
        [  1, 144, 214],
        [  1, 144, 214],
        [  1, 144, 214]],

       [[  0, 144, 205],
        [  0, 144, 205],
        [  0, 144, 205],
        ...,
        [  0, 143, 213],
        [  1, 144, 214],
        [  1, 144, 214]],

       ...,

       [[ 29,  44,  35],
        [ 29,  43,  35],
        [ 28,  43,  34],
        ...,
        [  1,  81, 120],
        [  1,  82, 120],
        [  1,  82, 120]],

       [[ 25,  41,  31],
        [ 23,  39,  29],
        [ 20,  36,  26],
        ...,
        [  1,  82, 120],
        [  1,  83, 121],
        [  2,  84, 122]],

       [[ 27,  43,  33],
        [ 24,  40,  30],
        [ 18,  34,  24],
        ...,
        [  1,  81, 120],
        [  1,  83, 121],
        [  2,  84, 122]]], dtype=uint8)]"
Image_1063.jpg,447,147,149,122,1024,512,596,269,149,daskShared_local/images/Image_1063.jpg,1063,"[array([[[  2, 131, 188],
        [  1, 132, 189],
        [  0, 132, 189],
        ...,
        [  1, 178, 219],
        [  1, 178, 219],
        [  2, 178, 219]],

       [[  2, 131, 188],
        [  1, 132, 189],
        [  0, 132, 189],
        ...,
        [  5, 182, 223],
        [  6, 182, 223],
        [  6, 183, 224]],

       [[  2, 131, 188],
        [  1, 131, 189],
        [  0, 132, 189],
        ...,
        [  7, 184, 225],
        [  8, 184, 225],
        [  8, 183, 225]],

       ...,

       [[ 87,  87,  66],
        [ 76,  77,  61],
        [ 69,  71,  58],
        ...,
        [  0, 141, 197],
        [  0, 141, 197],
        [  0, 141, 197]],

       [[102, 100,  80],
        [ 88,  88,  72],
        [ 74,  76,  62],
        ...,
        [  0, 141, 197],
        [  0, 141, 197],
        [  0, 141, 197]],

       [[ 91,  87,  68],
        [ 84,  83,  67],
        [ 71,  72,  58],
        ...,
        [  0, 141, 197],
        [  0, 141, 197],
        [  0, 141, 197]]], dtype=uint8)]"
Image_1064.jpg,107,75,94,70,475,264,201,145,94,daskShared_local/images/Image_1064.jpg,1064,"[array([[[ 25,  44,  64],
        [ 25,  44,  64],
        [ 23,  44,  63],
        ...,
        [ 41,  69,  99],
        [ 37,  65,  94],
        [ 37,  65,  94]],

       [[ 25,  44,  64],
        [ 25,  44,  64],
        [ 24,  44,  63],
        ...,
        [ 40,  69,  98],
        [ 36,  64,  93],
        [ 37,  65,  94]],

       [[ 23,  44,  63],
        [ 23,  44,  63],
        [ 22,  44,  63],
        ...,
        [ 44,  73, 102],
        [ 40,  69,  98],
        [ 41,  70,  98]],

       ...,

       [[ 16,  25,  34],
        [ 16,  26,  34],
        [ 13,  22,  31],
        ...,
        [ 43,  59,  65],
        [ 40,  56,  61],
        [ 40,  57,  62]],

       [[ 17,  27,  35],
        [ 17,  27,  36],
        [ 14,  24,  31],
        ...,
        [ 49,  68,  77],
        [ 41,  61,  69],
        [ 42,  62,  70]],

       [[ 17,  27,  35],
        [ 17,  27,  35],
        [ 14,  24,  31],
        ...,
        [ 48,  67,  76],
        [ 41,  61,  68],
        [ 42,  61,  69]]], dtype=uint8)]"
Image_1065.jpg,573,174,190,177,1000,665,763,351,190,daskShared_local/images/Image_1065.jpg,1065,"[array([[[ 45, 134, 200],
        [ 49, 137, 201],
        [ 46, 133, 200],
        ...,
        [ 31, 130, 197],
        [ 33, 132, 195],
        [ 17, 128, 194]],

       [[ 43, 135, 200],
        [ 47, 135, 199],
        [ 47, 134, 201],
        ...,
        [ 18, 129, 195],
        [ 26, 130, 196],
        [ 32, 132, 197]],

       [[ 42, 134, 199],
        [ 41, 133, 200],
        [ 42, 134, 201],
        ...,
        [ 22, 131, 196],
        [ 19, 129, 195],
        [ 29, 130, 198]],

       ...,

       [[ 17, 105, 129],
        [ 16,  92, 112],
        [ 31,  90, 105],
        ...,
        [ 15,  84,  95],
        [ 15,  83,  91],
        [ 12,  80,  89]],

       [[  7, 101, 125],
        [ 14,  96, 119],
        [  8,  78,  91],
        ...,
        [ 23,  87, 103],
        [ 13,  81,  92],
        [ 13,  80,  89]],

       [[  0,  96, 120],
        [  5,  99, 124],
        [ 13,  92, 113],
        ...,
        [  6,  87, 122],
        [ 17,  81,  97],
        [  8,  78,  90]]], dtype=uint8)]"
Image_1066.jpg,746,511,1305,1509,3072,2304,2051,2020,1509,daskShared_local/images/Image_1066.jpg,1066,"[array([[[108,  97,  96],
        [ 97,  88,  85],
        [ 98,  94,  92],
        ...,
        [ 80,  52,  72],
        [ 75,  48,  69],
        [ 86,  62,  77]],

       [[111, 103, 104],
        [104,  96,  98],
        [121, 117, 116],
        ...,
        [ 80,  57,  72],
        [ 74,  50,  68],
        [ 79,  55,  74]],

       [[115, 114, 111],
        [115, 112, 112],
        [119, 118, 117],
        ...,
        [ 89,  66,  81],
        [ 83,  61,  77],
        [ 84,  60,  79]],

       ...,

       [[  7, 111, 121],
        [  6, 112, 121],
        [  7, 111, 121],
        ...,
        [ 32, 112, 134],
        [ 39, 121, 142],
        [ 42, 126, 147]],

       [[  7, 111, 119],
        [  6, 111, 120],
        [  8, 110, 122],
        ...,
        [ 30, 116, 135],
        [ 36, 123, 142],
        [ 39, 125, 144]],

       [[  5, 107, 123],
        [  6, 109, 124],
        [  6, 109, 123],
        ...,
        [ 29, 119, 136],
        [ 35, 123, 141],
        [ 37, 123, 142]]], dtype=uint8)]"
Image_1067.jpg,197,334,283,209,1024,768,480,543,283,daskShared_local/images/Image_1067.jpg,1067,"[array([[[ 93, 150, 169],
        [ 86, 140, 155],
        [ 83, 135, 148],
        ...,
        [ 31,  42,  64],
        [ 10,  23,  45],
        [ 41,  55,  77]],

       [[116, 173, 193],
        [106, 164, 179],
        [101, 157, 169],
        ...,
        [ 24,  31,  55],
        [ 39,  47,  73],
        [ 25,  35,  60]],

       [[113, 171, 193],
        [121, 180, 196],
        [117, 176, 189],
        ...,
        [ 36,  40,  67],
        [ 32,  38,  64],
        [ 36,  42,  68]],

       ...,

       [[ 19,  55, 107],
        [ 73, 123, 166],
        [ 76, 138, 154],
        ...,
        [ 24,  10,  10],
        [ 21,   8,   7],
        [ 15,   1,   1]],

       [[ 56,  95, 144],
        [ 96, 148, 186],
        [144, 207, 219],
        ...,
        [ 16,   2,   2],
        [ 16,   2,   2],
        [ 15,   2,   2]],

       [[ 56, 100, 135],
        [127, 181, 206],
        [162, 223, 226],
        ...,
        [ 18,   4,   4],
        [ 20,   6,   6],
        [ 27,  13,  13]]], dtype=uint8)]"
Image_1068.jpg,497,138,212,180,800,600,709,318,212,daskShared_local/images/Image_1068.jpg,1068,"[array([[[  5,  34,  79],
        [ 10,  22,  70],
        [  7,  20,  64],
        ...,
        [  5,  10,  16],
        [ 11,  14,  21],
        [ 11,  14,  21]],

       [[  1,  45, 115],
        [  3,  32,  90],
        [  6,  26,  72],
        ...,
        [  9,  12,  19],
        [  9,  12,  19],
        [  3,   6,  13]],

       [[  4,  87, 169],
        [  1,  75, 146],
        [  1,  52, 114],
        ...,
        [  8,  11,  18],
        [  5,   8,  15],
        [  2,   5,  13]],

       ...,

       [[206, 176, 122],
        [219, 192, 145],
        [207, 184, 144],
        ...,
        [ 28,  20,  19],
        [ 24,  13,  12],
        [ 28,  16,  12]],

       [[216, 190, 141],
        [230, 206, 162],
        [217, 194, 154],
        ...,
        [ 24,  20,  17],
        [ 21,  16,  12],
        [ 30,  23,  17]],

       [[215, 192, 146],
        [225, 206, 164],
        [218, 198, 157],
        ...,
        [ 17,  16,  12],
        [ 17,  14,   9],
        [ 25,  22,  15]]], dtype=uint8)]"
Image_1069.jpg,104,105,415,309,800,533,519,414,415,daskShared_local/images/Image_1069.jpg,1069,"[array([[[  4,  12,  60],
        [  2,  10,  56],
        [  1,   8,  55],
        ...,
        [  7,  18,  68],
        [  6,  18,  70],
        [  3,  17,  67]],

       [[  3,  10,  55],
        [  5,  12,  58],
        [  4,  11,  57],
        ...,
        [  7,  18,  70],
        [ 10,  20,  73],
        [  8,  19,  71]],

       [[  4,  11,  55],
        [  4,   9,  56],
        [  3,  12,  55],
        ...,
        [  8,  18,  72],
        [  9,  19,  72],
        [  7,  17,  71]],

       ...,

       [[  6,  13,  57],
        [  8,  15,  59],
        [  8,  15,  59],
        ...,
        [ 73,  67,  30],
        [ 68,  54,  21],
        [ 81,  60,  26]],

       [[  5,  15,  57],
        [  6,  14,  57],
        [  8,  14,  59],
        ...,
        [ 95,  79,  40],
        [ 89,  67,  23],
        [ 93,  63,  16]],

       [[  5,  12,  55],
        [ 10,  15,  57],
        [  6,  15,  58],
        ...,
        [143, 127,  94],
        [141, 115,  75],
        [146, 111,  65]]], dtype=uint8)]"
Image_107.jpg,291,370,175,146,1024,683,466,516,175,daskShared_local/images/Image_107.jpg,107,"[array([[[168, 188, 189],
        [187, 207, 205],
        [196, 213, 208],
        ...,
        [ 76,  79,  79],
        [ 68,  79,  75],
        [ 58,  67,  64]],

       [[158, 179, 180],
        [173, 192, 191],
        [187, 202, 196],
        ...,
        [ 63,  62,  63],
        [ 54,  61,  60],
        [ 49,  54,  55]],

       [[157, 177, 177],
        [167, 185, 181],
        [184, 197, 188],
        ...,
        [ 52,  48,  48],
        [ 52,  54,  56],
        [ 53,  54,  56]],

       ...,

       [[  0, 104, 131],
        [  0, 104, 131],
        [  0, 104, 131],
        ...,
        [  1, 112, 139],
        [  0, 113, 139],
        [  0, 113, 139]],

       [[  0, 104, 131],
        [  0, 104, 131],
        [  0, 104, 131],
        ...,
        [  1, 112, 139],
        [  0, 113, 139],
        [  0, 113, 139]],

       [[  0, 104, 131],
        [  0, 104, 131],
        [  0, 104, 131],
        ...,
        [  1, 112, 139],
        [  0, 113, 139],
        [  0, 113, 139]]], dtype=uint8)]"
Image_1070.jpg,97,374,419,305,1715,1286,516,679,419,daskShared_local/images/Image_1070.jpg,1070,"[array([[[143, 153, 142],
        [140, 148, 137],
        [141, 149, 138],
        ...,
        [ 59,  54,  48],
        [ 73,  78,  54],
        [101, 104,  73]],

       [[144, 152, 141],
        [142, 149, 139],
        [141, 150, 139],
        ...,
        [ 87,  80,  61],
        [ 98,  98,  76],
        [106, 108,  91]],

       [[144, 157, 143],
        [142, 154, 143],
        [143, 153, 143],
        ...,
        [100,  97,  78],
        [102, 104,  88],
        [ 88, 100,  85]],

       ...,

       [[163, 167, 171],
        [166, 166, 176],
        [166, 173, 189],
        ...,
        [205, 215, 222],
        [209, 219, 222],
        [210, 220, 222]],

       [[159, 164, 166],
        [166, 166, 173],
        [173, 172, 187],
        ...,
        [199, 209, 224],
        [202, 216, 229],
        [208, 219, 228]],

       [[158, 163, 162],
        [164, 168, 170],
        [171, 180, 186],
        ...,
        [200, 201, 223],
        [201, 207, 229],
        [202, 217, 230]]], dtype=uint8)]"
Image_1071.jpg,312,285,140,110,1280,720,452,395,140,daskShared_local/images/Image_1071.jpg,1071,"[array([[[  0,  60, 133],
        [  0,  60, 133],
        [  0,  60, 133],
        ...,
        [  0,  62, 139],
        [  0,  62, 139],
        [  0,  62, 139]],

       [[  0,  60, 133],
        [  0,  60, 133],
        [  0,  60, 133],
        ...,
        [  0,  62, 139],
        [  0,  62, 139],
        [  0,  62, 139]],

       [[  0,  60, 133],
        [  0,  60, 133],
        [  0,  60, 133],
        ...,
        [  0,  62, 138],
        [  0,  62, 138],
        [  0,  62, 138]],

       ...,

       [[ 32, 106, 134],
        [ 32, 106, 134],
        [ 32, 106, 134],
        ...,
        [ 21,  95, 130],
        [ 21,  95, 131],
        [ 20,  96, 132]],

       [[ 32, 106, 132],
        [ 32, 106, 132],
        [ 32, 106, 132],
        ...,
        [ 21,  95, 130],
        [ 21,  96, 131],
        [ 20,  96, 132]],

       [[ 31, 105, 130],
        [ 31, 105, 130],
        [ 31, 105, 130],
        ...,
        [ 22,  96, 131],
        [ 21,  96, 131],
        [ 20,  96, 132]]], dtype=uint8)]"
Image_1072.jpg,341,19,616,519,1190,595,957,538,616,daskShared_local/images/Image_1072.jpg,1072,"[array([[[203, 220, 231],
        [201, 219, 230],
        [205, 222, 234],
        ...,
        [205, 217, 207],
        [205, 217, 207],
        [203, 216, 206]],

       [[198, 216, 226],
        [198, 217, 227],
        [204, 222, 233],
        ...,
        [205, 217, 207],
        [205, 217, 207],
        [205, 217, 207]],

       [[202, 221, 231],
        [204, 223, 230],
        [209, 226, 235],
        ...,
        [205, 218, 208],
        [204, 217, 207],
        [205, 217, 207]],

       ...,

       [[ 54,  36,  35],
        [ 54,  39,  37],
        [ 51,  31,  34],
        ...,
        [156,  75,  61],
        [158,  88,  77],
        [155,  93,  82]],

       [[ 98,  50,  59],
        [ 58,  37,  38],
        [ 48,  35,  40],
        ...,
        [146,  71,  61],
        [147,  80,  70],
        [147,  86,  77]],

       [[146,  66,  92],
        [ 71,  34,  41],
        [ 48,  34,  37],
        ...,
        [137,  70,  61],
        [137,  72,  61],
        [145,  80,  71]]], dtype=uint8)]"
Image_1073.jpg,1568,523,989,600,4100,2660,2557,1123,989,daskShared_local/images/Image_1073.jpg,1073,"[array([[[176, 166, 156],
        [175, 163, 152],
        [174, 161, 146],
        ...,
        [149, 141, 126],
        [151, 143, 132],
        [149, 140, 128]],

       [[178, 165, 155],
        [180, 169, 160],
        [177, 167, 151],
        ...,
        [147, 139, 123],
        [147, 139, 126],
        [149, 140, 128]],

       [[177, 164, 158],
        [177, 168, 158],
        [177, 168, 159],
        ...,
        [146, 138, 124],
        [149, 142, 126],
        [148, 141, 126]],

       ...,

       [[160, 143, 122],
        [158, 141, 119],
        [159, 143, 123],
        ...,
        [138, 126, 103],
        [143, 133, 104],
        [127, 110,  79]],

       [[163, 147, 131],
        [160, 145, 126],
        [160, 144, 126],
        ...,
        [129, 113,  86],
        [146, 132, 110],
        [145, 129, 105]],

       [[162, 145, 126],
        [163, 147, 130],
        [160, 146, 126],
        ...,
        [125, 106,  77],
        [129, 112,  87],
        [131, 114,  84]]], dtype=uint8)]"
Image_1074.jpg,341,120,190,205,770,422,531,325,205,daskShared_local/images/Image_1074.jpg,1074,"[array([[[105, 108,  99],
        [101, 111, 102],
        [104, 108,  87],
        ...,
        [ 28, 107, 197],
        [ 23, 103, 190],
        [ 19,  99, 186]],

       [[121, 119,  94],
        [118, 118,  92],
        [110, 100,  70],
        ...,
        [ 27, 107, 196],
        [ 25, 105, 194],
        [ 24, 104, 191]],

       [[204, 187, 132],
        [192, 174, 117],
        [179, 145,  96],
        ...,
        [ 25, 104, 196],
        [ 28, 108, 197],
        [ 31, 111, 198]],

       ...,

       [[ 40,  58,  21],
        [ 45,  61,  31],
        [ 39,  51,  28],
        ...,
        [  2,  20,  43],
        [  2,  20,  40],
        [  3,  21,  41]],

       [[ 33,  48,  27],
        [ 25,  39,  21],
        [ 15,  26,  19],
        ...,
        [  3,  21,  43],
        [  3,  21,  41],
        [  3,  21,  41]],

       [[ 18,  34,  24],
        [  6,  18,  14],
        [  4,  13,  17],
        ...,
        [  3,  21,  43],
        [  3,  21,  41],
        [  2,  21,  38]]], dtype=uint8)]"
Image_1075.jpg,437,194,201,201,900,600,638,395,201,daskShared_local/images/Image_1075.jpg,1075,"[array([[[  5, 132, 237],
        [  4, 133, 237],
        [  4, 132, 239],
        ...,
        [  0,  88, 206],
        [  0,  89, 207],
        [  1,  90, 208]],

       [[  3, 132, 236],
        [  3, 132, 236],
        [  3, 131, 238],
        ...,
        [  0,  88, 206],
        [  0,  88, 206],
        [  0,  89, 207]],

       [[  3, 132, 236],
        [  1, 132, 238],
        [  1, 132, 238],
        ...,
        [  0,  88, 208],
        [  0,  88, 208],
        [  0,  89, 207]],

       ...,

       [[206, 187, 131],
        [203, 178, 122],
        [205, 176, 118],
        ...,
        [127, 161, 163],
        [ 59,  97, 110],
        [ 33,  71, 102]],

       [[130, 117,  49],
        [175, 156,  88],
        [160, 136,  66],
        ...,
        [104, 138, 140],
        [ 43,  80,  95],
        [ 27,  70, 104]],

       [[100,  92,  17],
        [103,  89,  14],
        [115,  96,  19],
        ...,
        [ 77, 110, 115],
        [ 50,  87, 106],
        [ 25,  68, 110]]], dtype=uint8)]"
Image_1076.jpg,97,102,168,149,500,375,265,251,168,daskShared_local/images/Image_1076.jpg,1076,"[array([[[ 85, 151, 167],
        [ 99, 162, 178],
        [100, 160, 174],
        ...,
        [ 66, 109, 125],
        [ 57, 101, 119],
        [ 44,  90, 115]],

       [[ 47, 116, 134],
        [ 52, 119, 136],
        [ 54, 117, 133],
        ...,
        [ 52,  97, 115],
        [ 48,  93, 113],
        [ 37,  83, 109]],

       [[ 41, 114, 134],
        [ 43, 114, 132],
        [ 44, 111, 129],
        ...,
        [ 43,  88, 109],
        [ 41,  87, 109],
        [ 31,  77, 102]],

       ...,

       [[ 23, 108, 131],
        [ 24, 109, 132],
        [ 23, 108, 132],
        ...,
        [167, 149, 135],
        [164, 146, 131],
        [171, 154, 135]],

       [[ 23, 107, 131],
        [ 24, 108, 132],
        [ 24, 107, 131],
        ...,
        [167, 150, 133],
        [161, 144, 127],
        [164, 150, 129]],

       [[ 24, 106, 130],
        [ 25, 108, 132],
        [ 25, 107, 131],
        ...,
        [166, 149, 131],
        [159, 143, 124],
        [161, 149, 127]]], dtype=uint8)]"
Image_1077.jpg,318,272,261,232,750,740,579,504,261,daskShared_local/images/Image_1077.jpg,1077,"[array([[[ 56, 212, 239],
        [ 53, 212, 234],
        [ 49, 210, 226],
        ...,
        [  8, 197, 216],
        [ 11, 196, 219],
        [ 10, 194, 218]],

       [[ 31, 201, 224],
        [ 33, 202, 222],
        [ 37, 204, 221],
        ...,
        [ 12, 200, 220],
        [ 10, 196, 219],
        [ 10, 194, 218]],

       [[ 15, 198, 216],
        [ 20, 200, 218],
        [ 28, 206, 223],
        ...,
        [ 15, 202, 221],
        [ 10, 196, 218],
        [ 10, 195, 217]],

       ...,

       [[139, 183, 117],
        [141, 184, 125],
        [143, 184, 134],
        ...,
        [129, 169, 175],
        [135, 180, 177],
        [143, 188, 185]],

       [[134, 185, 118],
        [135, 184, 125],
        [137, 184, 133],
        ...,
        [131, 167, 175],
        [130, 171, 171],
        [139, 181, 181]],

       [[133, 181, 121],
        [132, 179, 125],
        [131, 179, 131],
        ...,
        [137, 168, 178],
        [132, 168, 174],
        [137, 173, 180]]], dtype=uint8)]"
Image_1078.jpg,630,440,225,202,1024,672,855,642,225,daskShared_local/images/Image_1078.jpg,1078,"[array([[[117, 118, 128],
        [120, 122, 131],
        [134, 134, 141],
        ...,
        [121, 120,  75],
        [134, 132,  82],
        [159, 158, 105]],

       [[120, 124, 136],
        [119, 123, 135],
        [120, 125, 134],
        ...,
        [ 94,  91,  51],
        [111, 106,  60],
        [145, 142,  91]],

       [[129, 130, 142],
        [123, 126, 138],
        [119, 123, 131],
        ...,
        [ 92,  90,  65],
        [107, 104,  72],
        [136, 134,  98]],

       ...,

       [[ 33,  92, 150],
        [ 32,  91, 150],
        [ 31,  90, 150],
        ...,
        [ 49, 126, 208],
        [ 49, 129, 218],
        [ 49, 131, 227]],

       [[ 32,  91, 148],
        [ 32,  91, 148],
        [ 32,  91, 150],
        ...,
        [ 80, 160, 245],
        [ 64, 147, 241],
        [ 55, 142, 241]],

       [[ 30,  90, 144],
        [ 31,  90, 145],
        [ 32,  91, 148],
        ...,
        [ 59, 143, 240],
        [ 57, 143, 246],
        [ 43, 133, 240]]], dtype=uint8)]"
Image_1079.jpg,305,105,234,279,1000,667,539,384,279,daskShared_local/images/Image_1079.jpg,1079,"[array([[[159, 157, 162],
        [177, 171, 170],
        [192, 182, 178],
        ...,
        [176, 159, 143],
        [174, 156, 141],
        [164, 145, 131]],

       [[205, 191, 184],
        [215, 200, 188],
        [226, 209, 195],
        ...,
        [217, 200, 184],
        [206, 189, 173],
        [188, 171, 156]],

       [[233, 212, 195],
        [250, 230, 209],
        [254, 232, 209],
        ...,
        [210, 193, 177],
        [187, 169, 153],
        [165, 147, 131]],

       ...,

       [[ 25, 110, 165],
        [ 25, 110, 165],
        [ 24, 109, 164],
        ...,
        [ 50,  36,  25],
        [ 48,  34,  18],
        [ 57,  42,  18]],

       [[ 23, 108, 163],
        [ 23, 108, 163],
        [ 23, 108, 163],
        ...,
        [ 37,  24,  15],
        [ 38,  26,  15],
        [ 38,  26,  13]],

       [[ 24, 109, 164],
        [ 25, 110, 165],
        [ 25, 110, 165],
        ...,
        [ 33,  23,  14],
        [ 33,  22,  16],
        [ 26,  15,  12]]], dtype=uint8)]"
Image_108.jpg,192,202,479,336,1599,1065,671,538,479,daskShared_local/images/Image_108.jpg,108,"[array([[[  5,   1,   2],
        [  5,   1,   2],
        [  5,   1,   2],
        ...,
        [  4,   0,   1],
        [  4,   0,   1],
        [  4,   0,   1]],

       [[  5,   1,   2],
        [  5,   1,   2],
        [  5,   1,   2],
        ...,
        [  4,   0,   1],
        [  4,   0,   1],
        [  4,   0,   1]],

       [[  5,   1,   2],
        [  5,   1,   2],
        [  5,   1,   2],
        ...,
        [  4,   0,   1],
        [  4,   0,   1],
        [  4,   0,   1]],

       ...,

       [[  2,   0,   1],
        [  2,   0,   1],
        [  2,   0,   1],
        ...,
        [154, 195, 201],
        [138, 168, 164],
        [143, 178, 159]],

       [[  2,   0,   1],
        [  2,   0,   1],
        [  2,   0,   1],
        ...,
        [102, 143, 149],
        [115, 137, 146],
        [185, 210, 199]],

       [[  5,   0,   1],
        [  4,   0,   1],
        [  4,   0,   1],
        ...,
        [111, 152, 163],
        [ 50,  62,  71],
        [175, 191, 193]]], dtype=uint8)]"
Image_1080.jpg,400,2,78,65,530,180,478,67,78,daskShared_local/images/Image_1080.jpg,1080,"[array([[[  1,  18,  62],
        [  1,  18,  63],
        [  1,  17,  62],
        ...,
        [ 60,  76, 111],
        [ 49,  66, 111],
        [ 55,  72, 111]],

       [[  1,  16,  62],
        [  0,  17,  63],
        [  1,  16,  62],
        ...,
        [ 62,  81, 113],
        [ 54,  72, 117],
        [ 58,  77, 115]],

       [[  1,  18,  62],
        [  1,  19,  63],
        [  1,  17,  62],
        ...,
        [ 58,  74, 110],
        [ 47,  64, 109],
        [ 53,  69, 109]],

       ...,

       [[249, 222, 131],
        [250, 230, 140],
        [248, 215, 124],
        ...,
        [ 46,  33,  60],
        [ 45,  30,  59],
        [ 46,  32,  59]],

       [[252, 232, 153],
        [253, 240, 161],
        [252, 225, 147],
        ...,
        [ 48,  35,  61],
        [ 48,  33,  62],
        [ 48,  34,  61]],

       [[250, 225, 138],
        [251, 233, 147],
        [249, 219, 131],
        ...,
        [ 47,  34,  60],
        [ 46,  31,  60],
        [ 46,  32,  60]]], dtype=uint8)]"
Image_1081.jpg,757,258,361,319,1200,906,1118,577,361,daskShared_local/images/Image_1081.jpg,1081,"[array([[[ 74,  70,  87],
        [ 41,  38,  55],
        [ 66,  62,  77],
        ...,
        [ 19,  47,  71],
        [ 18,  46,  70],
        [ 13,  43,  67]],

       [[137, 132, 147],
        [ 90,  87, 101],
        [ 55,  51,  66],
        ...,
        [ 22,  49,  74],
        [ 19,  48,  73],
        [ 14,  47,  71]],

       [[129, 123, 131],
        [102,  96, 106],
        [ 98,  92, 103],
        ...,
        [ 18,  49,  73],
        [ 15,  50,  74],
        [  9,  48,  72]],

       ...,

       [[ 67, 103, 116],
        [ 77, 120, 136],
        [ 89, 135, 156],
        ...,
        [ 26,  53,  72],
        [ 33,  58,  78],
        [ 33,  63,  79]],

       [[ 59,  94, 109],
        [ 77, 117, 134],
        [110, 152, 171],
        ...,
        [ 27,  53,  73],
        [ 31,  55,  74],
        [ 29,  56,  73]],

       [[ 60,  94, 109],
        [ 76, 113, 129],
        [106, 143, 162],
        ...,
        [ 35,  61,  81],
        [ 46,  68,  87],
        [ 41,  65,  82]]], dtype=uint8)]"
Image_1082.jpg,284,128,147,128,800,505,431,256,147,daskShared_local/images/Image_1082.jpg,1082,"[array([[[ 48,  76,  71],
        [ 57,  87,  80],
        [ 65,  98,  90],
        ...,
        [  9,  27,  41],
        [  7,  24,  39],
        [  8,  23,  38]],

       [[ 44,  74,  70],
        [ 49,  81,  76],
        [ 50,  85,  78],
        ...,
        [ 26,  42,  56],
        [ 27,  42,  56],
        [ 26,  40,  54]],

       [[ 29,  61,  59],
        [ 29,  63,  59],
        [ 25,  62,  57],
        ...,
        [ 51,  66,  78],
        [ 56,  70,  83],
        [ 54,  67,  80]],

       ...,

       [[ 85,  90,  56],
        [ 86,  91,  56],
        [ 89,  93,  57],
        ...,
        [139, 135, 111],
        [153, 148, 122],
        [170, 164, 138]],

       [[ 88,  91,  58],
        [ 92,  95,  61],
        [ 97,  99,  64],
        ...,
        [140, 137, 114],
        [164, 158, 134],
        [185, 177, 152]],

       [[ 90,  91,  59],
        [ 97,  98,  65],
        [104, 106,  71],
        ...,
        [159, 154, 133],
        [178, 171, 148],
        [188, 178, 156]]], dtype=uint8)]"
Image_1083.jpg,425,209,131,169,900,600,556,378,169,daskShared_local/images/Image_1083.jpg,1083,"[array([[[  4, 108, 163],
        [  4, 108, 163],
        [  5, 109, 164],
        ...,
        [  5, 119, 171],
        [  5, 119, 171],
        [  5, 119, 171]],

       [[  4, 108, 163],
        [  4, 108, 163],
        [  5, 109, 164],
        ...,
        [  5, 119, 171],
        [  5, 119, 171],
        [  5, 119, 171]],

       [[  4, 108, 163],
        [  4, 108, 163],
        [  5, 109, 164],
        ...,
        [  4, 118, 170],
        [  4, 118, 170],
        [  4, 118, 170]],

       ...,

       [[ 98, 101,  44],
        [132, 134,  77],
        [159, 159, 103],
        ...,
        [  4,  94, 142],
        [  4,  94, 142],
        [  4,  94, 142]],

       [[133, 133,  77],
        [154, 154,  98],
        [174, 175, 120],
        ...,
        [  7,  95, 143],
        [  7,  95, 143],
        [  7,  95, 143]],

       [[172, 172, 118],
        [158, 158, 104],
        [163, 163, 110],
        ...,
        [  7,  95, 143],
        [  7,  95, 143],
        [  7,  95, 143]]], dtype=uint8)]"
Image_1084.jpg,772,159,239,186,1050,700,1011,345,239,daskShared_local/images/Image_1084.jpg,1084,"[array([[[  0, 108, 103],
        [  2, 103, 100],
        [ 10, 106, 106],
        ...,
        [ 18,  35,  44],
        [ 18,  46,  48],
        [ 44,  90,  85]],

       [[  2, 121, 119],
        [  6, 133, 130],
        [ 25, 164, 158],
        ...,
        [ 18,  40,  47],
        [ 15,  50,  52],
        [ 27,  66,  64]],

       [[ 10, 152, 146],
        [  8, 163, 154],
        [  9, 180, 167],
        ...,
        [ 15,  57,  55],
        [ 19,  65,  62],
        [ 24,  41,  54]],

       ...,

       [[ 38,  47,  52],
        [ 38,  47,  52],
        [ 35,  44,  49],
        ...,
        [ 48,  30,  36],
        [ 19,  22,  17],
        [ 20,  74,  56]],

       [[ 38,  47,  52],
        [ 38,  47,  52],
        [ 37,  46,  51],
        ...,
        [ 35,  41,  47],
        [ 16,  30,  34],
        [  5,  23,  25]],

       [[ 34,  45,  49],
        [ 34,  45,  49],
        [ 34,  45,  49],
        ...,
        [ 35,  39,  47],
        [ 35,  36,  47],
        [ 34,  22,  33]]], dtype=uint8)]"
Image_1085.jpg,357,102,305,299,1024,670,662,401,305,daskShared_local/images/Image_1085.jpg,1085,"[array([[[  3,  62, 105],
        [  6,  64, 110],
        [  8,  68, 116],
        ...,
        [ 11,  21,  44],
        [  7,  18,  37],
        [  3,  15,  28]],

       [[  2,  63, 107],
        [  3,  63, 110],
        [  3,  58, 108],
        ...,
        [ 10,  21,  42],
        [  7,  18,  36],
        [  4,  16,  29]],

       [[  0,  68, 109],
        [  1,  67, 112],
        [  7,  72, 119],
        ...,
        [  6,  17,  37],
        [  5,  16,  33],
        [  6,  18,  32]],

       ...,

       [[ 18,  34,  11],
        [ 17,  44,  10],
        [ 36,  81,  35],
        ...,
        [  6,  17,  20],
        [ 11,  22,  24],
        [ 13,  25,  28]],

       [[ 18,  48,  18],
        [ 45,  87,  49],
        [ 68, 124,  75],
        ...,
        [  9,  21,  22],
        [ 15,  26,  28],
        [ 17,  29,  31]],

       [[ 45,  87,  43],
        [ 70, 125,  69],
        [ 48, 116,  44],
        ...,
        [  6,  20,  21],
        [ 11,  25,  26],
        [ 12,  26,  27]]], dtype=uint8)]"
Image_1086.jpg,266,325,165,119,900,599,431,444,165,daskShared_local/images/Image_1086.jpg,1086,"[array([[[ 67, 136, 213],
        [ 68, 137, 214],
        [ 68, 137, 214],
        ...,
        [234, 253, 255],
        [245, 255, 253],
        [249, 254, 248]],

       [[ 67, 136, 213],
        [ 68, 137, 214],
        [ 68, 137, 214],
        ...,
        [232, 248, 251],
        [247, 255, 251],
        [251, 255, 246]],

       [[ 68, 136, 213],
        [ 68, 136, 214],
        [ 69, 136, 214],
        ...,
        [239, 246, 242],
        [250, 251, 243],
        [254, 253, 244]],

       ...,

       [[ 44,  83, 160],
        [ 44,  83, 160],
        [ 44,  83, 160],
        ...,
        [ 46,  87, 166],
        [ 46,  87, 166],
        [ 46,  87, 166]],

       [[ 44,  83, 160],
        [ 44,  83, 160],
        [ 44,  83, 160],
        ...,
        [ 46,  87, 166],
        [ 46,  87, 166],
        [ 46,  87, 166]],

       [[ 44,  83, 160],
        [ 44,  83, 160],
        [ 44,  83, 160],
        ...,
        [ 46,  87, 166],
        [ 46,  87, 166],
        [ 46,  87, 166]]], dtype=uint8)]"
Image_1087.jpg,281,161,262,233,1000,541,543,394,262,daskShared_local/images/Image_1087.jpg,1087,"[array([[[ 12, 136, 173],
        [ 30, 133, 172],
        [ 48, 130, 169],
        ...,
        [ 27,  77,  97],
        [ 33,  72,  87],
        [ 38,  75,  88]],

       [[ 14, 134, 170],
        [ 32, 130, 168],
        [ 48, 124, 164],
        ...,
        [ 28,  77,  97],
        [ 33,  70,  86],
        [ 37,  69,  84]],

       [[ 14, 135, 168],
        [ 33, 131, 167],
        [ 49, 122, 161],
        ...,
        [ 26,  81, 101],
        [ 32,  73,  91],
        [ 35,  70,  88]],

       ...,

       [[  1,  60,  75],
        [ 11,  71,  87],
        [  6,  57,  72],
        ...,
        [165, 181, 209],
        [119, 136, 164],
        [ 90, 111, 134]],

       [[  1,  56,  74],
        [  8,  68,  88],
        [  5,  58,  76],
        ...,
        [ 89, 116, 144],
        [ 74,  98, 124],
        [ 79,  95, 117]],

       [[  0,  62,  78],
        [  1,  53,  71],
        [  2,  49,  66],
        ...,
        [128, 159, 179],
        [ 92, 120, 142],
        [135, 156, 181]]], dtype=uint8)]"
Image_1088.jpg,396,179,156,136,770,578,552,315,156,daskShared_local/images/Image_1088.jpg,1088,"[array([[[ 69,  74,  75],
        [ 68,  74,  76],
        [ 63,  68,  71],
        ...,
        [101, 104,  96],
        [102, 104,  98],
        [100, 102,  97]],

       [[ 66,  72,  72],
        [ 64,  70,  71],
        [ 58,  63,  65],
        ...,
        [100, 102,  97],
        [100, 102,  98],
        [ 98, 100,  96]],

       [[ 64,  70,  70],
        [ 62,  68,  68],
        [ 56,  61,  62],
        ...,
        [ 96,  98,  95],
        [ 95,  97,  95],
        [ 92,  94,  92]],

       ...,

       [[104, 108, 109],
        [ 79,  83,  84],
        [ 83,  87,  88],
        ...,
        [134, 135, 136],
        [156, 156, 157],
        [112, 112, 113]],

       [[103, 107, 108],
        [ 89,  93,  94],
        [ 91,  95,  96],
        ...,
        [109, 108, 107],
        [155, 154, 153],
        [127, 125, 125]],

       [[105, 109, 110],
        [ 97, 101, 102],
        [ 94,  98,  99],
        ...,
        [ 81,  80,  76],
        [139, 138, 135],
        [153, 152, 149]]], dtype=uint8)]"
Image_1089.jpg,292,357,193,158,1024,683,485,515,193,daskShared_local/images/Image_1089.jpg,1089,"[array([[[137, 155, 159],
        [141, 158, 165],
        [143, 160, 168],
        ...,
        [ 85,  88,  78],
        [ 79,  83,  67],
        [102, 105,  78]],

       [[121, 138, 148],
        [137, 153, 165],
        [156, 170, 183],
        ...,
        [ 86,  92,  82],
        [ 78,  83,  63],
        [100, 103,  74]],

       [[123, 138, 145],
        [134, 148, 157],
        [165, 176, 186],
        ...,
        [ 90,  98,  86],
        [ 74,  82,  60],
        [ 94,  97,  66]],

       ...,

       [[  0, 104, 131],
        [  0, 104, 131],
        [  0, 104, 131],
        ...,
        [  0, 113, 139],
        [  0, 113, 139],
        [  0, 113, 139]],

       [[  0, 104, 131],
        [  0, 104, 131],
        [  0, 104, 131],
        ...,
        [  0, 113, 139],
        [  0, 113, 139],
        [  0, 113, 139]],

       [[  0, 104, 131],
        [  0, 104, 131],
        [  0, 104, 131],
        ...,
        [  0, 113, 139],
        [  0, 113, 139],
        [  0, 113, 139]]], dtype=uint8)]"
Image_109.JPG,291,471,1531,1449,2560,1920,1822,1920,1531,daskShared_local/images/Image_109.JPG,109,"[array([[[ 82,  68,  23],
        [ 79,  65,  30],
        [ 98,  83,  48],
        ...,
        [190, 184, 155],
        [205, 197, 177],
        [205, 190, 175]],

       [[ 82,  67,  26],
        [ 80,  66,  29],
        [ 84,  71,  35],
        ...,
        [187, 172, 148],
        [200, 188, 159],
        [206, 190, 167]],

       [[ 82,  63,  30],
        [ 82,  68,  27],
        [ 88,  70,  30],
        ...,
        [156, 148, 110],
        [174, 165, 134],
        [182, 169, 134]],

       ...,

       [[ 78,  87,  27],
        [ 78,  83,  27],
        [ 75,  86,  25],
        ...,
        [ 90,  99,  30],
        [ 94, 102,  26],
        [ 94, 100,  30]],

       [[ 78,  84,  34],
        [ 79,  84,  29],
        [ 74,  87,  22],
        ...,
        [ 91, 100,  28],
        [ 88, 102,  26],
        [ 90, 101,  33]],

       [[ 81,  87,  32],
        [ 76,  87,  28],
        [ 71,  89,  27],
        ...,
        [ 92,  98,  32],
        [ 90, 100,  27],
        [ 92, 101,  31]]], dtype=uint8)]"
Image_1090.jpg,180,195,513,324,1599,1065,693,519,513,daskShared_local/images/Image_1090.jpg,1090,"[array([[[  4,   0,   1],
        [  4,   0,   1],
        [  4,   0,   1],
        ...,
        [  4,   0,   1],
        [  4,   0,   1],
        [  4,   0,   1]],

       [[  4,   0,   1],
        [  4,   0,   1],
        [  4,   0,   1],
        ...,
        [  4,   0,   1],
        [  4,   0,   1],
        [  4,   0,   1]],

       [[  4,   0,   1],
        [  4,   0,   1],
        [  4,   0,   1],
        ...,
        [  4,   0,   1],
        [  4,   0,   1],
        [  4,   0,   1]],

       ...,

       [[  4,   0,   1],
        [  4,   0,   1],
        [  4,   0,   1],
        ...,
        [183, 222, 195],
        [174, 209, 183],
        [154, 189, 172]],

       [[  4,   0,   1],
        [  4,   0,   1],
        [  4,   0,   1],
        ...,
        [164, 207, 185],
        [162, 201, 179],
        [175, 219, 217]],

       [[  4,   0,   1],
        [  4,   0,   1],
        [  4,   0,   1],
        ...,
        [150, 188, 164],
        [197, 238, 218],
        [158, 199, 198]]], dtype=uint8)]"
Image_1091.JPG,274,444,1561,1476,2560,1920,1835,1920,1561,daskShared_local/images/Image_1091.JPG,1091,"[array([[[ 76,  63,  23],
        [ 74,  64,  27],
        [ 72,  62,  21],
        ...,
        [100,  82,  38],
        [132, 112,  71],
        [152, 131, 106]],

       [[ 80,  68,  30],
        [ 79,  65,  28],
        [ 72,  59,  18],
        ...,
        [105,  91,  54],
        [127, 112,  67],
        [157, 140, 113]],

       [[ 83,  72,  30],
        [ 81,  70,  34],
        [ 74,  64,  22],
        ...,
        [136, 123, 102],
        [124, 112,  72],
        [150, 135,  97]],

       ...,

       [[ 80,  92,  30],
        [ 77,  88,  29],
        [ 75,  88,  26],
        ...,
        [ 94, 101,  29],
        [ 92,  99,  31],
        [ 89,  99,  24]],

       [[ 84,  92,  28],
        [ 76,  87,  29],
        [ 76,  86,  31],
        ...,
        [ 89, 102,  27],
        [ 93, 100,  28],
        [ 92, 100,  20]],

       [[ 91,  95,  24],
        [ 74,  91,  24],
        [ 78,  88,  26],
        ...,
        [ 91, 102,  25],
        [ 93, 100,  33],
        [ 91, 100,  27]]], dtype=uint8)]"
Image_1092.jpg,290,414,186,189,1024,768,476,603,189,daskShared_local/images/Image_1092.jpg,1092,"[array([[[182, 168, 165],
        [112,  93,  84],
        [ 85,  63,  50],
        ...,
        [ 81,  60,  39],
        [ 53,  34,  19],
        [ 45,  29,  14]],

       [[ 89,  77,  78],
        [114, 103,  94],
        [108,  95,  80],
        ...,
        [ 79,  57,  39],
        [ 57,  38,  23],
        [ 47,  30,  14]],

       [[ 97,  82,  62],
        [110,  85,  66],
        [106,  81,  66],
        ...,
        [ 78,  59,  42],
        [ 62,  46,  26],
        [ 61,  49,  24]],

       ...,

       [[220, 190, 158],
        [228, 195, 160],
        [230, 200, 163],
        ...,
        [198, 172, 137],
        [182, 155, 122],
        [178, 151, 118]],

       [[223, 197, 159],
        [235, 207, 170],
        [227, 201, 164],
        ...,
        [196, 166, 127],
        [191, 161, 123],
        [198, 168, 130]],

       [[238, 216, 175],
        [219, 199, 159],
        [228, 210, 172],
        ...,
        [199, 167, 128],
        [202, 169, 131],
        [199, 165, 127]]], dtype=uint8)]"
Image_1093.jpg,529,216,313,264,986,653,842,480,313,daskShared_local/images/Image_1093.jpg,1093,"[array([[[100,  95,  52],
        [109, 102,  58],
        [130, 122,  76],
        ...,
        [ 60, 117,  98],
        [ 60, 117,  98],
        [ 60, 117,  98]],

       [[102,  99,  57],
        [108, 103,  61],
        [138, 131,  86],
        ...,
        [ 61, 118,  99],
        [ 61, 118,  99],
        [ 60, 117,  98]],

       [[102, 101,  61],
        [101,  98,  57],
        [124, 119,  77],
        ...,
        [ 61, 118,  99],
        [ 61, 118,  99],
        [ 60, 117,  98]],

       ...,

       [[ 67,  88,  41],
        [ 67,  85,  42],
        [ 69,  87,  44],
        ...,
        [ 43,  68,  38],
        [ 45,  70,  40],
        [ 47,  72,  41]],

       [[ 63,  81,  39],
        [ 61,  79,  37],
        [ 65,  83,  40],
        ...,
        [ 42,  67,  37],
        [ 44,  69,  37],
        [ 45,  71,  37]],

       [[ 61,  78,  39],
        [ 60,  76,  37],
        [ 65,  82,  38],
        ...,
        [ 42,  67,  35],
        [ 43,  68,  36],
        [ 44,  70,  35]]], dtype=uint8)]"
Image_1094.jpg,650,228,338,315,2121,1063,988,543,338,daskShared_local/images/Image_1094.jpg,1094,"[array([[[104, 152, 166],
        [ 99, 147, 161],
        [ 89, 137, 151],
        ...,
        [153, 175, 182],
        [151, 174, 183],
        [153, 177, 186]],

       [[100, 149, 163],
        [104, 154, 168],
        [100, 150, 163],
        ...,
        [147, 166, 172],
        [146, 167, 172],
        [150, 170, 176]],

       [[ 93, 145, 158],
        [100, 152, 165],
        [100, 152, 165],
        ...,
        [149, 165, 168],
        [146, 164, 167],
        [147, 165, 168]],

       ...,

       [[ 53, 104, 123],
        [ 55, 106, 125],
        [ 54, 105, 124],
        ...,
        [160, 161, 146],
        [177, 178, 162],
        [168, 169, 152]],

       [[ 55, 106, 125],
        [ 54, 105, 124],
        [ 53, 104, 123],
        ...,
        [163, 164, 148],
        [165, 166, 150],
        [171, 172, 154]],

       [[ 54, 105, 124],
        [ 53, 104, 123],
        [ 53, 104, 123],
        ...,
        [171, 173, 157],
        [172, 174, 158],
        [159, 161, 145]]], dtype=uint8)]"
Image_1095.jpg,1069,1168,960,897,3840,2160,2029,2065,960,daskShared_local/images/Image_1095.jpg,1095,"[array([[[187, 196, 158],
        [187, 191, 152],
        [192, 183, 147],
        ...,
        [100,  87,  69],
        [ 55,  46,  41],
        [ 61,  53,  47]],

       [[198, 201, 166],
        [165, 159, 122],
        [123, 113,  88],
        ...,
        [103,  91,  73],
        [ 49,  43,  37],
        [ 35,  33,  26]],

       [[209, 212, 182],
        [192, 183, 147],
        [105,  94,  77],
        ...,
        [ 86,  72,  62],
        [ 53,  48,  45],
        [ 25,  24,  17]],

       ...,

       [[  5,  24,  30],
        [  5,  24,  31],
        [  5,  24,  31],
        ...,
        [  3,  15,  20],
        [  3,  14,  21],
        [  3,  13,  22]],

       [[  4,  23,  29],
        [  5,  24,  30],
        [  5,  24,  30],
        ...,
        [  3,  16,  22],
        [  3,  16,  23],
        [  2,  13,  22]],

       [[  5,  24,  30],
        [  4,  23,  29],
        [  4,  23,  29],
        ...,
        [  2,  17,  22],
        [  1,  15,  21],
        [  4,  15,  23]]], dtype=uint8)]"
Image_1096.jpg,63,134,128,114,525,340,191,248,128,daskShared_local/images/Image_1096.jpg,1096,"[array([[[ 27,  79,  97],
        [ 27,  79,  96],
        [ 28,  80,  96],
        ...,
        [ 68,  73,  38],
        [128, 133,  96],
        [166, 171, 134]],

       [[ 30,  81,  97],
        [ 29,  79,  94],
        [ 28,  78,  91],
        ...,
        [ 75,  84,  46],
        [137, 146, 108],
        [176, 185, 147]],

       [[ 35,  83,  97],
        [ 32,  80,  92],
        [ 27,  74,  82],
        ...,
        [ 91, 105,  64],
        [157, 173, 133],
        [196, 213, 173]],

       ...,

       [[ 52,  68,  63],
        [ 49,  74,  64],
        [ 46,  88,  69],
        ...,
        [ 13,  24,  10],
        [ 12,  23,   9],
        [ 12,  23,   9]],

       [[ 28,  50,  45],
        [ 29,  58,  47],
        [ 34,  73,  54],
        ...,
        [ 50,  61,  47],
        [ 33,  44,  30],
        [ 26,  38,  24]],

       [[ 13,  38,  32],
        [ 17,  47,  36],
        [ 27,  65,  46],
        ...,
        [ 69,  81,  67],
        [ 44,  56,  42],
        [ 35,  46,  32]]], dtype=uint8)]"
Image_1097.jpg,557,178,105,86,1000,700,662,264,105,daskShared_local/images/Image_1097.jpg,1097,"[array([[[  3, 160, 231],
        [  3, 160, 231],
        [  3, 160, 231],
        ...,
        [  0, 157, 231],
        [  0, 157, 230],
        [  0, 157, 230]],

       [[  3, 160, 231],
        [  3, 160, 231],
        [  3, 160, 231],
        ...,
        [  0, 157, 231],
        [  0, 157, 230],
        [  0, 157, 230]],

       [[  3, 160, 231],
        [  3, 160, 231],
        [  2, 160, 231],
        ...,
        [  0, 156, 230],
        [  0, 156, 229],
        [  0, 156, 229]],

       ...,

       [[122, 168, 185],
        [121, 166, 184],
        [104, 151, 171],
        ...,
        [  0, 151, 224],
        [  0, 152, 225],
        [  0, 152, 225]],

       [[101, 153, 168],
        [ 98, 150, 166],
        [ 70, 126, 144],
        ...,
        [  0, 151, 224],
        [  0, 151, 224],
        [  1, 152, 225]],

       [[ 99, 151, 166],
        [ 95, 148, 164],
        [ 66, 123, 141],
        ...,
        [  0, 151, 224],
        [  1, 151, 224],
        [  1, 152, 225]]], dtype=uint8)]"
Image_1098.jpg,389,29,1089,1008,1920,1080,1478,1037,1089,daskShared_local/images/Image_1098.jpg,1098,"[array([[[  0, 125, 157],
        [  0, 124, 155],
        [  0, 125, 157],
        ...,
        [ 49, 111,  96],
        [ 18,  82,  79],
        [ 21,  93,  86]],

       [[  0, 125, 156],
        [  1, 125, 156],
        [  0, 125, 157],
        ...,
        [ 32, 123, 111],
        [  6,  92,  95],
        [  2,  69,  75]],

       [[  0, 126, 156],
        [  1, 125, 156],
        [  0, 125, 157],
        ...,
        [ 25, 122, 113],
        [  4,  93,  97],
        [  2,  70,  77]],

       ...,

       [[ 92,  90,  50],
        [ 89,  86,  50],
        [ 92,  85,  48],
        ...,
        [ 18,  22,  19],
        [ 25,  26,  19],
        [ 33,  33,  23]],

       [[ 82,  79,  42],
        [ 83,  79,  44],
        [111, 104,  66],
        ...,
        [ 33,  32,  21],
        [ 38,  35,  23],
        [ 46,  44,  27]],

       [[ 79,  74,  37],
        [100,  96,  59],
        [115, 108,  70],
        ...,
        [ 44,  39,  26],
        [ 44,  40,  28],
        [ 45,  42,  27]]], dtype=uint8)]"
Image_1099.jpg,297,89,171,164,732,420,468,253,171,daskShared_local/images/Image_1099.jpg,1099,"[array([[[  1, 167, 217],
        [  1, 167, 217],
        [  1, 167, 217],
        ...,
        [ 68, 196, 232],
        [ 76, 201, 241],
        [ 69, 201, 240]],

       [[  1, 167, 217],
        [  1, 167, 217],
        [  1, 167, 217],
        ...,
        [ 61, 190, 224],
        [ 78, 198, 239],
        [ 79, 204, 245]],

       [[  2, 164, 216],
        [  2, 164, 216],
        [  1, 164, 215],
        ...,
        [ 79, 192, 223],
        [ 79, 196, 229],
        [ 77, 203, 236]],

       ...,

       [[197, 198, 179],
        [202, 203, 184],
        [198, 199, 180],
        ...,
        [  0,  18,  21],
        [  1,  25,  23],
        [  5,  43,  35]],

       [[188, 199, 187],
        [189, 201, 188],
        [190, 201, 187],
        ...,
        [  1,   3,   8],
        [  5,  17,  12],
        [ 23,  48,  38]],

       [[205, 217, 216],
        [205, 215, 216],
        [208, 218, 215],
        ...,
        [  0,   8,   3],
        [ 12,  31,  14],
        [ 53,  81,  54]]], dtype=uint8)]"
Image_11.jpg,613,219,385,423,1600,1070,998,642,423,daskShared_local/images/Image_11.jpg,11,"[array([[[ 24,  74, 145],
        [ 24,  74, 145],
        [ 24,  74, 145],
        ...,
        [ 28,  69, 133],
        [ 28,  69, 133],
        [ 28,  69, 133]],

       [[ 24,  74, 145],
        [ 24,  74, 145],
        [ 24,  74, 145],
        ...,
        [ 28,  69, 133],
        [ 28,  69, 133],
        [ 28,  69, 133]],

       [[ 24,  75, 142],
        [ 24,  75, 142],
        [ 24,  75, 142],
        ...,
        [ 28,  69, 133],
        [ 28,  69, 133],
        [ 28,  69, 133]],

       ...,

       [[175, 160, 134],
        [135, 126, 101],
        [167, 162, 135],
        ...,
        [220, 199, 151],
        [229, 205, 158],
        [192, 168, 123]],

       [[149, 147, 128],
        [129, 135, 125],
        [145, 156, 147],
        ...,
        [154, 137, 106],
        [198, 177, 142],
        [199, 175, 134]],

       [[149, 160, 149],
        [147, 155, 150],
        [134, 132, 124],
        ...,
        [168, 146, 120],
        [167, 146, 110],
        [181, 161, 124]]], dtype=uint8)]"
Image_110.jpg,289,410,180,188,1024,768,469,598,188,daskShared_local/images/Image_110.jpg,110,"[array([[[101,  65,  72],
        [ 89,  58,  59],
        [ 87,  65,  61],
        ...,
        [105,  86,  56],
        [108,  88,  55],
        [130, 108,  74]],

       [[131,  96, 103],
        [121,  92,  92],
        [130, 111, 103],
        ...,
        [ 99,  81,  58],
        [103,  83,  56],
        [ 95,  75,  42]],

       [[115,  93, 102],
        [119, 102, 100],
        [ 77,  66,  58],
        ...,
        [ 82,  63,  44],
        [102,  81,  59],
        [108,  84,  57]],

       ...,

       [[242, 216, 183],
        [232, 207, 171],
        [231, 210, 170],
        ...,
        [209, 178, 139],
        [208, 179, 139],
        [198, 170, 130]],

       [[237, 213, 179],
        [228, 205, 173],
        [228, 209, 174],
        ...,
        [201, 173, 136],
        [196, 168, 129],
        [193, 161, 120]],

       [[234, 208, 173],
        [223, 197, 164],
        [223, 198, 167],
        ...,
        [203, 174, 139],
        [194, 164, 125],
        [190, 157, 116]]], dtype=uint8)]"
Image_1100.jpg,436,372,217,207,1024,683,653,579,217,daskShared_local/images/Image_1100.jpg,1100,"[array([[[ 88,  74,  68],
        [ 79,  68,  69],
        [ 90,  81,  86],
        ...,
        [ 63,  41,  35],
        [ 61,  40,  32],
        [ 57,  39,  29]],

       [[ 70,  63,  67],
        [114, 100, 102],
        [113,  90,  88],
        ...,
        [ 55,  39,  39],
        [ 49,  35,  32],
        [ 52,  41,  37]],

       [[ 75,  66,  68],
        [130, 115, 116],
        [121,  99,  95],
        ...,
        [ 57,  41,  41],
        [ 56,  42,  40],
        [ 60,  48,  44]],

       ...,

       [[250, 228, 198],
        [242, 209, 183],
        [218, 186, 160],
        ...,
        [249, 225, 196],
        [242, 219, 192],
        [250, 240, 209]],

       [[204, 183, 154],
        [188, 157, 133],
        [236, 209, 184],
        ...,
        [244, 213, 178],
        [251, 216, 181],
        [242, 207, 170]],

       [[202, 182, 155],
        [215, 192, 169],
        [247, 242, 215],
        ...,
        [242, 205, 159],
        [232, 183, 140],
        [245, 192, 148]]], dtype=uint8)]"
Image_1101.jpg,539,95,298,292,1024,770,837,387,298,daskShared_local/images/Image_1101.jpg,1101,"[array([[[  2, 113, 185],
        [  2, 113, 185],
        [  2, 113, 185],
        ...,
        [ 40,  52,  58],
        [ 62,  74,  82],
        [ 57,  70,  78]],

       [[  1, 112, 184],
        [  1, 112, 184],
        [  2, 113, 185],
        ...,
        [ 51,  65,  74],
        [ 69,  83,  91],
        [ 52,  67,  77]],

       [[  0, 111, 183],
        [  1, 112, 184],
        [  1, 112, 184],
        ...,
        [ 58,  72,  81],
        [ 62,  79,  86],
        [ 46,  64,  72]],

       ...,

       [[ 75,  70,  57],
        [119, 112,  92],
        [156, 149, 115],
        ...,
        [ 33,  34,  33],
        [ 32,  32,  31],
        [ 34,  33,  31]],

       [[ 67,  63,  51],
        [102,  97,  79],
        [133, 128,  96],
        ...,
        [ 33,  33,  33],
        [ 38,  36,  36],
        [ 42,  39,  38]],

       [[ 61,  58,  48],
        [ 85,  84,  67],
        [107, 105,  75],
        ...,
        [ 46,  44,  45],
        [ 51,  47,  48],
        [ 51,  47,  46]]], dtype=uint8)]"
Image_1102.jpg,2253,254,597,540,3033,1757,2850,794,597,daskShared_local/images/Image_1102.jpg,1102,"[array([[[  0,  53, 217],
        [  0,  53, 217],
        [  0,  53, 217],
        ...,
        [  0,  53, 217],
        [  0,  53, 217],
        [  0,  53, 217]],

       [[  0,  53, 217],
        [  0,  53, 217],
        [  0,  53, 217],
        ...,
        [  0,  53, 217],
        [  0,  53, 217],
        [  0,  53, 217]],

       [[  0,  53, 217],
        [  0,  53, 217],
        [  0,  53, 217],
        ...,
        [  0,  53, 217],
        [  0,  53, 217],
        [  0,  53, 217]],

       ...,

       [[ 80,  92,  50],
        [ 81,  95,  53],
        [ 78,  91,  53],
        ...,
        [  0,  53, 217],
        [  0,  53, 217],
        [  0,  53, 217]],

       [[ 79,  91,  52],
        [ 79,  94,  54],
        [ 70,  83,  49],
        ...,
        [  0,  53, 217],
        [  0,  53, 217],
        [  0,  53, 217]],

       [[ 78,  90,  53],
        [ 76,  88,  51],
        [ 67,  78,  47],
        ...,
        [  0,  53, 217],
        [  0,  53, 217],
        [  0,  53, 217]]], dtype=uint8)]"
Image_1103.jpg,502,364,201,174,1024,678,703,538,201,daskShared_local/images/Image_1103.jpg,1103,"[array([[[159, 148, 128],
        [131, 115, 100],
        [ 88,  70,  60],
        ...,
        [163, 130, 114],
        [146, 118,  94],
        [204, 187, 159]],

       [[141, 130, 110],
        [129, 115, 102],
        [ 86,  68,  66],
        ...,
        [160, 128, 112],
        [119,  97,  84],
        [181, 164, 148]],

       [[148, 133, 107],
        [127, 105,  86],
        [109,  80,  73],
        ...,
        [138, 113,  90],
        [134, 111, 107],
        [144, 125, 132]],

       ...,

       [[240, 233, 205],
        [219, 212, 186],
        [223, 214, 183],
        ...,
        [233, 205, 160],
        [229, 200, 156],
        [234, 206, 158]],

       [[243, 233, 197],
        [233, 221, 181],
        [234, 219, 176],
        ...,
        [191, 170, 152],
        [161, 142, 127],
        [186, 164, 139]],

       [[250, 232, 192],
        [251, 232, 190],
        [242, 224, 176],
        ...,
        [239, 210, 155],
        [240, 217, 151],
        [240, 213, 146]]], dtype=uint8)]"
Image_1104.jpg,475,118,103,87,685,360,578,205,103,daskShared_local/images/Image_1104.jpg,1104,"[array([[[  1, 111, 152],
        [  1, 111, 152],
        [  0, 110, 151],
        ...,
        [  0, 101, 145],
        [  0, 101, 145],
        [  0, 101, 145]],

       [[  2, 112, 152],
        [  2, 111, 152],
        [  0, 110, 151],
        ...,
        [  0, 101, 145],
        [  0, 101, 145],
        [  0, 101, 145]],

       [[  5, 116, 156],
        [  5, 116, 156],
        [  1, 113, 153],
        ...,
        [  0, 101, 145],
        [  0, 101, 145],
        [  0, 101, 145]],

       ...,

       [[  9,  18,  36],
        [ 10,  19,  36],
        [ 11,  23,  36],
        ...,
        [  0,  83, 119],
        [  0,  83, 119],
        [  0,  83, 119]],

       [[  5,  15,  31],
        [  6,  16,  32],
        [ 11,  22,  32],
        ...,
        [  0,  83, 119],
        [  0,  83, 119],
        [  0,  83, 119]],

       [[  5,  15,  31],
        [  5,  15,  31],
        [ 11,  22,  32],
        ...,
        [  0,  83, 119],
        [  0,  83, 119],
        [  0,  83, 119]]], dtype=uint8)]"
Image_1105.jpg,329,260,130,134,1000,667,459,394,134,daskShared_local/images/Image_1105.jpg,1105,"[array([[[  3, 210, 228],
        [  2, 211, 227],
        [  4, 211, 227],
        ...,
        [ 49, 213, 235],
        [ 40, 213, 235],
        [ 36, 212, 235]],

       [[  2, 209, 227],
        [  3, 210, 227],
        [  4, 210, 227],
        ...,
        [ 45, 213, 235],
        [ 39, 213, 236],
        [ 38, 212, 236]],

       [[  7, 209, 226],
        [  8, 209, 226],
        [  8, 210, 226],
        ...,
        [ 41, 214, 236],
        [ 41, 213, 237],
        [ 44, 213, 237]],

       ...,

       [[182, 116,  56],
        [185, 119,  52],
        [185, 120,  37],
        ...,
        [231, 226, 233],
        [242, 237, 238],
        [250, 244, 243]],

       [[175, 113,  38],
        [176, 114,  33],
        [172, 110,  21],
        ...,
        [227, 225, 235],
        [239, 236, 241],
        [247, 243, 246]],

       [[168, 111,  22],
        [169, 111,  16],
        [162, 105,   7],
        ...,
        [229, 228, 239],
        [238, 236, 244],
        [245, 242, 248]]], dtype=uint8)]"
Image_1106.jpg,579,49,171,178,930,500,750,227,178,daskShared_local/images/Image_1106.jpg,1106,"[array([[[ 12, 151, 210],
        [ 12, 151, 210],
        [ 11, 150, 209],
        ...,
        [  8, 144, 202],
        [ 12, 148, 206],
        [ 10, 146, 204]],

       [[ 13, 151, 213],
        [ 12, 150, 212],
        [ 11, 149, 210],
        ...,
        [  8, 144, 202],
        [ 10, 146, 204],
        [  9, 145, 203]],

       [[ 11, 149, 211],
        [ 11, 149, 211],
        [ 10, 148, 210],
        ...,
        [  9, 145, 203],
        [  9, 145, 203],
        [ 10, 146, 204]],

       ...,

       [[187, 189, 185],
        [183, 185, 181],
        [204, 208, 203],
        ...,
        [  7, 133, 199],
        [  9, 132, 199],
        [  9, 132, 199]],

       [[185, 188, 185],
        [195, 198, 195],
        [212, 216, 213],
        ...,
        [  7, 131, 197],
        [  8, 131, 198],
        [  8, 131, 198]],

       [[194, 197, 198],
        [181, 185, 185],
        [171, 175, 175],
        ...,
        [  7, 131, 197],
        [  8, 131, 198],
        [  8, 131, 198]]], dtype=uint8)]"
Image_1107.jpg,1281,642,341,252,2106,1578,1622,894,341,daskShared_local/images/Image_1107.jpg,1107,"[array([[[ 27, 146, 147],
        [ 24, 147, 145],
        [ 28, 149, 147],
        ...,
        [ 17, 145, 141],
        [ 17, 144, 141],
        [ 24, 145, 146]],

       [[ 26, 146, 145],
        [ 26, 146, 145],
        [ 28, 146, 146],
        ...,
        [ 14, 144, 141],
        [ 17, 145, 144],
        [ 20, 145, 148]],

       [[ 24, 146, 148],
        [ 20, 144, 145],
        [ 24, 146, 148],
        ...,
        [ 18, 143, 147],
        [ 17, 142, 146],
        [ 19, 143, 148]],

       ...,

       [[ 38, 155, 151],
        [ 36, 156, 150],
        [ 33, 156, 151],
        ...,
        [ 26, 159, 154],
        [ 26, 159, 153],
        [ 28, 162, 156]],

       [[ 36, 157, 154],
        [ 35, 158, 155],
        [ 31, 156, 155],
        ...,
        [ 24, 160, 152],
        [ 25, 160, 154],
        [ 26, 160, 155]],

       [[ 32, 156, 150],
        [ 35, 158, 153],
        [ 34, 160, 153],
        ...,
        [ 26, 160, 155],
        [ 27, 158, 154],
        [ 28, 157, 151]]], dtype=uint8)]"
Image_1108.jpg,948,254,224,173,1600,1280,1172,427,224,daskShared_local/images/Image_1108.jpg,1108,"[array([[[  5,  91,  78],
        [  7,  91,  75],
        [ 11,  93,  75],
        ...,
        [ 37, 157, 130],
        [ 36, 159, 128],
        [ 35, 161, 124]],

       [[  7,  94,  85],
        [ 13,  99,  85],
        [ 14,  98,  83],
        ...,
        [ 39, 162, 135],
        [ 37, 161, 132],
        [ 35, 160, 127]],

       [[ 15, 102,  93],
        [  7,  93,  80],
        [ 19, 102,  88],
        ...,
        [ 38, 163, 139],
        [ 35, 160, 133],
        [ 35, 160, 129]],

       ...,

       [[130,  87,  93],
        [103,  54,  63],
        [113,  56,  70],
        ...,
        [ 33, 180, 118],
        [ 36, 182, 123],
        [ 39, 188, 131]],

       [[168, 147, 162],
        [123,  94, 110],
        [108,  69,  93],
        ...,
        [ 43, 184, 121],
        [ 45, 186, 125],
        [ 48, 191, 131]],

       [[186, 187, 193],
        [150, 144, 162],
        [ 83,  61,  97],
        ...,
        [ 41, 175, 110],
        [ 42, 175, 112],
        [ 46, 180, 119]]], dtype=uint8)]"
Image_1109.jpg,367,179,476,392,1280,854,843,571,476,daskShared_local/images/Image_1109.jpg,1109,"[array([[[117, 145, 172],
        [115, 142, 169],
        [114, 141, 168],
        ...,
        [ 17, 209, 245],
        [ 17, 209, 245],
        [ 17, 209, 245]],

       [[116, 148, 176],
        [117, 148, 177],
        [116, 147, 175],
        ...,
        [ 17, 209, 245],
        [ 17, 209, 245],
        [ 17, 209, 245]],

       [[115, 149, 176],
        [116, 150, 178],
        [116, 149, 177],
        ...,
        [ 17, 209, 244],
        [ 17, 209, 244],
        [ 17, 209, 244]],

       ...,

       [[ 67, 178, 212],
        [ 48, 171, 206],
        [ 24, 162, 198],
        ...,
        [  9, 185, 235],
        [  8, 188, 237],
        [  7, 188, 238]],

       [[ 70, 181, 217],
        [ 50, 172, 211],
        [ 21, 160, 198],
        ...,
        [  7, 188, 233],
        [  9, 190, 235],
        [  7, 188, 233]],

       [[ 81, 188, 221],
        [ 56, 175, 210],
        [ 29, 164, 199],
        ...,
        [  8, 189, 234],
        [ 11, 192, 237],
        [ 10, 191, 236]]], dtype=uint8)]"
Image_111.jpg,550,210,295,263,986,653,845,473,295,daskShared_local/images/Image_111.jpg,111,"[array([[[122, 130, 107],
        [102, 111,  92],
        [ 77,  87,  71],
        ...,
        [ 60, 117,  98],
        [ 60, 117,  98],
        [ 60, 117,  98]],

       [[103, 111,  90],
        [112, 121, 104],
        [117, 125, 110],
        ...,
        [ 60, 117,  98],
        [ 60, 117,  98],
        [ 60, 117,  98]],

       [[ 97, 104,  87],
        [ 89,  95,  80],
        [105, 113, 100],
        ...,
        [ 60, 117,  98],
        [ 60, 117,  98],
        [ 60, 117,  98]],

       ...,

       [[ 81,  98,  44],
        [ 75,  94,  37],
        [ 73,  93,  33],
        ...,
        [ 51,  76,  44],
        [ 51,  76,  44],
        [ 51,  76,  45]],

       [[ 69,  87,  27],
        [ 67,  85,  22],
        [ 66,  86,  20],
        ...,
        [ 52,  78,  43],
        [ 52,  77,  45],
        [ 52,  77,  45]],

       [[ 65,  85,  15],
        [ 66,  87,  12],
        [ 70,  89,  12],
        ...,
        [ 55,  81,  46],
        [ 54,  80,  45],
        [ 53,  78,  46]]], dtype=uint8)]"
Image_1110.jpg,58,120,194,176,600,350,252,296,194,daskShared_local/images/Image_1110.jpg,1110,"[array([[[ 24,  51,  36],
        [ 25,  49,  35],
        [ 23,  50,  35],
        ...,
        [ 59,  47,  49],
        [ 58,  44,  43],
        [ 55,  41,  40]],

       [[ 26,  47,  30],
        [ 29,  47,  33],
        [ 29,  47,  35],
        ...,
        [ 72,  55,  53],
        [ 66,  50,  50],
        [ 62,  50,  50]],

       [[ 27,  48,  33],
        [ 29,  47,  33],
        [ 27,  48,  33],
        ...,
        [ 59,  44,  51],
        [ 48,  35,  43],
        [ 41,  30,  38]],

       ...,

       [[155, 150, 126],
        [155, 149, 125],
        [156, 145, 123],
        ...,
        [121,  97,  73],
        [114,  87,  64],
        [118,  91,  69]],

       [[143, 143, 117],
        [148, 146, 119],
        [148, 138, 111],
        ...,
        [126,  98,  74],
        [123,  91,  70],
        [126,  79,  63]],

       [[143, 126, 106],
        [149, 134, 111],
        [150, 136, 110],
        ...,
        [141, 106,  71],
        [136,  93,  61],
        [135,  86,  56]]], dtype=uint8)]"
Image_1111.jpg,127,90,158,127,500,333,285,217,158,daskShared_local/images/Image_1111.jpg,1111,"[array([[[ 25,  42,  60],
        [ 26,  42,  61],
        [ 27,  42,  61],
        ...,
        [ 26,  44,  66],
        [ 26,  44,  66],
        [ 26,  44,  66]],

       [[ 25,  42,  60],
        [ 26,  42,  61],
        [ 27,  42,  61],
        ...,
        [ 26,  44,  66],
        [ 26,  44,  66],
        [ 26,  44,  66]],

       [[ 26,  42,  61],
        [ 27,  42,  61],
        [ 27,  42,  61],
        ...,
        [ 26,  44,  66],
        [ 26,  44,  66],
        [ 26,  44,  66]],

       ...,

       [[ 24,  42,  56],
        [ 24,  42,  56],
        [ 24,  42,  56],
        ...,
        [123, 142, 133],
        [121, 140, 131],
        [120, 139, 130]],

       [[ 23,  41,  55],
        [ 23,  41,  55],
        [ 24,  42,  56],
        ...,
        [123, 143, 134],
        [122, 142, 133],
        [122, 142, 133]],

       [[ 22,  40,  54],
        [ 22,  40,  54],
        [ 23,  41,  55],
        ...,
        [123, 143, 134],
        [124, 144, 135],
        [125, 145, 136]]], dtype=uint8)]"
Image_1112.jpg,401,183,92,52,800,600,493,235,92,daskShared_local/images/Image_1112.jpg,1112,"[array([[[ 68, 106, 128],
        [ 68, 106, 128],
        [ 66, 104, 126],
        ...,
        [ 75,  93, 167],
        [ 73,  95, 153],
        [ 73,  95, 155]],

       [[ 68, 106, 128],
        [ 69, 106, 128],
        [ 67, 105, 126],
        ...,
        [ 76,  93, 165],
        [ 73,  95, 152],
        [ 74,  95, 154]],

       [[ 66, 105, 127],
        [ 66, 105, 127],
        [ 64, 103, 125],
        ...,
        [ 71,  95, 174],
        [ 69,  97, 161],
        [ 69,  97, 163]],

       ...,

       [[ 99, 110, 132],
        [ 99, 110, 132],
        [ 98, 109, 127],
        ...,
        [ 19, 132, 241],
        [ 18, 132, 241],
        [ 18, 132, 241]],

       [[ 99, 108, 137],
        [ 99, 108, 138],
        [ 98, 107, 132],
        ...,
        [ 19, 132, 241],
        [ 17, 131, 241],
        [ 17, 132, 241]],

       [[ 99, 108, 137],
        [ 99, 108, 138],
        [ 98, 107, 131],
        ...,
        [ 19, 132, 241],
        [ 17, 132, 241],
        [ 17, 132, 241]]], dtype=uint8)]"
Image_1113.jpg,868,513,238,197,1920,1200,1106,710,238,daskShared_local/images/Image_1113.jpg,1113,"[array([[[  4, 124, 125],
        [  5, 125, 124],
        [  2, 122, 121],
        ...,
        [  1, 120, 118],
        [  0, 119, 117],
        [  1, 121, 119]],

       [[  4, 124, 125],
        [  6, 126, 125],
        [  3, 123, 122],
        ...,
        [  3, 123, 121],
        [  1, 120, 118],
        [  1, 121, 119]],

       [[  4, 121, 123],
        [  5, 122, 123],
        [  3, 119, 120],
        ...,
        [  2, 122, 122],
        [  0, 121, 117],
        [  0, 121, 116]],

       ...,

       [[ 83,  62,  13],
        [ 98,  79,  34],
        [130, 113,  70],
        ...,
        [ 52,  39,  27],
        [ 54,  38,  25],
        [ 43,  26,  13]],

       [[ 84,  63,  16],
        [ 97,  79,  35],
        [127, 111,  68],
        ...,
        [ 36,  27,  20],
        [ 37,  27,  22],
        [ 32,  21,  17]],

       [[ 96,  78,  32],
        [107,  90,  47],
        [121, 105,  63],
        ...,
        [ 41,  34,  31],
        [ 31,  25,  23],
        [ 29,  23,  24]]], dtype=uint8)]"
Image_1114.jpg,164,8,107,100,498,272,271,108,107,daskShared_local/images/Image_1114.jpg,1114,"[array([[[  4,  31,  61],
        [  4,  31,  61],
        [  4,  31,  61],
        ...,
        [  0,  31,  54],
        [  0,  32,  55],
        [  0,  32,  55]],

       [[  3,  31,  62],
        [  3,  31,  62],
        [  3,  31,  62],
        ...,
        [  0,  31,  54],
        [  0,  32,  55],
        [  0,  32,  55]],

       [[  2,  31,  63],
        [  2,  31,  63],
        [  2,  31,  63],
        ...,
        [  0,  32,  55],
        [  0,  33,  55],
        [  0,  33,  55]],

       ...,

       [[100, 101, 103],
        [101, 102, 104],
        [103, 107, 113],
        ...,
        [180, 195, 191],
        [178, 193, 190],
        [178, 193, 189]],

       [[100, 100, 107],
        [100, 100, 108],
        [101, 104, 113],
        ...,
        [193, 208, 204],
        [199, 214, 210],
        [200, 215, 212]],

       [[100, 100, 108],
        [100, 100, 109],
        [100, 104, 113],
        ...,
        [195, 210, 206],
        [202, 217, 214],
        [203, 218, 215]]], dtype=uint8)]"
Image_1115.JPG,554,396,458,336,1600,1467,1012,732,458,daskShared_local/images/Image_1115.JPG,1115,"[array([[[ 48,  65,  69],
        [ 46,  61,  68],
        [ 51,  68,  81],
        ...,
        [108, 114, 100],
        [111, 121,  99],
        [107, 116,  94]],

       [[ 51,  69,  71],
        [ 51,  67,  73],
        [ 50,  66,  80],
        ...,
        [111, 115, 101],
        [110, 114,  98],
        [102, 105,  91]],

       [[ 60,  77,  77],
        [ 63,  78,  81],
        [ 55,  70,  80],
        ...,
        [105, 107,  96],
        [105, 106, 100],
        [100, 100,  96]],

       ...,

       [[225, 234, 182],
        [226, 235, 183],
        [228, 233, 182],
        ...,
        [241, 244, 240],
        [233, 239, 229],
        [227, 232, 221]],

       [[232, 241, 188],
        [234, 240, 188],
        [235, 237, 187],
        ...,
        [231, 238, 223],
        [224, 229, 212],
        [225, 229, 210]],

       [[225, 233, 180],
        [228, 233, 182],
        [227, 229, 179],
        ...,
        [229, 237, 214],
        [230, 234, 215],
        [232, 234, 215]]], dtype=uint8)]"
Image_1116.jpg,677,289,287,334,1600,900,964,623,334,daskShared_local/images/Image_1116.jpg,1116,"[array([[[  0, 116, 199],
        [  0, 116, 199],
        [  0, 116, 199],
        ...,
        [  0, 119, 203],
        [  0, 120, 203],
        [  0, 120, 203]],

       [[  0, 116, 199],
        [  0, 116, 199],
        [  0, 116, 199],
        ...,
        [  0, 119, 203],
        [  0, 120, 203],
        [  0, 120, 203]],

       [[  0, 116, 199],
        [  0, 116, 199],
        [  0, 116, 199],
        ...,
        [  0, 118, 202],
        [  0, 118, 202],
        [  0, 119, 202]],

       ...,

       [[178, 187,  97],
        [185, 194,  98],
        [181, 189,  99],
        ...,
        [ 64,  67,  48],
        [ 69,  71,  49],
        [156, 159, 134]],

       [[166, 171,  85],
        [179, 183,  96],
        [185, 189, 104],
        ...,
        [ 59,  63,  47],
        [ 45,  50,  30],
        [126, 130, 106]],

       [[184, 188, 109],
        [186, 184, 112],
        [200, 198, 125],
        ...,
        [ 57,  63,  49],
        [ 61,  68,  48],
        [ 95, 101,  76]]], dtype=uint8)]"
Image_1117.jpg,74,72,93,88,300,260,167,160,93,daskShared_local/images/Image_1117.jpg,1117,"[array([[[  1, 229, 254],
        [  1, 229, 254],
        [  1, 230, 253],
        ...,
        [  1, 197, 234],
        [  1, 197, 232],
        [  1, 197, 233]],

       [[  1, 229, 254],
        [  1, 229, 254],
        [  1, 230, 253],
        ...,
        [  1, 196, 234],
        [  1, 195, 232],
        [  1, 196, 232]],

       [[  2, 228, 253],
        [  2, 228, 253],
        [  2, 229, 253],
        ...,
        [  2, 204, 236],
        [  2, 204, 237],
        [  2, 204, 237]],

       ...,

       [[  0, 186, 238],
        [  0, 186, 238],
        [  0, 185, 238],
        ...,
        [ 46, 141, 114],
        [ 40, 108,  75],
        [ 41, 112,  80]],

       [[  1, 186, 238],
        [  1, 186, 238],
        [  0, 186, 239],
        ...,
        [ 96, 170, 112],
        [ 91, 147,  77],
        [ 92, 150,  82]],

       [[  1, 186, 238],
        [  1, 186, 238],
        [  0, 186, 239],
        ...,
        [ 89, 166, 112],
        [ 85, 142,  77],
        [ 85, 145,  82]]], dtype=uint8)]"
Image_1118.jpg,325,267,94,75,800,600,419,342,94,daskShared_local/images/Image_1118.jpg,1118,"[array([[[  0, 159, 254],
        [  0, 159, 254],
        [  0, 159, 254],
        ...,
        [  0, 163, 254],
        [  0, 163, 254],
        [  0, 163, 254]],

       [[  0, 159, 253],
        [  0, 159, 253],
        [  0, 159, 253],
        ...,
        [  0, 163, 254],
        [  0, 163, 254],
        [  0, 163, 254]],

       [[  0, 158, 254],
        [  0, 158, 254],
        [  0, 159, 254],
        ...,
        [  0, 163, 254],
        [  0, 163, 254],
        [  0, 163, 254]],

       ...,

       [[225, 233, 212],
        [226, 233, 212],
        [218, 231, 209],
        ...,
        [ 41,  48,  35],
        [ 46,  54,  39],
        [ 45,  53,  38]],

       [[232, 243, 235],
        [233, 244, 236],
        [217, 237, 222],
        ...,
        [ 34,  40,  28],
        [ 37,  45,  30],
        [ 37,  44,  30]],

       [[231, 242, 232],
        [233, 243, 233],
        [217, 237, 221],
        ...,
        [ 34,  41,  29],
        [ 38,  46,  31],
        [ 38,  45,  31]]], dtype=uint8)]"
Image_1119.jpg,303,232,304,287,1000,664,607,519,304,daskShared_local/images/Image_1119.jpg,1119,"[array([[[199, 202, 207],
        [199, 203, 206],
        [199, 203, 206],
        ...,
        [165, 148, 141],
        [176, 158, 151],
        [184, 166, 159]],

       [[199, 202, 207],
        [199, 203, 206],
        [199, 203, 206],
        ...,
        [183, 160, 150],
        [184, 161, 152],
        [187, 164, 154]],

       [[199, 202, 207],
        [199, 203, 206],
        [199, 203, 206],
        ...,
        [198, 167, 155],
        [200, 168, 155],
        [204, 172, 159]],

       ...,

       [[145, 139, 131],
        [148, 143, 134],
        [146, 140, 134],
        ...,
        [164, 158, 146],
        [164, 159, 148],
        [164, 159, 148]],

       [[146, 145, 140],
        [145, 142, 136],
        [142, 139, 134],
        ...,
        [164, 160, 149],
        [164, 160, 149],
        [164, 160, 149]],

       [[146, 146, 144],
        [142, 143, 138],
        [138, 138, 134],
        ...,
        [164, 160, 149],
        [163, 160, 150],
        [162, 159, 150]]], dtype=uint8)]"
Image_112.jpg,665,230,360,333,2121,1063,1025,563,360,daskShared_local/images/Image_112.jpg,112,"[array([[[ 71, 117, 127],
        [ 71, 113, 121],
        [ 77, 115, 123],
        ...,
        [125, 144, 151],
        [123, 142, 147],
        [122, 140, 145]],

       [[ 96, 148, 160],
        [ 90, 139, 150],
        [ 83, 128, 139],
        ...,
        [122, 137, 140],
        [119, 134, 136],
        [116, 131, 132]],

       [[ 97, 154, 167],
        [101, 154, 168],
        [106, 155, 170],
        ...,
        [118, 130, 128],
        [115, 125, 124],
        [115, 126, 125]],

       ...,

       [[ 54, 105, 124],
        [ 55, 106, 125],
        [ 53, 104, 123],
        ...,
        [158, 154, 141],
        [152, 146, 130],
        [154, 148, 132]],

       [[ 54, 105, 124],
        [ 54, 105, 124],
        [ 53, 104, 123],
        ...,
        [152, 152, 143],
        [148, 146, 134],
        [160, 158, 145]],

       [[ 53, 104, 123],
        [ 53, 104, 123],
        [ 52, 103, 122],
        ...,
        [138, 139, 130],
        [143, 143, 132],
        [158, 155, 142]]], dtype=uint8)]"
Image_1120.jpg,311,156,178,181,1200,735,489,337,181,daskShared_local/images/Image_1120.jpg,1120,"[array([[[112, 185, 202],
        [104, 177, 194],
        [105, 178, 195],
        ...,
        [ 20,  51,  84],
        [ 16,  51,  81],
        [ 15,  50,  80]],

       [[112, 187, 202],
        [106, 182, 196],
        [105, 181, 195],
        ...,
        [ 15,  49,  80],
        [ 14,  51,  80],
        [ 17,  57,  83]],

       [[113, 189, 203],
        [111, 187, 201],
        [111, 187, 201],
        ...,
        [  5,  45,  69],
        [  6,  47,  72],
        [ 16,  57,  82]],

       ...,

       [[147, 188, 180],
        [153, 194, 188],
        [153, 194, 190],
        ...,
        [ 56,  53,  35],
        [ 78,  69,  47],
        [ 78,  62,  40]],

       [[146, 188, 180],
        [152, 193, 189],
        [152, 195, 191],
        ...,
        [  9,   3,   2],
        [ 25,  13,   8],
        [ 26,   8,   3]],

       [[137, 184, 176],
        [139, 184, 178],
        [141, 186, 182],
        ...,
        [ 15,   0,   0],
        [ 12,   1,   1],
        [ 12,   0,   4]]], dtype=uint8)]"
Image_1121.jpg,319,212,902,674,1500,1125,1221,886,902,daskShared_local/images/Image_1121.jpg,1121,"[array([[[ 95, 169, 173],
        [ 96, 170, 171],
        [ 96, 170, 172],
        ...,
        [115, 142, 149],
        [115, 144, 148],
        [115, 143, 148]],

       [[ 95, 169, 173],
        [ 96, 170, 171],
        [ 95, 170, 172],
        ...,
        [116, 139, 148],
        [115, 140, 147],
        [116, 142, 147]],

       [[ 94, 171, 171],
        [ 96, 170, 170],
        [ 95, 171, 170],
        ...,
        [117, 138, 148],
        [118, 140, 147],
        [120, 142, 148]],

       ...,

       [[ 99, 197, 244],
        [ 98, 194, 238],
        [ 97, 191, 236],
        ...,
        [106, 131, 128],
        [111, 134, 131],
        [111, 139, 136]],

       [[103, 201, 248],
        [102, 198, 244],
        [100, 193, 240],
        ...,
        [109, 133, 128],
        [113, 138, 133],
        [113, 143, 139]],

       [[105, 205, 249],
        [103, 201, 247],
        [102, 197, 244],
        ...,
        [112, 139, 130],
        [118, 143, 136],
        [119, 146, 141]]], dtype=uint8)]"
Image_1122.jpg,192,422,51,53,1024,683,243,475,53,daskShared_local/images/Image_1122.jpg,1122,"[array([[[121, 128,  58],
        [116, 127,  65],
        [118, 127,  63],
        ...,
        [  1, 191, 200],
        [  1, 191, 200],
        [  1, 191, 200]],

       [[121, 128,  56],
        [115, 128,  62],
        [117, 128,  61],
        ...,
        [  0, 191, 200],
        [  0, 191, 201],
        [  0, 191, 200]],

       [[121, 128,  56],
        [116, 128,  63],
        [117, 128,  61],
        ...,
        [  0, 191, 200],
        [  0, 191, 200],
        [  0, 191, 200]],

       ...,

       [[ 72, 152, 134],
        [ 73, 144, 132],
        [ 73, 146, 132],
        ...,
        [185, 216, 155],
        [185, 216, 154],
        [186, 217, 159]],

       [[ 74, 155, 138],
        [ 74, 147, 136],
        [ 74, 149, 136],
        ...,
        [188, 219, 159],
        [188, 218, 158],
        [188, 220, 163]],

       [[ 69, 144, 124],
        [ 69, 136, 121],
        [ 69, 138, 122],
        ...,
        [179, 209, 143],
        [179, 208, 142],
        [180, 210, 148]]], dtype=uint8)]"
Image_1123.jpg,385,108,182,178,800,600,567,286,182,daskShared_local/images/Image_1123.jpg,1123,"[array([[[250, 252, 213],
        [252, 254, 216],
        [249, 251, 214],
        ...,
        [ 50, 127,  99],
        [ 52, 128, 100],
        [ 52, 127,  98]],

       [[252, 255, 212],
        [251, 253, 213],
        [251, 253, 215],
        ...,
        [ 54, 133, 111],
        [ 65, 144, 122],
        [ 70, 149, 127]],

       [[242, 248, 205],
        [235, 241, 199],
        [240, 247, 207],
        ...,
        [ 61, 144, 128],
        [ 78, 161, 145],
        [ 83, 166, 150]],

       ...,

       [[226, 125,  22],
        [227, 125,  24],
        [225, 126,  27],
        ...,
        [ 47,  45,  47],
        [ 35,  27,  36],
        [ 22,  12,  21]],

       [[224, 122,  21],
        [225, 123,  23],
        [221, 123,  25],
        ...,
        [ 61,  59,  63],
        [ 35,  28,  36],
        [ 28,  18,  27]],

       [[221, 119,  19],
        [223, 121,  23],
        [218, 120,  22],
        ...,
        [ 71,  71,  75],
        [ 45,  38,  46],
        [ 57,  47,  56]]], dtype=uint8)]"
Image_1124.jpg,413,353,278,243,1536,1024,691,596,278,daskShared_local/images/Image_1124.jpg,1124,"[array([[[ 13, 128, 245],
        [ 14, 129, 246],
        [ 10, 127, 243],
        ...,
        [ 13, 144, 241],
        [ 12, 146, 246],
        [ 13, 144, 252]],

       [[ 13, 128, 245],
        [ 13, 128, 245],
        [ 11, 128, 244],
        ...,
        [  9, 146, 246],
        [ 13, 145, 246],
        [ 13, 143, 254]],

       [[ 11, 126, 243],
        [ 12, 127, 244],
        [ 10, 126, 245],
        ...,
        [  6, 145, 248],
        [ 12, 145, 238],
        [ 12, 143, 247]],

       ...,

       [[  9,  63, 213],
        [  9,  63, 213],
        [ 10,  62, 200],
        ...,
        [ 11,  40,   9],
        [ 11,  37,  26],
        [ 22,  49,  40]],

       [[  9,  63, 213],
        [  9,  63, 213],
        [ 14,  68, 190],
        ...,
        [ 24,  41,  22],
        [ 16,  35,  26],
        [ 19,  44,  33]],

       [[  9,  63, 213],
        [  9,  63, 213],
        [ 19,  75, 187],
        ...,
        [ 28,  42,  40],
        [ 28,  34,  29],
        [ 17,  33,  25]]], dtype=uint8)]"
Image_1125.jpg,386,138,226,191,869,574,612,329,226,daskShared_local/images/Image_1125.jpg,1125,"[array([[[ 73, 171, 236],
        [ 76, 169, 237],
        [ 78, 170, 240],
        ...,
        [ 61, 163, 238],
        [ 53, 156, 231],
        [ 42, 150, 223]],

       [[ 72, 173, 241],
        [ 75, 173, 242],
        [ 79, 173, 243],
        ...,
        [ 50, 149, 228],
        [ 46, 151, 227],
        [ 41, 153, 225]],

       [[ 55, 169, 240],
        [ 66, 173, 244],
        [ 75, 175, 245],
        ...,
        [ 59, 154, 233],
        [ 61, 159, 237],
        [ 64, 164, 239]],

       ...,

       [[  4,   8,   6],
        [  2,   5,   2],
        [  0,  12,   8],
        ...,
        [  2, 104, 179],
        [  2, 104, 179],
        [  2, 104, 179]],

       [[ 21,   4,  10],
        [ 14,   1,   4],
        [  8,   7,   9],
        ...,
        [  2, 104, 179],
        [  2, 104, 179],
        [  2, 104, 179]],

       [[  7,   1,   3],
        [  9,   3,   5],
        [  9,  15,  15],
        ...,
        [  2, 104, 179],
        [  2, 104, 179],
        [  2, 104, 179]]], dtype=uint8)]"
Image_1126.jpg,598,216,404,458,1600,1070,1002,674,458,daskShared_local/images/Image_1126.jpg,1126,"[array([[[ 22,  75, 145],
        [ 22,  75, 145],
        [ 22,  75, 145],
        ...,
        [ 28,  69, 133],
        [ 30,  68, 133],
        [ 30,  68, 133]],

       [[ 22,  75, 145],
        [ 22,  75, 145],
        [ 22,  75, 145],
        ...,
        [ 28,  69, 133],
        [ 30,  68, 133],
        [ 30,  68, 133]],

       [[ 22,  75, 145],
        [ 22,  75, 145],
        [ 22,  75, 145],
        ...,
        [ 28,  69, 133],
        [ 30,  68, 133],
        [ 30,  68, 133]],

       ...,

       [[136, 113,  72],
        [149, 129,  81],
        [142, 112,  75],
        ...,
        [251, 230, 202],
        [253, 223, 173],
        [255, 224, 177]],

       [[157, 143, 102],
        [134, 121,  74],
        [127,  96,  51],
        ...,
        [245, 229, 224],
        [254, 230, 199],
        [255, 227, 186]],

       [[187, 161, 119],
        [182, 152, 104],
        [132, 103,  57],
        ...,
        [222, 196, 175],
        [240, 199, 161],
        [245, 201, 157]]], dtype=uint8)]"
Image_1127.jpg,654,117,198,187,1156,650,852,304,198,daskShared_local/images/Image_1127.jpg,1127,"[array([[[ 49, 148, 180],
        [ 39, 139, 171],
        [ 38, 135, 168],
        ...,
        [ 10, 130, 146],
        [  2, 129, 144],
        [ 44, 176, 191]],

       [[ 41, 140, 172],
        [ 45, 144, 176],
        [ 44, 143, 175],
        ...,
        [ 60, 180, 196],
        [ 16, 146, 160],
        [ 23, 159, 173]],

       [[ 50, 147, 180],
        [ 53, 150, 183],
        [ 63, 163, 195],
        ...,
        [ 55, 175, 189],
        [  2, 134, 146],
        [  0, 141, 151]],

       ...,

       [[ 46,  45,  17],
        [ 55,  54,  26],
        [ 74,  68,  44],
        ...,
        [  2, 131, 170],
        [  0, 129, 168],
        [  0, 127, 167]],

       [[ 83,  82,  52],
        [ 69,  68,  38],
        [ 54,  50,  23],
        ...,
        [  2, 132, 168],
        [  1, 130, 169],
        [  1, 130, 169]],

       [[ 89,  88,  58],
        [ 74,  73,  42],
        [ 52,  48,  19],
        ...,
        [  0, 132, 170],
        [  2, 134, 172],
        [  2, 134, 173]]], dtype=uint8)]"
Image_1128.jpg,294,165,237,197,1000,664,531,362,237,daskShared_local/images/Image_1128.jpg,1128,"[array([[[  0,  82, 150],
        [  1,  82, 149],
        [  1,  82, 150],
        ...,
        [  0, 105, 173],
        [  0, 104, 174],
        [  0, 104, 175]],

       [[  2,  82, 150],
        [  0,  82, 150],
        [  1,  82, 148],
        ...,
        [  0, 103, 173],
        [  0, 102, 173],
        [  0, 103, 175]],

       [[  1,  81, 148],
        [  1,  80, 150],
        [  1,  81, 149],
        ...,
        [  0, 104, 172],
        [  0, 104, 173],
        [  0, 103, 175]],

       ...,

       [[ 32,  41,  38],
        [ 42,  54,  51],
        [ 49,  58,  50],
        ...,
        [216, 205, 178],
        [225, 212, 174],
        [231, 221, 189]],

       [[ 29,  36,  38],
        [ 36,  55,  58],
        [ 45,  66,  58],
        ...,
        [224, 215, 191],
        [227, 213, 172],
        [226, 216, 176]],

       [[ 30,  36,  39],
        [ 33,  53,  54],
        [ 37,  60,  53],
        ...,
        [219, 208, 179],
        [225, 213, 177],
        [209, 200, 159]]], dtype=uint8)]"
Image_1129.jpg,443,205,185,212,1200,630,628,417,212,daskShared_local/images/Image_1129.jpg,1129,"[array([[[ 34, 112, 184],
        [ 35, 113, 185],
        [ 32, 107, 175],
        ...,
        [ 31,  63,  59],
        [ 37,  56,  58],
        [ 28,  46,  48]],

       [[ 32, 110, 182],
        [ 33, 110, 182],
        [ 35, 110, 178],
        ...,
        [ 58,  96,  89],
        [ 41,  61,  62],
        [ 49,  67,  68]],

       [[ 30, 107, 179],
        [ 29, 107, 178],
        [ 35, 110, 179],
        ...,
        [ 90, 127, 119],
        [ 85, 105, 103],
        [ 54,  73,  71]],

       ...,

       [[ 33,  76,  97],
        [ 36,  78, 100],
        [ 29,  66,  90],
        ...,
        [ 60,  62,  61],
        [ 38,  43,  39],
        [ 29,  35,  31]],

       [[ 33,  74,  96],
        [ 40,  80, 103],
        [ 34,  68,  95],
        ...,
        [ 67,  69,  68],
        [ 31,  37,  33],
        [ 28,  34,  30]],

       [[ 38,  86, 108],
        [ 27,  74,  96],
        [ 24,  60,  84],
        ...,
        [ 54,  63,  62],
        [ 63,  65,  58],
        [ 34,  37,  30]]], dtype=uint8)]"
Image_113.jpg,1843,421,331,267,3840,2160,2174,688,331,daskShared_local/images/Image_113.jpg,113,"[array([[[106, 189, 207],
        [124, 202, 221],
        [140, 213, 233],
        ...,
        [ 63, 136, 160],
        [ 51, 119, 140],
        [ 71, 130, 149]],

       [[131, 213, 230],
        [125, 204, 219],
        [141, 215, 230],
        ...,
        [ 45, 117, 135],
        [ 55, 123, 136],
        [ 77, 136, 146]],

       [[120, 202, 216],
        [139, 217, 229],
        [141, 216, 228],
        ...,
        [ 56, 124, 135],
        [ 79, 144, 148],
        [ 94, 149, 150]],

       ...,

       [[ 25,  93, 112],
        [ 25,  93, 112],
        [ 23,  91, 110],
        ...,
        [116, 117,  78],
        [117, 119,  79],
        [113, 116,  72]],

       [[ 24,  92, 111],
        [ 22,  90, 109],
        [ 20,  88, 107],
        ...,
        [124, 124,  88],
        [117, 118,  78],
        [114, 115,  73]],

       [[ 24,  92, 111],
        [ 27,  95, 114],
        [ 29,  97, 116],
        ...,
        [114, 114,  77],
        [112, 113,  73],
        [119, 120,  78]]], dtype=uint8)]"
Image_1130.jpg,452,228,157,170,900,586,609,398,170,daskShared_local/images/Image_1130.jpg,1130,"[array([[[  1, 171, 206],
        [  1, 171, 206],
        [  1, 173, 207],
        ...,
        [104, 206, 228],
        [103, 205, 227],
        [103, 205, 227]],

       [[  3, 173, 208],
        [  3, 173, 208],
        [  2, 174, 208],
        ...,
        [103, 205, 227],
        [103, 205, 227],
        [103, 205, 227]],

       [[  5, 175, 210],
        [  5, 175, 210],
        [  2, 174, 209],
        ...,
        [103, 205, 227],
        [103, 205, 227],
        [102, 204, 226]],

       ...,

       [[  5,  95,  87],
        [  1,  90,  83],
        [  8,  85,  80],
        ...,
        [  1, 163, 209],
        [  1, 163, 209],
        [  1, 163, 209]],

       [[ 20,  97,  91],
        [  5,  95,  86],
        [  4,  86,  79],
        ...,
        [  1, 163, 209],
        [  1, 163, 209],
        [  1, 163, 209]],

       [[ 40,  98,  92],
        [  9,  80,  68],
        [  1,  82,  72],
        ...,
        [  1, 163, 209],
        [  1, 163, 209],
        [  1, 163, 209]]], dtype=uint8)]"
Image_1131.jpg,410,140,241,225,1024,686,651,365,241,daskShared_local/images/Image_1131.jpg,1131,"[array([[[ 38, 192, 242],
        [ 36, 190, 240],
        [ 33, 187, 237],
        ...,
        [  1, 158, 219],
        [  1, 159, 220],
        [  1, 159, 220]],

       [[ 37, 191, 241],
        [ 36, 190, 240],
        [ 35, 189, 239],
        ...,
        [  1, 158, 219],
        [  2, 158, 219],
        [  2, 158, 219]],

       [[ 33, 187, 237],
        [ 35, 189, 239],
        [ 37, 191, 241],
        ...,
        [  1, 158, 219],
        [  2, 158, 219],
        [  2, 158, 219]],

       ...,

       [[231, 216, 208],
        [216, 200, 190],
        [228, 210, 199],
        ...,
        [  3, 115, 181],
        [  2, 115, 181],
        [  2, 115, 181]],

       [[238, 223, 218],
        [203, 188, 179],
        [206, 191, 179],
        ...,
        [  3, 115, 181],
        [  2, 115, 181],
        [  3, 116, 182]],

       [[250, 235, 230],
        [214, 200, 192],
        [217, 204, 193],
        ...,
        [  3, 115, 181],
        [  3, 116, 182],
        [  4, 117, 183]]], dtype=uint8)]"
Image_1132.jpg,692,663,343,240,2793,2090,1035,903,343,daskShared_local/images/Image_1132.jpg,1132,"[array([[[  3,  67, 190],
        [  3,  67, 190],
        [  3,  67, 190],
        ...,
        [  3,  68, 186],
        [  3,  68, 186],
        [  3,  68, 186]],

       [[  3,  67, 190],
        [  3,  67, 190],
        [  3,  67, 190],
        ...,
        [  3,  68, 186],
        [  3,  68, 186],
        [  3,  68, 186]],

       [[  5,  69, 192],
        [  5,  69, 192],
        [  3,  67, 190],
        ...,
        [  3,  68, 186],
        [  3,  68, 186],
        [  3,  68, 186]],

       ...,

       [[  5,  52, 156],
        [  5,  52, 156],
        [  5,  52, 156],
        ...,
        [ 79,  69,  20],
        [ 81,  71,  22],
        [ 83,  76,  29]],

       [[  3,  50, 154],
        [  3,  50, 154],
        [  5,  52, 156],
        ...,
        [ 75,  67,  20],
        [ 79,  71,  25],
        [ 79,  76,  32]],

       [[  3,  50, 154],
        [  3,  50, 154],
        [  5,  52, 156],
        ...,
        [ 72,  69,  25],
        [ 75,  73,  30],
        [ 77,  77,  36]]], dtype=uint8)]"
Image_1133.jpg,725,431,480,382,2119,1414,1205,813,480,daskShared_local/images/Image_1133.jpg,1133,"[array([[[ 97, 151, 182],
        [ 93, 148, 178],
        [101, 156, 186],
        ...,
        [ 75, 141, 175],
        [ 72, 138, 170],
        [ 72, 138, 170]],

       [[ 94, 146, 179],
        [ 91, 144, 176],
        [ 99, 153, 184],
        ...,
        [ 75, 140, 170],
        [ 70, 137, 166],
        [ 67, 134, 163]],

       [[ 97, 149, 181],
        [ 93, 146, 178],
        [ 95, 149, 181],
        ...,
        [ 71, 136, 166],
        [ 73, 140, 169],
        [ 77, 144, 173]],

       ...,

       [[ 77, 173, 197],
        [ 78, 174, 198],
        [ 77, 173, 197],
        ...,
        [111,  94,  60],
        [132, 120,  88],
        [132, 118,  89]],

       [[ 78, 174, 198],
        [ 77, 173, 197],
        [ 78, 174, 198],
        ...,
        [100,  77,  46],
        [113,  96,  63],
        [114,  94,  63]],

       [[ 77, 173, 197],
        [ 75, 171, 195],
        [ 77, 173, 197],
        ...,
        [ 91,  60,  34],
        [ 98,  75,  39],
        [114,  89,  56]]], dtype=uint8)]"
Image_1134.jpeg,647,139,252,253,1200,800,899,392,253,daskShared_local/images/Image_1134.jpeg,1134,"[array([[[167, 211, 224],
        [170, 213, 224],
        [167, 209, 221],
        ...,
        [176, 209, 226],
        [178, 211, 228],
        [181, 214, 231]],

       [[164, 205, 218],
        [169, 209, 221],
        [167, 207, 218],
        ...,
        [178, 211, 228],
        [176, 209, 226],
        [176, 209, 226]],

       [[172, 211, 224],
        [171, 208, 221],
        [173, 210, 222],
        ...,
        [180, 213, 230],
        [177, 210, 227],
        [175, 208, 225]],

       ...,

       [[132,  87,   6],
        [165, 121,  52],
        [226, 183, 124],
        ...,
        [216, 174, 153],
        [202, 166, 122],
        [188, 155, 112]],

       [[152, 107,  25],
        [171, 128,  53],
        [212, 171, 100],
        ...,
        [225, 183, 166],
        [238, 201, 158],
        [225, 189, 144]],

       [[151, 105,  27],
        [168, 126,  47],
        [180, 138,  58],
        ...,
        [206, 167, 152],
        [214, 177, 133],
        [235, 197, 148]]], dtype=uint8)]"
Image_1135.jpg,1866,595,1238,1210,4752,3168,3104,1805,1238,daskShared_local/images/Image_1135.jpg,1135,"[array([[[ 59,  67,  65],
        [ 60,  68,  65],
        [ 61,  67,  62],
        ...,
        [ 53, 126, 150],
        [ 54, 126, 151],
        [ 52, 124, 151]],

       [[ 61,  67,  58],
        [ 64,  69,  58],
        [ 67,  67,  51],
        ...,
        [ 54, 127, 150],
        [ 55, 127, 151],
        [ 53, 125, 150]],

       [[ 66,  68,  49],
        [ 68,  70,  50],
        [ 69,  66,  44],
        ...,
        [ 55, 127, 150],
        [ 54, 127, 149],
        [ 53, 127, 149]],

       ...,

       [[ 42, 122, 151],
        [ 42, 118, 147],
        [ 29, 110, 143],
        ...,
        [114,  96,  71],
        [168, 157, 105],
        [198, 200, 151]],

       [[ 53, 136, 154],
        [ 52, 131, 152],
        [ 46, 128, 151],
        ...,
        [171, 159, 117],
        [199, 199, 158],
        [197, 204, 178]],

       [[ 59, 140, 155],
        [ 58, 139, 153],
        [ 58, 140, 157],
        ...,
        [200, 197, 164],
        [195, 195, 171],
        [174, 174, 157]]], dtype=uint8)]"
Image_1136.png,243,33,83,83,589,295,326,116,83,daskShared_local/images/Image_1136.png,1136,"[array([[[  0, 171, 186],
        [  0, 172, 187],
        [  0, 169, 184],
        ...,
        [  0, 169, 192],
        [  0, 170, 194],
        [  0, 170, 193]],

       [[  0, 171, 185],
        [  0, 172, 186],
        [  0, 170, 184],
        ...,
        [  0, 170, 193],
        [  0, 170, 196],
        [  0, 170, 195]],

       [[  0, 171, 187],
        [  0, 172, 188],
        [  0, 169, 184],
        ...,
        [  0, 169, 190],
        [  0, 169, 192],
        [  0, 169, 191]],

       ...,

       [[ 70,  29,  22],
        [ 69,  27,  20],
        [ 71,  31,  27],
        ...,
        [126,  76,  70],
        [118,  68,  63],
        [121,  71,  66]],

       [[ 71,  31,  26],
        [ 70,  30,  25],
        [ 71,  32,  29],
        ...,
        [167, 103,  94],
        [161, 101,  93],
        [163, 102,  93]],

       [[ 70,  30,  25],
        [ 70,  29,  23],
        [ 71,  32,  28],
        ...,
        [151,  93,  85],
        [145,  88,  81],
        [147,  90,  83]]], dtype=uint8)]"
Image_1137.jpg,226,187,156,163,500,559,382,350,163,daskShared_local/images/Image_1137.jpg,1137,"[array([[[ 86, 171, 167],
        [ 78, 173, 173],
        [ 74, 174, 176],
        ...,
        [122, 213, 203],
        [123, 215, 205],
        [124, 213, 203]],

       [[ 81, 172, 171],
        [ 76, 172, 174],
        [ 74, 173, 176],
        ...,
        [125, 214, 205],
        [129, 216, 206],
        [131, 214, 205]],

       [[ 76, 174, 175],
        [ 73, 171, 173],
        [ 72, 170, 173],
        ...,
        [127, 214, 205],
        [133, 214, 206],
        [135, 213, 205]],

       ...,

       [[ 58,  50,  19],
        [ 66,  59,  14],
        [ 78,  70,  16],
        ...,
        [ 98, 120,  21],
        [101, 117,  16],
        [100, 113,  14]],

       [[ 63,  61,  13],
        [ 64,  60,  13],
        [ 63,  57,   9],
        ...,
        [ 95, 119,  18],
        [121, 134,  23],
        [123, 134,  27]],

       [[ 85,  91,  20],
        [ 77,  76,  24],
        [ 67,  63,  16],
        ...,
        [ 89, 113,  13],
        [124, 137,  22],
        [130, 142,  32]]], dtype=uint8)]"
Image_1138.jpg,510,232,333,238,1200,900,843,470,333,daskShared_local/images/Image_1138.jpg,1138,"[array([[[ 21, 166, 180],
        [ 44, 174, 191],
        [ 58, 180, 197],
        ...,
        [ 88, 190, 206],
        [ 96, 192, 208],
        [ 98, 191, 208]],

       [[ 48, 172, 196],
        [ 47, 172, 194],
        [ 59, 178, 198],
        ...,
        [ 95, 192, 210],
        [ 77, 187, 204],
        [ 81, 188, 207]],

       [[ 62, 182, 199],
        [ 61, 182, 203],
        [ 62, 183, 201],
        ...,
        [ 82, 188, 209],
        [ 80, 189, 208],
        [ 93, 191, 209]],

       ...,

       [[132, 166, 155],
        [108, 157, 151],
        [124, 172, 175],
        ...,
        [150, 208, 222],
        [137, 204, 219],
        [136, 204, 217]],

       [[134, 161, 150],
        [153, 174, 164],
        [177, 207, 208],
        ...,
        [157, 212, 225],
        [139, 204, 222],
        [120, 199, 212]],

       [[134, 170, 159],
        [160, 202, 198],
        [212, 233, 234],
        ...,
        [135, 201, 215],
        [142, 204, 224],
        [116, 197, 214]]], dtype=uint8)]"
Image_1139.jpg,1726,547,1393,1545,4631,3087,3119,2092,1545,daskShared_local/images/Image_1139.jpg,1139,"[array([[[ 21,  92, 239],
        [ 21,  92, 240],
        [ 22,  92, 240],
        ...,
        [  1,  60, 197],
        [  1,  60, 197],
        [  0,  59, 197]],

       [[ 21,  92, 240],
        [ 22,  92, 240],
        [ 21,  91, 239],
        ...,
        [  1,  60, 196],
        [  1,  60, 196],
        [  0,  59, 195]],

       [[ 21,  91, 239],
        [ 21,  91, 239],
        [ 21,  91, 239],
        ...,
        [  0,  59, 195],
        [  0,  59, 195],
        [  0,  59, 194]],

       ...,

       [[ 43,  41,  38],
        [ 81,  71,  55],
        [116, 109,  79],
        ...,
        [ 33,  32,  16],
        [ 34,  33,  18],
        [ 35,  33,  19]],

       [[ 84,  71,  54],
        [108,  98,  74],
        [105,  98,  74],
        ...,
        [ 32,  33,  17],
        [ 33,  33,  17],
        [ 33,  34,  19]],

       [[111,  98,  74],
        [103,  92,  71],
        [102,  97,  86],
        ...,
        [ 31,  33,  18],
        [ 31,  33,  17],
        [ 32,  34,  19]]], dtype=uint8)]"
Image_114.jpg,63,136,126,110,525,340,189,246,126,daskShared_local/images/Image_114.jpg,114,"[array([[[ 35,  83,  97],
        [ 32,  80,  92],
        [ 27,  74,  82],
        ...,
        [202, 210, 169],
        [164, 173, 131],
        [139, 149, 108]],

       [[ 36,  84,  99],
        [ 33,  82,  94],
        [ 28,  76,  84],
        ...,
        [165, 172, 131],
        [140, 148, 107],
        [124, 133,  91]],

       [[ 38,  87, 102],
        [ 35,  84,  97],
        [ 30,  79,  87],
        ...,
        [ 92,  99,  58],
        [ 94, 102,  61],
        [ 94, 102,  61]],

       ...,

       [[ 25,  31,  24],
        [ 31,  45,  36],
        [ 45,  75,  60],
        ...,
        [ 28,  42,  27],
        [ 15,  25,  15],
        [  8,  15,   7]],

       [[ 42,  55,  49],
        [ 42,  64,  54],
        [ 46,  84,  66],
        ...,
        [ 16,  30,  15],
        [ 16,  27,  15],
        [ 15,  25,  14]],

       [[ 50,  66,  60],
        [ 48,  72,  62],
        [ 46,  87,  67],
        ...,
        [ 11,  25,  10],
        [ 17,  29,  15],
        [ 20,  32,  19]]], dtype=uint8)]"
Image_1140.jpg,278,168,175,171,800,533,453,339,175,daskShared_local/images/Image_1140.jpg,1140,"[array([[[254, 240, 240],
        [245, 231, 232],
        [247, 227, 223],
        ...,
        [ 52,  51,  71],
        [ 13,  12,  30],
        [ 21,  20,  36]],

       [[244, 233, 240],
        [237, 226, 232],
        [243, 224, 226],
        ...,
        [ 67,  66,  86],
        [ 27,  26,  43],
        [  6,   5,  20]],

       [[251, 242, 250],
        [247, 237, 245],
        [250, 238, 238],
        ...,
        [ 78,  77,  92],
        [ 44,  43,  58],
        [ 18,  18,  32]],

       ...,

       [[136, 100,  83],
        [157, 121, 105],
        [182, 152, 135],
        ...,
        [111,  97,  88],
        [106,  92,  83],
        [ 99,  85,  76]],

       [[139, 104,  85],
        [169, 134, 115],
        [190, 159, 142],
        ...,
        [119, 105,  96],
        [109,  95,  86],
        [ 98,  84,  75]],

       [[157, 122, 102],
        [179, 144, 124],
        [187, 154, 139],
        ...,
        [128, 114, 105],
        [114, 100,  91],
        [100,  86,  77]]], dtype=uint8)]"
Image_1141.jpg,329,134,273,227,845,563,602,361,273,daskShared_local/images/Image_1141.jpg,1141,"[array([[[ 94, 201, 203],
        [113, 208, 213],
        [136, 218, 228],
        ...,
        [ 90, 202, 198],
        [ 90, 201, 198],
        [ 88, 199, 195]],

       [[117, 203, 210],
        [137, 209, 217],
        [159, 219, 229],
        ...,
        [ 91, 199, 199],
        [ 93, 199, 199],
        [ 93, 197, 196]],

       [[120, 209, 214],
        [136, 213, 220],
        [156, 221, 230],
        ...,
        [ 85, 198, 196],
        [ 89, 198, 197],
        [ 89, 197, 197]],

       ...,

       [[ 56, 109,  49],
        [ 58, 105,  47],
        [ 60,  99,  44],
        ...,
        [ 49, 194, 191],
        [ 49, 195, 192],
        [ 49, 195, 192]],

       [[ 61, 100,  37],
        [ 58,  98,  35],
        [ 55,  97,  32],
        ...,
        [ 64, 201, 195],
        [ 63, 201, 195],
        [ 63, 201, 195]],

       [[ 56,  83,  15],
        [ 49,  84,  14],
        [ 43,  87,  13],
        ...,
        [ 74, 206, 199],
        [ 75, 207, 201],
        [ 74, 208, 201]]], dtype=uint8)]"
Image_1142.jpg,355,94,154,203,728,486,509,297,203,daskShared_local/images/Image_1142.jpg,1142,"[array([[[  1,  66, 254],
        [  2,  65, 255],
        [  1,  64, 253],
        ...,
        [  0, 111, 253],
        [  1, 110, 253],
        [  0, 111, 252]],

       [[  1,  64, 253],
        [  0,  67, 254],
        [  2,  67, 255],
        ...,
        [  1, 110, 253],
        [  0, 106, 254],
        [  3, 114, 255]],

       [[  2,  62, 255],
        [  1,  64, 253],
        [  0,  67, 254],
        ...,
        [  2, 108, 254],
        [  0, 109, 254],
        [  0, 111, 253]],

       ...,

       [[194, 151, 119],
        [194, 149, 114],
        [193, 134,  98],
        ...,
        [170, 183, 192],
        [223, 221, 215],
        [216, 203, 180]],

       [[204, 170, 135],
        [195, 148, 112],
        [187, 128,  91],
        ...,
        [130, 128, 117],
        [206, 208, 212],
        [231, 223, 204]],

       [[218, 177, 135],
        [192, 147, 112],
        [179, 119,  83],
        ...,
        [ 94,  97,  90],
        [175, 179, 180],
        [230, 226, 215]]], dtype=uint8)]"
Image_1143.jpg,304,205,205,209,1000,600,509,414,209,daskShared_local/images/Image_1143.jpg,1143,"[array([[[  1, 146, 193],
        [  1, 146, 193],
        [  0, 148, 194],
        ...,
        [  1, 157, 205],
        [  1, 157, 205],
        [  1, 157, 205]],

       [[  1, 146, 193],
        [  1, 146, 193],
        [  0, 147, 193],
        ...,
        [  1, 157, 205],
        [  1, 157, 205],
        [  1, 157, 205]],

       [[  1, 146, 193],
        [  1, 146, 193],
        [  0, 146, 192],
        ...,
        [  1, 157, 204],
        [  1, 157, 204],
        [  1, 157, 204]],

       ...,

       [[147, 113,  34],
        [176, 136,  50],
        [204, 156,  78],
        ...,
        [246, 220, 146],
        [246, 219, 142],
        [246, 217, 139]],

       [[189, 147,  40],
        [205, 153,  78],
        [219, 165, 107],
        ...,
        [245, 221, 151],
        [246, 220, 146],
        [246, 218, 144]],

       [[215, 173,  59],
        [222, 170,  97],
        [216, 168, 104],
        ...,
        [245, 221, 158],
        [244, 219, 152],
        [246, 219, 150]]], dtype=uint8)]"
Image_1144.png,391,181,311,290,900,600,702,471,311,daskShared_local/images/Image_1144.png,1144,"[array([[[128, 137, 137],
        [148, 146, 146],
        [143, 138, 141],
        ...,
        [ 22, 148, 179],
        [ 18, 153, 181],
        [ 19, 152, 183]],

       [[136, 128, 126],
        [132, 135, 144],
        [134, 132, 141],
        ...,
        [ 21, 153, 185],
        [ 24, 152, 185],
        [ 17, 151, 183]],

       [[122, 113, 109],
        [133, 131, 126],
        [128, 132, 129],
        ...,
        [ 27, 152, 186],
        [ 25, 152, 182],
        [ 22, 150, 185]],

       ...,

       [[ 44, 101,  90],
        [ 32,  88,  84],
        [ 26,  71,  75],
        ...,
        [ 85, 152, 138],
        [ 92, 158, 146],
        [ 97, 167, 155]],

       [[ 14,  64,  60],
        [ 19,  56,  55],
        [ 21,  55,  55],
        ...,
        [ 82, 149, 140],
        [ 94, 154, 150],
        [ 94, 162, 151]],

       [[ 17,  59,  56],
        [ 22,  57,  56],
        [ 19,  56,  56],
        ...,
        [ 80, 156, 143],
        [ 89, 160, 147],
        [ 97, 160, 147]]], dtype=uint8)]"
Image_1145.jpg,425,145,246,245,1200,822,671,390,246,daskShared_local/images/Image_1145.jpg,1145,"[array([[[  0, 145, 172],
        [  0, 144, 171],
        [  0, 143, 170],
        ...,
        [  0, 161, 186],
        [  1, 163, 188],
        [  2, 164, 189]],

       [[  2, 147, 174],
        [  1, 146, 173],
        [  0, 145, 172],
        ...,
        [  0, 161, 187],
        [  1, 163, 189],
        [  2, 164, 190]],

       [[  1, 146, 173],
        [  1, 146, 173],
        [  0, 145, 172],
        ...,
        [  1, 161, 189],
        [  2, 163, 191],
        [  1, 162, 190]],

       ...,

       [[ 89, 112,  62],
        [ 94, 111,  61],
        [ 82,  93,  42],
        ...,
        [204, 188, 160],
        [167, 148, 128],
        [132, 109,  85]],

       [[ 89, 112,  64],
        [ 92, 110,  60],
        [ 81,  95,  43],
        ...,
        [215, 198, 166],
        [190, 167, 142],
        [169, 141, 110]],

       [[ 99, 119,  68],
        [ 92, 109,  61],
        [ 78,  92,  42],
        ...,
        [210, 190, 154],
        [197, 169, 141],
        [173, 142, 104]]], dtype=uint8)]"
Image_1146.jpg,693,272,478,512,1920,1080,1171,784,512,daskShared_local/images/Image_1146.jpg,1146,"[array([[[  0, 119, 203],
        [  0, 119, 203],
        [  0, 119, 203],
        ...,
        [  2, 117, 200],
        [  2, 117, 200],
        [  2, 117, 200]],

       [[  0, 119, 203],
        [  0, 119, 203],
        [  0, 119, 203],
        ...,
        [  2, 117, 200],
        [  2, 117, 200],
        [  2, 117, 200]],

       [[  0, 119, 203],
        [  0, 119, 203],
        [  0, 119, 203],
        ...,
        [  2, 117, 200],
        [  2, 117, 200],
        [  2, 117, 200]],

       ...,

       [[ 75,  87,  63],
        [ 86,  96,  68],
        [109, 114,  85],
        ...,
        [196, 184, 149],
        [179, 167, 133],
        [181, 168, 134]],

       [[ 97, 112,  91],
        [127, 139, 116],
        [106, 111,  89],
        ...,
        [215, 207, 171],
        [188, 181, 145],
        [200, 193, 157]],

       [[119, 137, 115],
        [120, 137, 112],
        [ 84,  94,  67],
        ...,
        [203, 198, 165],
        [182, 177, 142],
        [196, 190, 156]]], dtype=uint8)]"
Image_1147.jpg,39,80,216,178,800,600,255,258,216,daskShared_local/images/Image_1147.jpg,1147,"[array([[[  7, 151, 201],
        [  7, 152, 199],
        [ 17, 159, 205],
        ...,
        [ 20, 178, 223],
        [ 20, 181, 223],
        [ 19, 178, 220]],

       [[  5, 151, 200],
        [  6, 152, 198],
        [ 13, 157, 203],
        ...,
        [ 21, 182, 223],
        [ 20, 181, 223],
        [ 20, 181, 223]],

       [[  5, 153, 199],
        [  4, 152, 198],
        [  6, 152, 199],
        ...,
        [ 21, 182, 221],
        [ 20, 182, 220],
        [ 20, 182, 222]],

       ...,

       [[ 66, 129, 112],
        [ 67, 132, 112],
        [ 63, 131, 111],
        ...,
        [ 97,  71,  47],
        [ 93,  65,  39],
        [ 86,  56,  33]],

       [[ 65, 129, 110],
        [ 66, 134, 113],
        [ 67, 136, 116],
        ...,
        [100,  76,  51],
        [102,  77,  48],
        [105,  75,  49]],

       [[ 65, 128, 109],
        [ 67, 135, 114],
        [ 67, 136, 117],
        ...,
        [ 95,  71,  46],
        [102,  76,  49],
        [102,  72,  46]]], dtype=uint8)]"
Image_1148.jpg,468,129,281,315,1600,1019,749,444,315,daskShared_local/images/Image_1148.jpg,1148,"[array([[[ 26, 109, 213],
        [ 26, 109, 213],
        [ 26, 109, 213],
        ...,
        [ 28, 116, 213],
        [ 28, 116, 213],
        [ 28, 116, 213]],

       [[ 26, 109, 213],
        [ 26, 109, 213],
        [ 26, 109, 213],
        ...,
        [ 28, 116, 213],
        [ 28, 116, 213],
        [ 28, 116, 213]],

       [[ 26, 109, 213],
        [ 26, 109, 213],
        [ 26, 109, 213],
        ...,
        [ 28, 116, 213],
        [ 28, 116, 213],
        [ 28, 116, 213]],

       ...,

       [[253, 254, 243],
        [250, 252, 241],
        [245, 247, 236],
        ...,
        [106,  81,  74],
        [113,  87,  82],
        [115,  90,  84]],

       [[254, 254, 247],
        [248, 249, 241],
        [237, 239, 228],
        ...,
        [101,  61,  57],
        [107,  65,  61],
        [ 87,  42,  37]],

       [[255, 255, 251],
        [249, 250, 244],
        [225, 227, 217],
        ...,
        [154, 103, 102],
        [154,  97,  95],
        [106,  45,  43]]], dtype=uint8)]"
Image_1149.jpg,995,137,251,324,1686,1216,1246,461,324,daskShared_local/images/Image_1149.jpg,1149,"[array([[[126, 183, 213],
        [126, 183, 213],
        [127, 184, 214],
        ...,
        [162, 202, 227],
        [163, 203, 228],
        [163, 203, 228]],

       [[126, 183, 213],
        [126, 183, 213],
        [127, 184, 214],
        ...,
        [161, 201, 226],
        [162, 202, 227],
        [162, 202, 227]],

       [[126, 183, 213],
        [126, 183, 213],
        [126, 183, 213],
        ...,
        [160, 200, 225],
        [161, 201, 226],
        [161, 201, 226]],

       ...,

       [[136, 190, 167],
        [133, 189, 163],
        [102, 161, 135],
        ...,
        [ 90, 166, 202],
        [ 92, 166, 201],
        [ 93, 167, 202]],

       [[118, 168, 156],
        [129, 185, 160],
        [ 97, 154, 129],
        ...,
        [ 90, 166, 202],
        [ 93, 167, 202],
        [ 93, 167, 202]],

       [[108, 156, 145],
        [122, 175, 152],
        [ 98, 153, 129],
        ...,
        [ 90, 166, 202],
        [ 92, 166, 201],
        [ 90, 164, 199]]], dtype=uint8)]"
Image_115.jpg,559,184,99,79,1000,700,658,263,99,daskShared_local/images/Image_115.jpg,115,"[array([[[  1, 158, 229],
        [  1, 158, 229],
        [  1, 158, 229],
        ...,
        [  0, 155, 224],
        [  0, 156, 225],
        [  0, 156, 225]],

       [[  1, 158, 229],
        [  1, 158, 229],
        [  1, 158, 229],
        ...,
        [  0, 155, 224],
        [  0, 156, 225],
        [  0, 156, 225]],

       [[  0, 158, 229],
        [  0, 158, 229],
        [  0, 157, 228],
        ...,
        [  0, 156, 225],
        [  0, 156, 226],
        [  0, 156, 226]],

       ...,

       [[134, 172, 190],
        [134, 172, 190],
        [149, 186, 199],
        ...,
        [  0, 153, 222],
        [  1, 153, 221],
        [  1, 153, 221]],

       [[100, 145, 164],
        [100, 145, 164],
        [112, 155, 169],
        ...,
        [  0, 151, 222],
        [  0, 151, 222],
        [  0, 151, 222]],

       [[100, 145, 164],
        [100, 145, 164],
        [112, 155, 169],
        ...,
        [  0, 151, 222],
        [  0, 151, 222],
        [  0, 151, 222]]], dtype=uint8)]"
Image_1150.jpg,425,156,812,662,1500,1000,1237,818,812,daskShared_local/images/Image_1150.jpg,1150,"[array([[[  3,  55,  66],
        [  3,  55,  66],
        [  2,  54,  65],
        ...,
        [173, 167, 178],
        [131, 130, 156],
        [101, 104, 140]],

       [[  3,  55,  66],
        [  3,  55,  66],
        [  2,  54,  65],
        ...,
        [163, 159, 174],
        [115, 116, 147],
        [ 95, 100, 139]],

       [[  3,  55,  66],
        [  2,  54,  65],
        [  2,  54,  65],
        ...,
        [142, 139, 161],
        [ 96,  98, 136],
        [ 84,  88, 132]],

       ...,

       [[190, 192, 197],
        [173, 176, 187],
        [145, 151, 181],
        ...,
        [ 55,  81,  54],
        [ 57,  85,  55],
        [ 57,  85,  55]],

       [[203, 203, 205],
        [192, 192, 198],
        [164, 167, 186],
        ...,
        [ 58,  84,  56],
        [ 58,  85,  56],
        [ 57,  86,  56]],

       [[207, 206, 210],
        [199, 200, 205],
        [178, 180, 194],
        ...,
        [ 58,  84,  55],
        [ 60,  86,  57],
        [ 58,  86,  56]]], dtype=uint8)]"
Image_1151.jpg,457,278,158,169,850,567,615,447,169,daskShared_local/images/Image_1151.jpg,1151,"[array([[[152,  95,  80],
        [152,  99,  85],
        [160, 109,  93],
        ...,
        [ 32,  48,  65],
        [ 32,  46,  66],
        [ 29,  41,  63]],

       [[216, 165, 139],
        [211, 159, 136],
        [200, 147, 127],
        ...,
        [ 26,  41,  59],
        [ 29,  41,  64],
        [ 27,  39,  64]],

       [[228, 175, 145],
        [216, 163, 134],
        [197, 147, 121],
        ...,
        [ 37,  48,  70],
        [ 40,  50,  70],
        [ 24,  34,  58]],

       ...,

       [[  8, 122, 234],
        [  8, 122, 234],
        [  8, 122, 234],
        ...,
        [ 10, 128, 234],
        [ 10, 128, 234],
        [ 10, 128, 234]],

       [[  9, 123, 235],
        [  8, 122, 234],
        [  9, 123, 235],
        ...,
        [ 10, 128, 234],
        [ 11, 129, 235],
        [ 11, 129, 235]],

       [[  9, 123, 235],
        [  9, 123, 235],
        [  9, 123, 235],
        ...,
        [ 11, 129, 235],
        [ 11, 129, 235],
        [ 11, 129, 235]]], dtype=uint8)]"
Image_1152.jpg,239,380,875,693,1512,1231,1114,1073,875,daskShared_local/images/Image_1152.jpg,1152,"[array([[[ 77,  90,  79],
        [ 76,  88,  79],
        [ 76,  87,  78],
        ...,
        [ 78, 110,  79],
        [ 77, 106,  79],
        [ 78, 107,  79]],

       [[ 73,  87,  77],
        [ 71,  84,  74],
        [ 72,  84,  73],
        ...,
        [ 81, 113,  81],
        [ 78, 108,  79],
        [ 77, 107,  79]],

       [[ 70,  85,  76],
        [ 69,  84,  73],
        [ 69,  83,  69],
        ...,
        [ 82, 115,  82],
        [ 78, 110,  79],
        [ 77, 108,  78]],

       ...,

       [[131, 126, 121],
        [121, 120, 116],
        [123, 122, 119],
        ...,
        [248, 238, 220],
        [248, 238, 219],
        [247, 236, 216]],

       [[122, 120, 117],
        [122, 121, 119],
        [123, 122, 120],
        ...,
        [248, 241, 221],
        [247, 239, 223],
        [243, 235, 219]],

       [[127, 124, 121],
        [126, 123, 120],
        [122, 119, 118],
        ...,
        [246, 233, 221],
        [243, 233, 216],
        [241, 232, 215]]], dtype=uint8)]"
Image_1153.jpg,647,286,313,328,1600,1000,960,614,328,daskShared_local/images/Image_1153.jpg,1153,"[array([[[  0,  71, 161],
        [  0,  71, 161],
        [  0,  71, 161],
        ...,
        [  2,  69, 160],
        [  2,  69, 160],
        [  2,  69, 160]],

       [[  0,  71, 163],
        [  0,  71, 163],
        [  0,  71, 163],
        ...,
        [  2,  69, 160],
        [  2,  69, 160],
        [  2,  69, 160]],

       [[  0,  71, 163],
        [  0,  71, 163],
        [  0,  71, 163],
        ...,
        [  2,  69, 160],
        [  1,  68, 159],
        [  1,  68, 159]],

       ...,

       [[ 70,  72,  49],
        [ 59,  62,  44],
        [ 29,  41,  18],
        ...,
        [100,  92,  52],
        [114, 108,  62],
        [118, 108,  61]],

       [[ 49,  53,  31],
        [ 31,  35,  20],
        [ 38,  50,  31],
        ...,
        [103,  91,  53],
        [105,  93,  53],
        [106,  91,  52]],

       [[ 53,  57,  37],
        [ 25,  30,  18],
        [ 36,  49,  33],
        ...,
        [112,  97,  63],
        [120, 102,  68],
        [126, 110,  74]]], dtype=uint8)]"
Image_1154.jpg,2463,878,580,634,3840,2160,3043,1512,634,daskShared_local/images/Image_1154.jpg,1154,"[array([[[141, 120, 108],
        [111,  94,  82],
        [110,  96,  84],
        ...,
        [  1, 132, 176],
        [  1, 132, 176],
        [  1, 131, 175]],

       [[169, 148, 134],
        [163, 145, 131],
        [140, 125, 111],
        ...,
        [  1, 134, 177],
        [  1, 133, 176],
        [  1, 132, 176]],

       [[173, 152, 138],
        [194, 176, 161],
        [213, 198, 183],
        ...,
        [  1, 134, 177],
        [  0, 133, 176],
        [  1, 132, 176]],

       ...,

       [[  1, 140, 168],
        [  3, 143, 169],
        [  4, 145, 170],
        ...,
        [  1, 120, 162],
        [  0, 119, 161],
        [  0, 119, 161]],

       [[  2, 137, 167],
        [  2, 139, 167],
        [  2, 140, 166],
        ...,
        [  0, 119, 162],
        [  0, 119, 162],
        [  0, 119, 162]],

       [[  2, 136, 166],
        [  1, 135, 164],
        [  0, 136, 163],
        ...,
        [  1, 120, 163],
        [  1, 119, 163],
        [  1, 119, 164]]], dtype=uint8)]"
Image_1155.jpg,897,441,646,560,3008,2000,1543,1001,646,daskShared_local/images/Image_1155.jpg,1155,"[array([[[148, 187, 194],
        [148, 187, 194],
        [148, 187, 194],
        ...,
        [138, 183, 194],
        [140, 182, 194],
        [140, 182, 194]],

       [[148, 187, 194],
        [148, 187, 194],
        [148, 187, 194],
        ...,
        [140, 182, 194],
        [140, 182, 194],
        [140, 182, 194]],

       [[148, 187, 194],
        [148, 187, 194],
        [148, 187, 194],
        ...,
        [140, 182, 194],
        [140, 182, 194],
        [140, 182, 194]],

       ...,

       [[132, 185, 193],
        [128, 181, 189],
        [128, 181, 189],
        ...,
        [ 78,  88,  94],
        [ 76,  89,  95],
        [ 74,  87,  93]],

       [[130, 184, 192],
        [127, 181, 188],
        [126, 181, 188],
        ...,
        [ 72,  79,  89],
        [ 73,  85,  91],
        [ 79,  91,  96]],

       [[125, 184, 190],
        [122, 181, 187],
        [121, 180, 186],
        ...,
        [ 90,  98, 116],
        [ 90, 101, 104],
        [ 89, 101, 105]]], dtype=uint8)]"
Image_1156.jpg,352,118,204,207,1280,720,556,325,207,daskShared_local/images/Image_1156.jpg,1156,"[array([[[ 18, 107, 197],
        [ 12, 103, 192],
        [ 13, 104, 193],
        ...,
        [ 18, 129, 211],
        [ 16, 127, 209],
        [ 16, 127, 209]],

       [[  8,  97, 187],
        [ 10,  99, 189],
        [ 12, 102, 192],
        ...,
        [ 13, 124, 206],
        [ 11, 122, 204],
        [ 12, 123, 205]],

       [[ 16, 105, 195],
        [ 15, 104, 194],
        [ 15, 104, 194],
        ...,
        [ 16, 127, 209],
        [ 18, 129, 211],
        [ 22, 133, 215]],

       ...,

       [[ 16,  80, 170],
        [ 11,  76, 168],
        [ 12,  77, 169],
        ...,
        [  5,   8,   3],
        [ 18,  21,  12],
        [ 38,  40,  31]],

       [[ 12,  76, 166],
        [  7,  72, 164],
        [  8,  73, 165],
        ...,
        [ 14,  19,  12],
        [ 98, 101,  94],
        [161, 164, 155]],

       [[ 18,  82, 172],
        [ 14,  79, 171],
        [ 14,  79, 171],
        ...,
        [ 36,  42,  35],
        [123, 128, 121],
        [157, 160, 153]]], dtype=uint8)]"
Image_1157.jpg,414,6,418,524,1280,720,832,530,524,daskShared_local/images/Image_1157.jpg,1157,"[array([[[160, 228, 239],
        [160, 228, 238],
        [160, 226, 236],
        ...,
        [ 75, 185, 216],
        [ 78, 188, 216],
        [ 75, 185, 214]],

       [[158, 228, 238],
        [157, 227, 238],
        [158, 227, 238],
        ...,
        [ 89, 193, 220],
        [ 83, 191, 218],
        [ 69, 185, 212]],

       [[154, 226, 239],
        [154, 226, 238],
        [153, 225, 238],
        ...,
        [ 75, 189, 211],
        [ 67, 189, 212],
        [ 58, 184, 210]],

       ...,

       [[116,  94,  54],
        [122,  99,  57],
        [116,  93,  52],
        ...,
        [  2,  69,  93],
        [  3,  69,  95],
        [  3,  69,  95]],

       [[ 94,  79,  45],
        [115,  93,  50],
        [116,  92,  50],
        ...,
        [  3,  68,  92],
        [  3,  69,  95],
        [  3,  69,  95]],

       [[ 53,  51,  33],
        [ 87,  72,  42],
        [111,  86,  46],
        ...,
        [  2,  67,  93],
        [  4,  67,  93],
        [  2,  69,  94]]], dtype=uint8)]"
Image_1158.jpg,209,434,176,205,2015,1510,385,639,205,daskShared_local/images/Image_1158.jpg,1158,"[array([[[ 71,  65,  49],
        [ 61,  55,  40],
        [ 34,  28,  14],
        ...,
        [ 14,   5,   6],
        [ 14,   5,   6],
        [ 18,   9,  10]],

       [[ 58,  55,  38],
        [ 52,  49,  34],
        [ 37,  34,  19],
        ...,
        [ 11,   3,   4],
        [ 12,   3,   4],
        [ 16,   7,   8]],

       [[ 45,  42,  27],
        [ 42,  39,  24],
        [ 44,  40,  28],
        ...,
        [ 18,   9,  10],
        [ 20,  11,  12],
        [ 26,  17,  18]],

       ...,

       [[137, 124, 108],
        [ 95,  82,  65],
        [119, 103,  87],
        ...,
        [136, 140, 141],
        [136, 140, 141],
        [146, 150, 151]],

       [[144, 131, 114],
        [111,  95,  79],
        [127, 112,  93],
        ...,
        [142, 146, 147],
        [138, 142, 143],
        [145, 149, 150]],

       [[153, 140, 123],
        [155, 140, 121],
        [164, 149, 130],
        ...,
        [153, 157, 158],
        [143, 147, 148],
        [143, 147, 148]]], dtype=uint8)]"
Image_1159.jpg,606,304,208,173,1400,933,814,477,208,daskShared_local/images/Image_1159.jpg,1159,"[array([[[  1, 172, 228],
        [  1, 172, 228],
        [  0, 171, 227],
        ...,
        [  1, 210, 249],
        [  1, 208, 248],
        [  1, 208, 248]],

       [[  1, 172, 228],
        [  1, 172, 228],
        [  1, 171, 230],
        ...,
        [  4, 207, 250],
        [  3, 206, 249],
        [  2, 205, 248]],

       [[  1, 172, 228],
        [  1, 172, 228],
        [  1, 171, 230],
        ...,
        [  2, 207, 250],
        [  2, 207, 250],
        [  2, 207, 250]],

       ...,

       [[214, 202, 146],
        [161, 137,  73],
        [126, 112,  69],
        ...,
        [  1, 180, 236],
        [  1, 180, 236],
        [  1, 180, 236]],

       [[251, 247, 215],
        [197, 179, 125],
        [107,  90,  51],
        ...,
        [  1, 180, 236],
        [  1, 180, 236],
        [  1, 180, 236]],

       [[249, 234, 208],
        [163, 155, 109],
        [ 97,  79,  44],
        ...,
        [  1, 180, 236],
        [  1, 180, 236],
        [  1, 180, 236]]], dtype=uint8)]"
Image_116.jpg,387,41,1137,971,1920,1080,1524,1012,1137,daskShared_local/images/Image_116.jpg,116,"[array([[[  0, 125, 157],
        [  0, 125, 157],
        [  0, 124, 155],
        ...,
        [  1,  85,  95],
        [  2, 104, 110],
        [  1,  97, 110]],

       [[  0, 126, 158],
        [  0, 125, 157],
        [  0, 124, 155],
        ...,
        [  2,  87, 102],
        [  1,  83, 109],
        [  1,  78, 108]],

       [[  0, 127, 156],
        [  0, 126, 156],
        [  1, 125, 156],
        ...,
        [  1,  78, 105],
        [  1,  77, 108],
        [  0,  76, 105]],

       ...,

       [[100,  87,  45],
        [ 95,  89,  49],
        [ 97,  93,  56],
        ...,
        [ 34,  33,  23],
        [ 36,  35,  24],
        [ 36,  35,  26]],

       [[ 95,  87,  46],
        [ 86,  84,  46],
        [ 82,  78,  44],
        ...,
        [ 36,  37,  25],
        [ 32,  33,  24],
        [ 29,  29,  21]],

       [[ 85,  77,  40],
        [ 78,  73,  37],
        [ 94,  89,  53],
        ...,
        [ 44,  42,  26],
        [ 34,  34,  23],
        [ 30,  28,  21]]], dtype=uint8)]"
Image_1160.jpg,393,976,807,638,4601,3200,1200,1614,807,daskShared_local/images/Image_1160.jpg,1160,"[array([[[ 35, 165, 238],
        [ 30, 162, 246],
        [ 32, 162, 239],
        ...,
        [ 48, 155, 228],
        [ 49, 156, 227],
        [ 49, 154, 223]],

       [[ 36, 159, 230],
        [ 21, 165, 244],
        [ 26, 158, 238],
        ...,
        [ 55, 162, 238],
        [ 58, 163, 240],
        [ 53, 154, 230]],

       [[ 38, 161, 234],
        [ 18, 166, 243],
        [ 24, 157, 238],
        ...,
        [ 56, 163, 239],
        [ 55, 165, 240],
        [ 57, 170, 245]],

       ...,

       [[ 16, 158, 219],
        [ 25, 156, 220],
        [ 25, 155, 216],
        ...,
        [ 43, 153, 213],
        [ 48, 160, 222],
        [ 44, 154, 214]],

       [[ 23, 158, 223],
        [ 35, 155, 230],
        [ 28, 150, 224],
        ...,
        [ 40, 152, 200],
        [ 45, 155, 205],
        [ 46, 153, 195]],

       [[ 25, 158, 223],
        [ 25, 142, 217],
        [ 31, 154, 225],
        ...,
        [ 40, 151, 206],
        [ 45, 155, 210],
        [ 45, 154, 206]]], dtype=uint8)]"
Image_1161.jpg,211,30,218,188,900,521,429,218,218,daskShared_local/images/Image_1161.jpg,1161,"[array([[[ 16,  58, 170],
        [ 16,  58, 170],
        [ 16,  58, 170],
        ...,
        [ 33,  70, 185],
        [ 33,  70, 185],
        [ 33,  70, 185]],

       [[ 16,  58, 170],
        [ 16,  58, 170],
        [ 17,  59, 171],
        ...,
        [ 34,  69, 185],
        [ 34,  69, 185],
        [ 34,  69, 185]],

       [[ 16,  58, 170],
        [ 16,  58, 170],
        [ 17,  59, 171],
        ...,
        [ 34,  69, 185],
        [ 34,  69, 185],
        [ 34,  69, 185]],

       ...,

       [[  0,  54, 140],
        [  0,  54, 140],
        [  0,  54, 140],
        ...,
        [196, 214, 213],
        [213, 232, 230],
        [214, 233, 231]],

       [[  0,  54, 140],
        [  0,  54, 140],
        [  0,  54, 140],
        ...,
        [189, 207, 207],
        [202, 221, 219],
        [208, 227, 225]],

       [[  0,  56, 137],
        [  0,  56, 138],
        [  0,  55, 141],
        ...,
        [187, 207, 206],
        [205, 225, 224],
        [221, 241, 240]]], dtype=uint8)]"
Image_1162.jpg,98,256,171,124,900,600,269,380,171,daskShared_local/images/Image_1162.jpg,1162,"[array([[[  0,  74,  83],
        [  2,  76,  83],
        [  3,  78,  84],
        ...,
        [  1,  89, 102],
        [  2,  91, 107],
        [  4,  93, 109]],

       [[  0,  72,  81],
        [  2,  75,  83],
        [  5,  76,  84],
        ...,
        [  1,  88, 102],
        [  1,  89, 105],
        [  3,  92, 108]],

       [[  0,  72,  81],
        [  1,  72,  81],
        [  2,  74,  82],
        ...,
        [  1,  85, 100],
        [  1,  87, 104],
        [  3,  90, 107]],

       ...,

       [[  0,  79,  86],
        [  1,  81,  88],
        [  1,  78,  86],
        ...,
        [ 10,  46,  40],
        [ 15,  50,  44],
        [ 18,  53,  47]],

       [[  0,  79,  87],
        [  2,  82,  89],
        [  2,  81,  88],
        ...,
        [ 11,  46,  41],
        [ 15,  50,  45],
        [ 19,  54,  48]],

       [[  0,  77,  84],
        [  2,  80,  87],
        [  1,  80,  87],
        ...,
        [ 13,  48,  44],
        [ 17,  52,  47],
        [ 19,  54,  50]]], dtype=uint8)]"
Image_1163.jpg,699,183,186,150,1000,600,885,333,186,daskShared_local/images/Image_1163.jpg,1163,"[array([[[  3, 159, 207],
        [  4, 159, 207],
        [  6, 158, 207],
        ...,
        [  3, 147, 207],
        [  4, 148, 208],
        [  5, 149, 209]],

       [[  3, 159, 207],
        [  4, 159, 207],
        [  6, 158, 207],
        ...,
        [  6, 151, 208],
        [  6, 151, 208],
        [  6, 151, 208]],

       [[  1, 157, 205],
        [  2, 157, 205],
        [  4, 156, 205],
        ...,
        [  8, 153, 210],
        [  8, 153, 210],
        [  7, 152, 209]],

       ...,

       [[ 90,  71,  23],
        [ 82,  66,  10],
        [109,  93,  24],
        ...,
        [173, 168, 185],
        [164, 160, 175],
        [176, 173, 176]],

       [[165, 146,  87],
        [155, 138,  68],
        [184, 169,  86],
        ...,
        [158, 160, 137],
        [136, 139, 112],
        [132, 135, 110]],

       [[251, 233, 167],
        [222, 206, 127],
        [202, 188,  95],
        ...,
        [137, 146,  77],
        [140, 150,  80],
        [142, 149,  98]]], dtype=uint8)]"
Image_1164.jpg,373,338,355,222,1904,803,728,560,355,daskShared_local/images/Image_1164.jpg,1164,"[array([[[  2,  58,  95],
        [  1,  57,  94],
        [  0,  56,  93],
        ...,
        [ 86, 155, 163],
        [111, 142, 154],
        [193, 199, 210]],

       [[  0,  54,  93],
        [  0,  54,  93],
        [  0,  53,  92],
        ...,
        [ 93, 157, 165],
        [152, 185, 193],
        [232, 244, 247]],

       [[  0,  53,  92],
        [  0,  53,  92],
        [  0,  54,  93],
        ...,
        [181, 240, 244],
        [222, 252, 253],
        [224, 245, 244]],

       ...,

       [[  0,  35,  87],
        [  0,  34,  84],
        [  0,  36,  78],
        ...,
        [  7, 132, 164],
        [  1, 130, 155],
        [  4, 145, 162]],

       [[  4,  36,  82],
        [  3,  39,  82],
        [  1,  41,  79],
        ...,
        [  8,  99, 135],
        [  7, 103, 137],
        [ 19, 127, 160]],

       [[  6,  37,  82],
        [  4,  40,  81],
        [  0,  40,  76],
        ...,
        [  2,  79, 112],
        [  9,  94, 129],
        [ 17, 111, 147]]], dtype=uint8)]"
Image_1165.jpg,269,195,185,133,1000,667,454,328,185,daskShared_local/images/Image_1165.jpg,1165,"[array([[[  0,  68, 175],
        [  1,  69, 176],
        [  3,  70, 175],
        ...,
        [  2,  49, 135],
        [  1,  47, 132],
        [  0,  46, 132]],

       [[  1,  70, 174],
        [  2,  71, 174],
        [  2,  69, 173],
        ...,
        [  3,  49, 136],
        [  1,  49, 134],
        [  1,  49, 134]],

       [[  1,  70, 172],
        [  2,  71, 172],
        [  1,  69, 171],
        ...,
        [  2,  48, 134],
        [  2,  48, 133],
        [  1,  48, 131]],

       ...,

       [[ 72,  96,  78],
        [ 76,  97,  93],
        [ 81, 124, 119],
        ...,
        [127, 128,  74],
        [104, 105,  69],
        [153, 161, 128]],

       [[ 86, 121,  94],
        [ 87, 118, 106],
        [ 79, 126, 118],
        ...,
        [156, 156,  99],
        [153, 148,  94],
        [177, 177, 127]],

       [[ 88, 136, 108],
        [ 99, 136, 109],
        [ 90, 137, 124],
        ...,
        [179, 179, 116],
        [175, 175, 116],
        [183, 187, 136]]], dtype=uint8)]"
Image_1166.jpg,369,19,145,141,550,380,514,160,145,daskShared_local/images/Image_1166.jpg,1166,"[array([[[ 76,  95, 153],
        [ 75,  94, 152],
        [ 75,  94, 152],
        ...,
        [ 71,  86, 145],
        [ 71,  86, 145],
        [ 71,  86, 145]],

       [[ 76,  95, 153],
        [ 75,  94, 152],
        [ 75,  94, 152],
        ...,
        [ 70,  85, 144],
        [ 71,  86, 145],
        [ 71,  86, 145]],

       [[ 76,  95, 153],
        [ 75,  94, 152],
        [ 75,  94, 152],
        ...,
        [ 70,  85, 144],
        [ 71,  86, 145],
        [ 71,  86, 145]],

       ...,

       [[149, 127, 101],
        [164, 143, 116],
        [173, 155, 126],
        ...,
        [ 66,  78, 140],
        [ 66,  78, 139],
        [ 66,  78, 139]],

       [[117,  92,  68],
        [136, 112,  87],
        [159, 136, 109],
        ...,
        [ 66,  78, 139],
        [ 66,  77, 139],
        [ 66,  77, 139]],

       [[ 98,  72,  48],
        [112,  88,  63],
        [138, 115,  88],
        ...,
        [ 65,  77, 139],
        [ 66,  77, 139],
        [ 66,  77, 139]]], dtype=uint8)]"
Image_1167.jpg,509,72,153,195,1200,630,662,267,195,daskShared_local/images/Image_1167.jpg,1167,"[array([[[  7, 159, 224],
        [  5, 157, 222],
        [  6, 155, 221],
        ...,
        [  5, 157, 224],
        [  5, 157, 224],
        [  5, 157, 224]],

       [[  7, 159, 224],
        [  5, 157, 222],
        [  4, 156, 221],
        ...,
        [  5, 157, 224],
        [  5, 157, 224],
        [  5, 157, 224]],

       [[  5, 158, 225],
        [  5, 157, 224],
        [  4, 156, 223],
        ...,
        [  5, 157, 224],
        [  5, 157, 224],
        [  5, 157, 224]],

       ...,

       [[ 26,  15,  21],
        [ 22,  11,  17],
        [ 26,  15,  21],
        ...,
        [  2,  86, 123],
        [  4,  88, 125],
        [  7,  91, 128]],

       [[ 27,  17,  18],
        [ 28,  17,  21],
        [ 31,  20,  24],
        ...,
        [  3,  87, 124],
        [  4,  88, 125],
        [  5,  89, 126]],

       [[ 25,  15,  16],
        [ 31,  21,  22],
        [ 34,  24,  23],
        ...,
        [  0,  80, 118],
        [  0,  82, 120],
        [  2,  84, 122]]], dtype=uint8)]"
Image_1168.jpg,1210,1011,453,456,2592,1944,1663,1467,456,daskShared_local/images/Image_1168.jpg,1168,"[array([[[ 69,  42,  20],
        [ 68,  41,  24],
        [ 76,  48,  35],
        ...,
        [ 43, 116, 170],
        [ 43, 116, 170],
        [ 44, 117, 170]],

       [[ 89,  63,  40],
        [ 77,  49,  31],
        [105,  76,  60],
        ...,
        [ 43, 114, 170],
        [ 43, 115, 171],
        [ 43, 115, 169]],

       [[138, 111,  86],
        [132, 104,  81],
        [145, 116,  94],
        ...,
        [ 42, 113, 171],
        [ 42, 113, 171],
        [ 41, 112, 168]],

       ...,

       [[ 39, 119, 168],
        [ 40, 120, 169],
        [ 38, 118, 168],
        ...,
        [ 37, 121, 167],
        [ 37, 121, 167],
        [ 38, 122, 168]],

       [[ 41, 121, 170],
        [ 41, 121, 172],
        [ 38, 118, 169],
        ...,
        [ 37, 121, 165],
        [ 37, 121, 165],
        [ 37, 121, 166]],

       [[ 40, 121, 170],
        [ 41, 121, 171],
        [ 40, 121, 171],
        ...,
        [ 38, 122, 167],
        [ 38, 122, 168],
        [ 38, 121, 167]]], dtype=uint8)]"
Image_1169.jpg,1043,126,2549,2695,4608,3072,3592,2821,2695,daskShared_local/images/Image_1169.jpg,1169,"[array([[[ 46,  46,  44],
        [ 44,  45,  44],
        [ 45,  45,  44],
        ...,
        [170, 164, 121],
        [169, 163, 120],
        [169, 164, 121]],

       [[ 47,  47,  45],
        [ 43,  43,  42],
        [ 40,  40,  38],
        ...,
        [169, 163, 119],
        [169, 163, 118],
        [168, 162, 119]],

       [[ 43,  43,  40],
        [ 38,  38,  36],
        [ 34,  34,  32],
        ...,
        [167, 161, 118],
        [167, 161, 117],
        [167, 161, 118]],

       ...,

       [[ 81,  65,  36],
        [ 81,  66,  36],
        [ 81,  66,  34],
        ...,
        [157, 139, 105],
        [156, 140, 112],
        [151, 139, 115]],

       [[ 76,  59,  32],
        [ 75,  59,  29],
        [ 77,  61,  31],
        ...,
        [156, 128,  82],
        [154, 124,  86],
        [156, 129,  91]],

       [[ 68,  54,  29],
        [ 68,  55,  28],
        [ 70,  56,  32],
        ...,
        [147, 125,  73],
        [163, 136,  80],
        [173, 148,  93]]], dtype=uint8)]"
Image_117.jpg,297,90,169,163,732,420,466,253,169,daskShared_local/images/Image_117.jpg,117,"[array([[[  1, 167, 217],
        [  1, 167, 217],
        [  1, 167, 217],
        ...,
        [ 59, 198, 231],
        [ 46, 190, 215],
        [ 52, 185, 215]],

       [[  2, 164, 215],
        [  2, 164, 215],
        [  1, 164, 215],
        ...,
        [103, 210, 237],
        [ 96, 203, 232],
        [ 85, 194, 223]],

       [[  1, 162, 214],
        [  1, 162, 214],
        [  1, 163, 214],
        ...,
        [ 80, 203, 228],
        [ 85, 202, 231],
        [ 77, 197, 226]],

       ...,

       [[199, 180, 156],
        [194, 175, 151],
        [170, 152, 128],
        ...,
        [  8,  49,  49],
        [  1,  58,  54],
        [  0,  51,  48]],

       [[200, 198, 179],
        [205, 204, 185],
        [201, 199, 180],
        ...,
        [  3,  17,  23],
        [  4,  26,  32],
        [  1,  21,  25]],

       [[185, 195, 178],
        [186, 198, 181],
        [186, 196, 179],
        ...,
        [  9,   2,   8],
        [ 10,   2,  12],
        [  3,   2,  12]]], dtype=uint8)]"
Image_1170.jpg,114,136,371,310,1152,768,485,446,371,daskShared_local/images/Image_1170.jpg,1170,"[array([[[181, 232, 225],
        [181, 232, 225],
        [182, 233, 226],
        ...,
        [185, 238, 230],
        [185, 238, 230],
        [185, 239, 231]],

       [[180, 233, 225],
        [180, 233, 225],
        [181, 234, 226],
        ...,
        [184, 238, 232],
        [182, 238, 231],
        [181, 238, 231]],

       [[180, 233, 225],
        [180, 233, 225],
        [181, 234, 226],
        ...,
        [175, 235, 227],
        [174, 235, 227],
        [172, 235, 226]],

       ...,

       [[ 88, 176, 185],
        [ 93, 180, 188],
        [ 98, 182, 189],
        ...,
        [106, 137, 148],
        [ 87, 116, 122],
        [ 91, 119, 121]],

       [[ 86, 174, 186],
        [ 91, 178, 188],
        [ 97, 180, 191],
        ...,
        [ 93, 125, 136],
        [ 93, 123, 130],
        [ 96, 126, 127]],

       [[ 87, 174, 186],
        [ 91, 176, 190],
        [ 97, 178, 192],
        ...,
        [ 80, 115, 126],
        [ 87, 122, 128],
        [ 92, 125, 126]]], dtype=uint8)]"
Image_1171.jpg,981,376,198,198,2000,1000,1179,574,198,daskShared_local/images/Image_1171.jpg,1171,"[array([[[197, 178, 148],
        [191, 170, 139],
        [196, 173, 141],
        ...,
        [217, 197, 162],
        [210, 190, 155],
        [207, 187, 154]],

       [[202, 183, 153],
        [197, 176, 145],
        [199, 176, 142],
        ...,
        [213, 193, 158],
        [210, 190, 155],
        [208, 188, 153]],

       [[201, 180, 149],
        [192, 172, 139],
        [191, 169, 132],
        ...,
        [213, 194, 161],
        [211, 193, 157],
        [209, 191, 155]],

       ...,

       [[129, 128,  98],
        [136, 135, 107],
        [137, 135, 112],
        ...,
        [198, 176, 135],
        [202, 178, 132],
        [195, 163, 114]],

       [[124, 123,  93],
        [129, 128, 100],
        [134, 132, 109],
        ...,
        [191, 174, 144],
        [193, 170, 136],
        [190, 162, 122]],

       [[116, 112,  85],
        [127, 123,  98],
        [130, 125, 105],
        ...,
        [212, 190, 166],
        [201, 178, 147],
        [187, 163, 125]]], dtype=uint8)]"
Image_1172.jpg,511,74,313,413,1600,900,824,487,413,daskShared_local/images/Image_1172.jpg,1172,"[array([[[  1, 155, 209],
        [  1, 156, 210],
        [  2, 157, 211],
        ...,
        [156, 201, 242],
        [155, 200, 241],
        [156, 201, 242]],

       [[  0, 154, 208],
        [  1, 155, 209],
        [  2, 157, 211],
        ...,
        [156, 201, 242],
        [155, 200, 241],
        [154, 199, 240]],

       [[  0, 154, 208],
        [  1, 155, 209],
        [  2, 157, 211],
        ...,
        [156, 201, 242],
        [156, 201, 242],
        [154, 200, 241]],

       ...,

       [[  1, 141, 202],
        [  0, 142, 202],
        [  0, 142, 202],
        ...,
        [108,  87,  81],
        [ 77,  52,  47],
        [ 90,  61,  54]],

       [[  1, 141, 202],
        [  0, 142, 202],
        [  0, 142, 202],
        ...,
        [142, 126, 115],
        [101,  81,  70],
        [ 89,  64,  50]],

       [[  1, 141, 202],
        [  0, 142, 202],
        [  0, 142, 202],
        ...,
        [162, 149, 134],
        [124, 105,  89],
        [105,  80,  61]]], dtype=uint8)]"
Image_1173.jpg,627,219,127,110,1000,667,754,329,127,daskShared_local/images/Image_1173.jpg,1173,"[array([[[ 79, 143, 143],
        [ 79, 142, 142],
        [ 77, 140, 140],
        ...,
        [  9,  92, 105],
        [  6,  92, 105],
        [  5,  91, 104]],

       [[ 80, 143, 143],
        [ 80, 142, 143],
        [ 78, 141, 141],
        ...,
        [ 10,  93, 105],
        [  7,  92, 105],
        [  6,  91, 104]],

       [[ 81, 142, 143],
        [ 80, 141, 142],
        [ 79, 140, 141],
        ...,
        [ 14,  95, 106],
        [ 11,  93, 106],
        [ 10,  92, 106]],

       ...,

       [[ 90,  90,  60],
        [ 89,  89,  60],
        [ 89,  89,  60],
        ...,
        [ 56, 139, 152],
        [ 65, 147, 159],
        [ 69, 151, 162]],

       [[107, 107,  76],
        [103, 102,  72],
        [ 94,  94,  63],
        ...,
        [ 71, 153, 165],
        [ 77, 158, 169],
        [ 80, 160, 172]],

       [[117, 116,  86],
        [110, 110,  80],
        [ 97,  98,  67],
        ...,
        [ 77, 158, 170],
        [ 82, 162, 173],
        [ 84, 164, 175]]], dtype=uint8)]"
Image_1174.jpg,214,206,140,152,800,600,354,358,152,daskShared_local/images/Image_1174.jpg,1174,"[array([[[ 78, 189, 209],
        [ 79, 190, 210],
        [ 78, 190, 210],
        ...,
        [ 29, 168, 195],
        [ 28, 168, 195],
        [ 27, 168, 195]],

       [[ 78, 188, 210],
        [ 78, 189, 211],
        [ 78, 190, 211],
        ...,
        [ 29, 168, 196],
        [ 28, 169, 196],
        [ 28, 169, 196]],

       [[ 78, 189, 211],
        [ 78, 189, 211],
        [ 78, 189, 212],
        ...,
        [ 29, 169, 196],
        [ 28, 169, 195],
        [ 27, 169, 195]],

       ...,

       [[ 17, 149, 153],
        [ 18, 149, 152],
        [ 18, 148, 151],
        ...,
        [220, 197, 149],
        [227, 200, 154],
        [234, 204, 172]],

       [[ 22, 150, 150],
        [ 23, 150, 150],
        [ 24, 150, 149],
        ...,
        [225, 202, 157],
        [229, 204, 160],
        [235, 207, 169]],

       [[ 26, 149, 148],
        [ 27, 150, 148],
        [ 27, 150, 146],
        ...,
        [228, 204, 166],
        [228, 203, 159],
        [228, 202, 151]]], dtype=uint8)]"
Image_1175.png,376,50,182,163,600,600,558,213,182,daskShared_local/images/Image_1175.png,1175,"[array([[[  0, 107, 250],
        [  0, 107, 250],
        [  0, 108, 251],
        ...,
        [  0, 121, 254],
        [  0, 121, 254],
        [  0, 120, 253]],

       [[  0, 105, 249],
        [  1, 106, 250],
        [  1, 106, 250],
        ...,
        [  2, 120, 254],
        [  2, 120, 254],
        [  2, 120, 254]],

       [[  1, 102, 249],
        [  2, 103, 251],
        [  2, 104, 250],
        ...,
        [  1, 119, 253],
        [  1, 119, 253],
        [  2, 120, 254]],

       ...,

       [[164, 155, 131],
        [164, 180, 125],
        [186, 195, 165],
        ...,
        [246, 249, 204],
        [244, 250, 187],
        [242, 251, 172]],

       [[208, 215, 208],
        [199, 201, 192],
        [185, 173, 139],
        ...,
        [247, 249, 197],
        [246, 251, 183],
        [244, 253, 170]],

       [[220, 230, 185],
        [201, 195, 214],
        [172, 163, 156],
        ...,
        [247, 250, 196],
        [246, 252, 180],
        [246, 255, 167]]], dtype=uint8)]"
Image_1176.jpg,594,78,220,173,1068,601,814,251,220,daskShared_local/images/Image_1176.jpg,1176,"[array([[[  0,  72, 254],
        [  0,  72, 254],
        [  0,  72, 254],
        ...,
        [  0,  86, 254],
        [  0,  87, 255],
        [  0,  87, 255]],

       [[  0,  73, 255],
        [  0,  73, 255],
        [  0,  73, 255],
        ...,
        [  0,  87, 255],
        [  0,  87, 255],
        [  0,  87, 255]],

       [[  0,  73, 255],
        [  0,  73, 255],
        [  1,  74, 255],
        ...,
        [  0,  87, 255],
        [  0,  87, 255],
        [  0,  87, 255]],

       ...,

       [[216, 207, 201],
        [197, 191, 185],
        [168, 164, 162],
        ...,
        [209, 218, 232],
        [212, 222, 232],
        [211, 223, 223]],

       [[137, 126, 124],
        [168, 164, 161],
        [110, 109, 107],
        ...,
        [210, 218, 233],
        [211, 218, 228],
        [214, 220, 217]],

       [[ 91,  80,  75],
        [ 75,  69,  63],
        [105, 102,  99],
        ...,
        [208, 217, 228],
        [209, 216, 223],
        [213, 221, 211]]], dtype=uint8)]"
Image_1177.jpg,423,148,238,189,1000,667,661,337,238,daskShared_local/images/Image_1177.jpg,1177,"[array([[[ 39, 178, 251],
        [ 36, 178, 251],
        [ 36, 178, 251],
        ...,
        [  1, 143, 225],
        [  1, 143, 223],
        [  0, 144, 223]],

       [[ 36, 177, 252],
        [ 36, 178, 252],
        [ 35, 177, 252],
        ...,
        [  1, 142, 222],
        [  1, 142, 223],
        [  1, 143, 223]],

       [[ 26, 173, 250],
        [ 31, 175, 251],
        [ 31, 175, 252],
        ...,
        [  1, 143, 222],
        [  1, 142, 224],
        [  0, 141, 222]],

       ...,

       [[213, 201, 156],
        [221, 209, 158],
        [212, 195, 128],
        ...,
        [  0,  61, 105],
        [  1,  60, 105],
        [  2,  61, 104]],

       [[185, 167, 117],
        [201, 184, 128],
        [212, 194, 130],
        ...,
        [  2,  60, 104],
        [  0,  61, 105],
        [  1,  61, 105]],

       [[189, 170, 121],
        [187, 170, 111],
        [210, 200, 142],
        ...,
        [  0,  62, 103],
        [  0,  62, 103],
        [  2,  61, 103]]], dtype=uint8)]"
Image_1178.jpg,428,132,724,631,1152,763,1152,763,724,daskShared_local/images/Image_1178.jpg,1178,"[array([[[  0, 179, 235],
        [  1, 180, 236],
        [  2, 181, 237],
        ...,
        [  0, 184, 238],
        [  0, 184, 238],
        [  0, 184, 238]],

       [[  0, 179, 235],
        [  1, 180, 236],
        [  2, 181, 237],
        ...,
        [  0, 183, 237],
        [  0, 184, 238],
        [  0, 184, 238]],

       [[  0, 179, 235],
        [  1, 180, 236],
        [  2, 181, 237],
        ...,
        [  0, 183, 237],
        [  0, 184, 238],
        [  0, 184, 238]],

       ...,

       [[155, 178, 153],
        [155, 179, 156],
        [156, 180, 158],
        ...,
        [140, 169, 134],
        [153, 172, 147],
        [188, 201, 186]],

       [[158, 181, 158],
        [158, 181, 158],
        [158, 181, 158],
        ...,
        [157, 183, 168],
        [170, 188, 169],
        [160, 193, 193]],

       [[159, 183, 161],
        [159, 183, 161],
        [159, 183, 158],
        ...,
        [153, 181, 172],
        [146, 184, 176],
        [116, 158, 148]]], dtype=uint8)]"
Image_1179.jpg,535,229,168,198,990,681,703,427,198,daskShared_local/images/Image_1179.jpg,1179,"[array([[[ 24,  22,   7],
        [ 21,  19,   4],
        [ 19,  17,   2],
        ...,
        [ 27,  12,   5],
        [ 30,  13,   3],
        [ 33,  15,   1]],

       [[ 26,  24,   9],
        [ 24,  22,   7],
        [ 22,  20,   5],
        ...,
        [ 26,  12,   3],
        [ 32,  14,   2],
        [ 37,  18,   3]],

       [[ 31,  29,  14],
        [ 29,  27,  12],
        [ 27,  25,  10],
        ...,
        [ 28,  11,   1],
        [ 33,  15,   1],
        [ 39,  20,   3]],

       ...,

       [[117, 110,  81],
        [133, 126,  97],
        [153, 147, 115],
        ...,
        [ 53,  58,  38],
        [ 50,  55,  35],
        [ 45,  50,  28]],

       [[110, 105,  76],
        [104,  99,  69],
        [120, 115,  83],
        ...,
        [ 51,  59,  38],
        [ 50,  58,  37],
        [ 49,  54,  32]],

       [[ 96,  91,  62],
        [ 77,  70,  41],
        [ 92,  86,  54],
        ...,
        [ 51,  59,  38],
        [ 53,  61,  40],
        [ 50,  58,  35]]], dtype=uint8)]"
Image_118.jpg,430,365,225,217,1024,683,655,582,225,daskShared_local/images/Image_118.jpg,118,"[array([[[ 38,  25,  24],
        [ 56,  48,  46],
        [142, 134, 131],
        ...,
        [162, 137, 121],
        [117,  91,  74],
        [ 91,  65,  48]],

       [[ 43,  36,  33],
        [ 73,  72,  70],
        [140, 138, 139],
        ...,
        [138, 116, 101],
        [ 95,  70,  54],
        [ 78,  55,  39]],

       [[ 57,  57,  52],
        [131, 133, 130],
        [141, 141, 140],
        ...,
        [ 88,  66,  52],
        [ 74,  53,  39],
        [ 74,  53,  40]],

       ...,

       [[241, 212, 175],
        [200, 165, 127],
        [193, 165, 117],
        ...,
        [242, 194, 152],
        [199, 150, 107],
        [242, 207, 160]],

       [[251, 224, 189],
        [232, 201, 173],
        [170, 147, 101],
        ...,
        [221, 168, 114],
        [233, 177, 124],
        [251, 214, 158]],

       [[209, 173, 132],
        [211, 172, 140],
        [181, 150, 104],
        ...,
        [190, 142,  93],
        [204, 145, 100],
        [210, 162, 116]]], dtype=uint8)]"
Image_1180.jpg,492,161,104,83,660,438,596,244,104,daskShared_local/images/Image_1180.jpg,1180,"[array([[[ 17,  45,  74],
        [ 17,  45,  74],
        [ 23,  47,  78],
        ...,
        [  7,  20,  57],
        [ 25,  39,  74],
        [ 26,  41,  76]],

       [[ 16,  44,  74],
        [ 17,  44,  74],
        [ 22,  47,  77],
        ...,
        [  7,  20,  57],
        [ 25,  39,  74],
        [ 26,  41,  76]],

       [[ 14,  37,  74],
        [ 14,  37,  74],
        [ 16,  39,  75],
        ...,
        [  8,  23,  59],
        [ 23,  39,  74],
        [ 24,  41,  75]],

       ...,

       [[ 91, 108, 126],
        [ 87, 103, 120],
        [ 46,  51,  62],
        ...,
        [ 51,  37,  54],
        [ 33,  22,  39],
        [ 32,  20,  38]],

       [[178, 190, 192],
        [174, 185, 188],
        [134, 137, 146],
        ...,
        [ 50,  36,  56],
        [ 35,  24,  45],
        [ 34,  23,  44]],

       [[187, 197, 199],
        [183, 193, 195],
        [142, 145, 154],
        ...,
        [ 50,  36,  56],
        [ 36,  24,  46],
        [ 34,  23,  45]]], dtype=uint8)]"
Image_1181.jpg,378,156,136,131,900,600,514,287,136,daskShared_local/images/Image_1181.jpg,1181,"[array([[[ 14, 119, 186],
        [ 13, 119, 185],
        [ 14, 119, 184],
        ...,
        [164, 158, 196],
        [197, 172, 203],
        [201, 176, 206]],

       [[ 42, 126, 186],
        [ 40, 126, 186],
        [ 39, 124, 185],
        ...,
        [147, 145, 180],
        [176, 157, 185],
        [181, 161, 187]],

       [[ 96, 138, 185],
        [ 93, 137, 186],
        [ 87, 134, 185],
        ...,
        [120, 125, 156],
        [140, 131, 155],
        [144, 135, 156]],

       ...,

       [[  1,  77, 165],
        [  1,  77, 165],
        [  0,  77, 165],
        ...,
        [132, 100, 119],
        [125,  93, 113],
        [120,  89, 109]],

       [[  1,  79, 168],
        [  1,  79, 167],
        [  0,  79, 166],
        ...,
        [129,  96, 114],
        [124,  91, 110],
        [120,  87, 107]],

       [[  1,  80, 169],
        [  1,  80, 168],
        [  0,  80, 166],
        ...,
        [127,  94, 111],
        [123,  90, 108],
        [120,  87, 106]]], dtype=uint8)]"
Image_1182.jpg,410,129,123,96,759,422,533,225,123,daskShared_local/images/Image_1182.jpg,1182,"[array([[[136, 206, 208],
        [135, 205, 206],
        [133, 203, 203],
        ...,
        [ 13, 137, 152],
        [  6, 130, 144],
        [  2, 127, 141]],

       [[147, 217, 218],
        [144, 214, 215],
        [137, 207, 207],
        ...,
        [  9, 134, 149],
        [  4, 129, 143],
        [  2, 127, 141]],

       [[170, 240, 242],
        [163, 233, 234],
        [145, 215, 215],
        ...,
        [  1, 128, 143],
        [  0, 128, 142],
        [  0, 128, 142]],

       ...,

       [[  0, 153, 187],
        [  0, 153, 187],
        [  1, 154, 188],
        ...,
        [  0, 132, 153],
        [  0, 132, 153],
        [  0, 132, 153]],

       [[  2, 153, 188],
        [  2, 153, 188],
        [  2, 153, 188],
        ...,
        [  0, 132, 153],
        [  0, 131, 152],
        [  0, 131, 152]],

       [[  2, 153, 188],
        [  3, 153, 188],
        [  3, 153, 188],
        ...,
        [  0, 131, 152],
        [  0, 131, 152],
        [  0, 131, 152]]], dtype=uint8)]"
Image_1183.jpg,479,159,234,272,981,650,713,431,272,daskShared_local/images/Image_1183.jpg,1183,"[array([[[244, 244, 244],
        [244, 244, 244],
        [244, 244, 244],
        ...,
        [243, 243, 243],
        [243, 243, 243],
        [243, 243, 243]],

       [[244, 244, 244],
        [244, 244, 244],
        [244, 244, 244],
        ...,
        [242, 242, 242],
        [242, 242, 242],
        [242, 242, 242]],

       [[244, 244, 244],
        [244, 244, 244],
        [244, 244, 244],
        ...,
        [242, 242, 242],
        [242, 242, 242],
        [242, 242, 242]],

       ...,

       [[ 27,  94, 173],
        [ 28,  95, 174],
        [ 27,  94, 173],
        ...,
        [ 22,  89, 168],
        [ 23,  90, 169],
        [ 24,  91, 170]],

       [[ 27,  94, 173],
        [ 29,  96, 175],
        [ 29,  96, 175],
        ...,
        [ 22,  89, 168],
        [ 23,  90, 169],
        [ 26,  93, 172]],

       [[ 26,  93, 172],
        [ 27,  94, 173],
        [ 27,  94, 173],
        ...,
        [ 23,  90, 169],
        [ 24,  91, 170],
        [ 26,  93, 172]]], dtype=uint8)]"
Image_1184.jpg,403,306,228,225,1500,1000,631,531,228,daskShared_local/images/Image_1184.jpg,1184,"[array([[[  2, 159, 178],
        [  2, 156, 177],
        [  3, 154, 175],
        ...,
        [  6, 132, 155],
        [  6, 134, 157],
        [  5, 136, 156]],

       [[  0, 154, 174],
        [  3, 154, 175],
        [  3, 153, 175],
        ...,
        [  2, 129, 151],
        [  3, 131, 153],
        [  4, 135, 155]],

       [[  0, 150, 171],
        [  0, 149, 170],
        [  1, 147, 170],
        ...,
        [  0, 126, 147],
        [  0, 126, 148],
        [  0, 129, 148]],

       ...,

       [[138, 173, 147],
        [139, 174, 147],
        [140, 174, 148],
        ...,
        [ 83,  66,   6],
        [ 88,  74,  13],
        [106,  93,  33]],

       [[150, 185, 161],
        [153, 190, 165],
        [147, 182, 159],
        ...,
        [139, 123,  62],
        [125, 110,  50],
        [145, 133,  73]],

       [[148, 185, 162],
        [149, 188, 166],
        [137, 175, 154],
        ...,
        [191, 176, 116],
        [182, 169, 109],
        [175, 163, 104]]], dtype=uint8)]"
Image_1185.jpg,1277,623,201,187,2304,1536,1478,810,201,daskShared_local/images/Image_1185.jpg,1185,"[array([[[  1, 110, 153],
        [  1, 110, 153],
        [  1, 110, 153],
        ...,
        [  2, 115, 147],
        [  2, 117, 148],
        [  1, 119, 149]],

       [[  0, 107, 151],
        [  0, 107, 151],
        [  0, 107, 151],
        ...,
        [  1, 111, 146],
        [  0, 113, 145],
        [  1, 114, 146]],

       [[  0, 106, 150],
        [  0, 106, 150],
        [  0, 106, 150],
        ...,
        [  0, 109, 144],
        [  0, 109, 144],
        [  0, 110, 145]],

       ...,

       [[ 77, 120, 137],
        [ 62, 108, 123],
        [ 67, 115, 129],
        ...,
        [ 21,  20,  38],
        [ 19,  18,  34],
        [ 20,  19,  35]],

       [[ 69, 111, 127],
        [ 59, 105, 120],
        [ 80, 129, 143],
        ...,
        [ 19,  18,  36],
        [ 20,  19,  35],
        [ 22,  21,  37]],

       [[ 69, 119, 118],
        [103, 154, 131],
        [140, 192, 154],
        ...,
        [ 20,  21,  39],
        [ 22,  23,  41],
        [ 23,  25,  40]]], dtype=uint8)]"
Image_1186.jpg,184,98,354,299,1024,670,538,397,354,daskShared_local/images/Image_1186.jpg,1186,"[array([[[ 25,  44,  51],
        [ 28,  45,  53],
        [ 28,  44,  55],
        ...,
        [ 52, 135, 138],
        [ 49, 134, 138],
        [ 41, 124, 129]],

       [[ 27,  47,  50],
        [ 29,  46,  51],
        [ 14,  29,  36],
        ...,
        [ 49, 126, 123],
        [ 35, 113, 110],
        [ 54, 133, 130]],

       [[ 34,  52,  56],
        [ 33,  48,  53],
        [ 14,  24,  33],
        ...,
        [ 49, 106, 104],
        [ 41, 102, 100],
        [ 43, 108, 102]],

       ...,

       [[ 64, 182, 207],
        [ 54, 193, 213],
        [ 46, 175, 196],
        ...,
        [ 83, 193, 200],
        [ 38, 161, 173],
        [ 43, 155, 176]],

       [[ 70, 198, 216],
        [ 62, 201, 214],
        [ 45, 169, 181],
        ...,
        [ 60, 178, 186],
        [ 45, 168, 182],
        [ 48, 154, 179]],

       [[ 49, 188, 197],
        [ 45, 188, 188],
        [ 49, 175, 172],
        ...,
        [ 34, 156, 166],
        [ 48, 167, 183],
        [ 53, 150, 175]]], dtype=uint8)]"
Image_1187.jpg,243,214,139,146,775,518,382,360,146,daskShared_local/images/Image_1187.jpg,1187,"[array([[[ 53,  61,  37],
        [ 55,  63,  39],
        [ 58,  65,  42],
        ...,
        [147, 117,  93],
        [161, 130, 102],
        [164, 134, 106]],

       [[ 53,  62,  39],
        [ 51,  59,  37],
        [ 50,  57,  36],
        ...,
        [126,  95,  70],
        [135, 105,  76],
        [145, 115,  86]],

       [[ 55,  64,  44],
        [ 51,  59,  40],
        [ 48,  54,  36],
        ...,
        [122,  91,  65],
        [123,  92,  62],
        [129,  98,  69]],

       ...,

       [[144, 104,  52],
        [142, 102,  50],
        [155, 117,  64],
        ...,
        [213, 173, 136],
        [211, 173, 137],
        [208, 170, 133]],

       [[145, 105,  53],
        [152, 112,  60],
        [162, 123,  71],
        ...,
        [207, 167, 130],
        [208, 169, 133],
        [210, 171, 135]],

       [[142, 102,  50],
        [157, 117,  65],
        [163, 124,  72],
        ...,
        [205, 164, 128],
        [203, 163, 128],
        [209, 169, 134]]], dtype=uint8)]"
Image_1188.jpg,308,302,153,137,966,642,461,439,153,daskShared_local/images/Image_1188.jpg,1188,"[array([[[ 16,  96,  85],
        [ 15,  93,  80],
        [ 14,  90,  74],
        ...,
        [ 18,   1,   4],
        [ 17,   2,   5],
        [ 15,   0,   1]],

       [[ 10, 121, 111],
        [  7, 117, 105],
        [  6, 114,  99],
        ...,
        [ 21,   3,   5],
        [ 20,   3,   6],
        [ 17,   1,   2]],

       [[ 14, 165, 163],
        [ 12, 161, 158],
        [ 12, 159, 155],
        ...,
        [ 29,   4,   5],
        [ 30,   6,   8],
        [ 28,   3,   5]],

       ...,

       [[ 16, 193, 205],
        [ 17, 194, 205],
        [ 17, 196, 204],
        ...,
        [ 67, 232, 244],
        [ 66, 234, 247],
        [ 66, 235, 248]],

       [[ 17, 192, 205],
        [ 18, 193, 205],
        [ 18, 195, 204],
        ...,
        [ 73, 234, 249],
        [ 74, 237, 252],
        [ 73, 237, 253]],

       [[ 19, 192, 206],
        [ 19, 193, 205],
        [ 20, 196, 205],
        ...,
        [ 74, 236, 251],
        [ 76, 238, 254],
        [ 75, 238, 255]]], dtype=uint8)]"
Image_1189.jpg,730,335,181,134,1600,1000,911,469,181,daskShared_local/images/Image_1189.jpg,1189,"[array([[[  0,  83, 169],
        [  0,  83, 169],
        [  0,  83, 169],
        ...,
        [  0,  81, 167],
        [  0,  81, 167],
        [  0,  81, 167]],

       [[  0,  83, 169],
        [  0,  83, 169],
        [  0,  83, 169],
        ...,
        [  0,  81, 167],
        [  0,  81, 167],
        [  0,  81, 167]],

       [[  0,  83, 169],
        [  0,  83, 169],
        [  0,  83, 169],
        ...,
        [  0,  81, 167],
        [  0,  81, 167],
        [  0,  81, 167]],

       ...,

       [[  1,  65, 137],
        [  1,  65, 137],
        [  1,  65, 137],
        ...,
        [239, 228, 218],
        [230, 227, 210],
        [199, 202, 175]],

       [[  1,  65, 137],
        [  1,  65, 137],
        [  1,  65, 137],
        ...,
        [238, 226, 222],
        [244, 240, 230],
        [235, 237, 218]],

       [[  1,  65, 137],
        [  1,  65, 137],
        [  1,  65, 137],
        ...,
        [234, 221, 220],
        [232, 225, 221],
        [232, 232, 220]]], dtype=uint8)]"
Image_119.jpg,542,98,293,299,1024,770,835,397,299,daskShared_local/images/Image_119.jpg,119,"[array([[[  0, 111, 183],
        [  2, 113, 185],
        [  1, 111, 183],
        ...,
        [ 43,  58,  65],
        [ 60,  77,  84],
        [ 36,  56,  63]],

       [[  1, 112, 184],
        [  0, 111, 183],
        [  0, 110, 182],
        ...,
        [ 57,  71,  80],
        [ 55,  72,  80],
        [ 40,  59,  66]],

       [[  3, 111, 184],
        [  2, 110, 183],
        [  1, 109, 182],
        ...,
        [ 59,  73,  82],
        [ 56,  72,  80],
        [ 67,  85,  93]],

       ...,

       [[ 55,  56,  50],
        [ 69,  71,  59],
        [ 89,  92,  68],
        ...,
        [ 40,  36,  37],
        [ 40,  36,  35],
        [ 39,  34,  34]],

       [[ 51,  51,  46],
        [ 47,  48,  37],
        [ 83,  87,  62],
        ...,
        [ 40,  37,  38],
        [ 39,  36,  34],
        [ 37,  34,  32]],

       [[ 42,  42,  34],
        [ 45,  46,  34],
        [ 75,  77,  53],
        ...,
        [ 38,  36,  37],
        [ 37,  36,  34],
        [ 41,  41,  39]]], dtype=uint8)]"
Image_1190.jpg,408,323,133,131,800,600,541,454,133,daskShared_local/images/Image_1190.jpg,1190,"[array([[[195, 167, 127],
        [199, 173, 133],
        [206, 186, 147],
        ...,
        [  5,  92, 102],
        [  5,  92, 102],
        [  6,  93, 103]],

       [[208, 183, 142],
        [212, 189, 148],
        [219, 200, 160],
        ...,
        [  5,  92, 102],
        [  5,  92, 102],
        [  6,  93, 103]],

       [[227, 205, 163],
        [233, 211, 170],
        [239, 219, 179],
        ...,
        [  5,  91, 101],
        [  5,  92, 102],
        [  6,  92, 102]],

       ...,

       [[ 32,  52,  51],
        [ 32,  52,  51],
        [ 32,  52,  51],
        ...,
        [ 37, 107,  60],
        [ 41, 113,  64],
        [ 45, 118,  68]],

       [[ 29,  50,  49],
        [ 29,  51,  49],
        [ 29,  51,  49],
        ...,
        [ 38, 116,  60],
        [ 42, 122,  62],
        [ 46, 126,  67]],

       [[ 28,  50,  48],
        [ 27,  50,  48],
        [ 27,  51,  49],
        ...,
        [ 37, 119,  61],
        [ 40, 124,  62],
        [ 44, 128,  66]]], dtype=uint8)]"
Image_1191.jpg,684,294,516,516,1920,1080,1200,810,516,daskShared_local/images/Image_1191.jpg,1191,"[array([[[ 43, 106, 145],
        [ 49, 100, 127],
        [ 10,  42,  58],
        ...,
        [ 35,  62,  63],
        [ 35,  69,  67],
        [ 43,  81,  77]],

       [[ 45, 104, 142],
        [ 58, 109, 141],
        [ 22,  56,  77],
        ...,
        [ 34,  68,  67],
        [ 34,  77,  72],
        [ 25,  68,  63]],

       [[ 47, 100, 129],
        [ 55, 104, 130],
        [ 46,  82,  98],
        ...,
        [ 30,  77,  72],
        [ 33,  89,  82],
        [130, 188, 182]],

       ...,

       [[ 28,  94, 144],
        [ 28,  94, 143],
        [ 29,  95, 145],
        ...,
        [ 24,  43,  42],
        [ 26,  45,  42],
        [ 24,  44,  39]],

       [[ 29,  95, 145],
        [ 27,  93, 143],
        [ 29,  95, 145],
        ...,
        [ 24,  43,  42],
        [ 27,  44,  42],
        [ 24,  42,  39]],

       [[ 29,  95, 145],
        [ 29,  95, 145],
        [ 29,  95, 146],
        ...,
        [ 21,  42,  40],
        [ 26,  44,  42],
        [ 25,  44,  42]]], dtype=uint8)]"
Image_1192.jpg,162,175,176,140,728,500,338,315,176,daskShared_local/images/Image_1192.jpg,1192,"[array([[[  2,  72, 222],
        [  1,  71, 219],
        [  1,  71, 219],
        ...,
        [  3,  79, 227],
        [  2,  78, 226],
        [  0,  78, 226]],

       [[  1,  71, 221],
        [  1,  71, 219],
        [  2,  72, 219],
        ...,
        [  2,  78, 228],
        [  1,  79, 227],
        [  0,  78, 226]],

       [[  0,  71, 221],
        [  1,  72, 220],
        [  1,  72, 219],
        ...,
        [  1,  77, 227],
        [  0,  78, 226],
        [  0,  78, 226]],

       ...,

       [[ 24, 137, 153],
        [ 23, 141, 148],
        [ 16, 133, 143],
        ...,
        [248, 251, 233],
        [249, 250, 233],
        [251, 253, 231]],

       [[ 19, 129, 141],
        [ 19, 131, 139],
        [ 18, 132, 141],
        ...,
        [248, 249, 231],
        [249, 249, 230],
        [250, 251, 234]],

       [[ 22, 124, 138],
        [ 23, 126, 138],
        [ 26, 132, 142],
        ...,
        [248, 250, 230],
        [246, 250, 228],
        [243, 245, 230]]], dtype=uint8)]"
Image_1193.jpg,801,330,163,130,1536,1024,964,460,163,daskShared_local/images/Image_1193.jpg,1193,"[array([[[  3,  37,  77],
        [  1,  57, 108],
        [  7,  87, 155],
        ...,
        [ 48, 125, 213],
        [ 47, 124, 212],
        [ 47, 124, 212]],

       [[  1,  47,  94],
        [  2,  69, 130],
        [ 12,  99, 175],
        ...,
        [ 48, 125, 213],
        [ 47, 124, 212],
        [ 47, 124, 212]],

       [[  1,  66, 119],
        [  8,  87, 157],
        [ 22, 111, 194],
        ...,
        [ 48, 125, 213],
        [ 47, 124, 212],
        [ 47, 124, 212]],

       ...,

       [[ 17, 115, 202],
        [ 18, 115, 202],
        [ 18, 115, 202],
        ...,
        [ 10, 113, 205],
        [ 13, 114, 206],
        [ 15, 113, 205]],

       [[ 17, 115, 202],
        [ 19, 115, 202],
        [ 18, 116, 203],
        ...,
        [ 11, 115, 206],
        [ 14, 115, 206],
        [ 16, 114, 205]],

       [[ 18, 116, 203],
        [ 20, 117, 204],
        [ 20, 117, 204],
        ...,
        [ 12, 115, 206],
        [ 14, 115, 206],
        [ 15, 114, 205]]], dtype=uint8)]"
Image_1194.jpg,1785,2554,504,446,2720,4080,2289,3000,504,daskShared_local/images/Image_1194.jpg,1194,"[array([[[ 95,  81,  65],
        [ 86,  74,  60],
        [ 77,  66,  51],
        ...,
        [  5, 120, 193],
        [  3, 118, 191],
        [  3, 118, 191]],

       [[143, 120, 102],
        [113,  97,  76],
        [ 77,  66,  48],
        ...,
        [  4, 119, 194],
        [  4, 123, 196],
        [  2, 121, 193]],

       [[207, 186, 160],
        [186, 173, 154],
        [110, 104,  95],
        ...,
        [  3, 119, 194],
        [  2, 121, 195],
        [  1, 120, 194]],

       ...,

       [[  8, 116, 190],
        [  8, 120, 194],
        [  6, 117, 191],
        ...,
        [  6, 118, 194],
        [  1, 112, 188],
        [  6, 114, 190]],

       [[  2, 113, 187],
        [  5, 117, 191],
        [  4, 114, 188],
        ...,
        [  5, 116, 190],
        [  7, 118, 192],
        [  2, 109, 184]],

       [[  4, 116, 190],
        [  3, 115, 189],
        [  6, 118, 192],
        ...,
        [  3, 114, 188],
        [  3, 114, 188],
        [  4, 115, 190]]], dtype=uint8)]"
Image_1195.jpg,74,84,112,128,637,450,186,212,128,daskShared_local/images/Image_1195.jpg,1195,"[array([[[  2, 173, 253],
        [  2, 173, 253],
        [  2, 173, 253],
        ...,
        [  2, 178, 254],
        [  2, 178, 254],
        [  2, 178, 254]],

       [[  2, 173, 253],
        [  2, 173, 253],
        [  2, 173, 253],
        ...,
        [  2, 178, 254],
        [  2, 178, 254],
        [  2, 177, 254]],

       [[  1, 172, 252],
        [  1, 172, 252],
        [  1, 172, 252],
        ...,
        [  2, 178, 254],
        [  1, 177, 255],
        [  1, 176, 255]],

       ...,

       [[  2, 131, 236],
        [  2, 131, 236],
        [  3, 131, 238],
        ...,
        [136, 157, 137],
        [125, 148, 127],
        [118, 143, 120]],

       [[  2, 131, 236],
        [  2, 131, 236],
        [  3, 131, 238],
        ...,
        [136, 153, 139],
        [124, 144, 128],
        [117, 138, 122]],

       [[  2, 131, 236],
        [  2, 131, 236],
        [  3, 131, 238],
        ...,
        [136, 151, 140],
        [124, 142, 130],
        [117, 136, 123]]], dtype=uint8)]"
Image_1196.jpg,278,127,109,111,775,518,387,238,111,daskShared_local/images/Image_1196.jpg,1196,"[array([[[ 87, 160, 178],
        [ 86, 160, 179],
        [ 86, 160, 179],
        ...,
        [ 74, 142, 157],
        [ 82, 150, 165],
        [ 83, 151, 167]],

       [[ 86, 160, 179],
        [ 86, 160, 179],
        [ 86, 160, 179],
        ...,
        [ 76, 144, 159],
        [ 84, 152, 167],
        [ 86, 153, 169]],

       [[ 83, 159, 179],
        [ 83, 159, 179],
        [ 83, 160, 180],
        ...,
        [ 87, 153, 169],
        [ 95, 161, 178],
        [ 97, 162, 180]],

       ...,

       [[168, 149, 142],
        [162, 142, 135],
        [131, 112, 104],
        ...,
        [ 42,  27,  24],
        [ 53,  38,  35],
        [ 55,  40,  37]],

       [[186, 166, 157],
        [179, 159, 149],
        [144, 125, 115],
        ...,
        [ 51,  34,  33],
        [ 65,  48,  47],
        [ 68,  51,  50]],

       [[190, 170, 160],
        [182, 162, 152],
        [147, 127, 117],
        ...,
        [ 53,  35,  35],
        [ 67,  50,  49],
        [ 71,  53,  53]]], dtype=uint8)]"
Image_1197.jpg,618,314,155,143,1440,960,773,457,155,daskShared_local/images/Image_1197.jpg,1197,"[array([[[  0, 144, 205],
        [  0, 143, 204],
        [  0, 143, 204],
        ...,
        [  0, 143, 213],
        [  0, 143, 213],
        [  0, 142, 212]],

       [[  0, 144, 205],
        [  0, 143, 204],
        [  0, 143, 204],
        ...,
        [  0, 143, 213],
        [  0, 143, 213],
        [  0, 143, 213]],

       [[  0, 144, 204],
        [  0, 144, 204],
        [  0, 143, 204],
        ...,
        [  1, 144, 214],
        [  1, 144, 214],
        [  1, 144, 214]],

       ...,

       [[ 61,  88,  83],
        [ 63,  87,  83],
        [ 62,  83,  79],
        ...,
        [  0,  72, 109],
        [  0,  71, 108],
        [  0,  73, 110]],

       [[ 52,  81,  76],
        [ 59,  85,  81],
        [ 64,  88,  83],
        ...,
        [  0,  71, 108],
        [  0,  72, 109],
        [  0,  73, 110]],

       [[ 47,  77,  71],
        [ 50,  78,  73],
        [ 51,  76,  71],
        ...,
        [  0,  72, 109],
        [  0,  73, 110],
        [  1,  74, 111]]], dtype=uint8)]"
Image_1198.jpg,447,146,146,114,1024,512,593,260,146,daskShared_local/images/Image_1198.jpg,1198,"[array([[[  0, 134, 188],
        [  0, 133, 189],
        [  0, 132, 189],
        ...,
        [  0, 172, 214],
        [  0, 171, 214],
        [  0, 170, 213]],

       [[  0, 133, 188],
        [  0, 133, 189],
        [  0, 132, 189],
        ...,
        [  0, 172, 214],
        [  0, 171, 213],
        [  0, 170, 214]],

       [[  0, 133, 188],
        [  0, 132, 189],
        [  0, 132, 189],
        ...,
        [  0, 171, 213],
        [  0, 171, 213],
        [  0, 171, 214]],

       ...,

       [[118, 107,  84],
        [138, 117,  81],
        [146, 118,  72],
        ...,
        [  0, 143, 196],
        [  0, 143, 197],
        [  1, 142, 198]],

       [[101,  92,  66],
        [117,  99,  64],
        [136, 112,  70],
        ...,
        [  0, 143, 196],
        [  0, 143, 197],
        [  1, 142, 198]],

       [[ 85,  77,  50],
        [103,  87,  53],
        [135, 112,  73],
        ...,
        [  0, 143, 196],
        [  0, 143, 197],
        [  1, 142, 198]]], dtype=uint8)]"
Image_1199.jpg,104,76,93,67,475,264,197,143,93,daskShared_local/images/Image_1199.jpg,1199,"[array([[[ 27,  46,  65],
        [ 27,  46,  65],
        [ 27,  45,  64],
        ...,
        [ 24,  51,  78],
        [ 21,  50,  77],
        [ 22,  50,  77]],

       [[ 27,  46,  65],
        [ 27,  47,  65],
        [ 27,  46,  64],
        ...,
        [ 24,  52,  78],
        [ 21,  50,  77],
        [ 22,  50,  77]],

       [[ 27,  45,  67],
        [ 27,  45,  67],
        [ 27,  44,  67],
        ...,
        [ 23,  49,  74],
        [ 21,  48,  74],
        [ 22,  48,  74]],

       ...,

       [[ 12,  21,  30],
        [ 12,  21,  30],
        [ 13,  22,  31],
        ...,
        [ 77, 107, 113],
        [ 63,  91,  99],
        [ 65,  93, 101]],

       [[ 15,  24,  33],
        [ 15,  24,  33],
        [ 15,  24,  33],
        ...,
        [ 74, 108, 117],
        [ 63,  95, 104],
        [ 65,  96, 106]],

       [[ 15,  24,  33],
        [ 15,  24,  33],
        [ 15,  24,  33],
        ...,
        [ 75, 108, 116],
        [ 63,  94, 104],
        [ 65,  96, 105]]], dtype=uint8)]"
Image_12.jpeg,641,149,253,236,1200,800,894,385,253,daskShared_local/images/Image_12.jpeg,12,"[array([[[174, 215, 231],
        [173, 215, 230],
        [169, 210, 224],
        ...,
        [180, 213, 230],
        [180, 213, 230],
        [181, 214, 231]],

       [[177, 216, 233],
        [177, 216, 231],
        [175, 214, 229],
        ...,
        [180, 213, 230],
        [179, 212, 229],
        [180, 213, 230]],

       [[177, 216, 226],
        [180, 217, 228],
        [181, 219, 229],
        ...,
        [181, 214, 232],
        [178, 215, 232],
        [175, 214, 230]],

       ...,

       [[195, 147,  52],
        [180, 132,  37],
        [182, 135,  42],
        ...,
        [170, 150, 123],
        [188, 164, 142],
        [205, 174, 155]],

       [[151, 103,  24],
        [138,  91,  17],
        [150, 103,  26],
        ...,
        [176, 159, 117],
        [190, 170, 134],
        [197, 172, 142]],

       [[150, 102,  36],
        [129,  81,  20],
        [128,  80,  21],
        ...,
        [173, 158, 104],
        [185, 168, 121],
        [203, 181, 140]]], dtype=uint8)]"
Image_120.jpg,2271,276,576,501,3033,1757,2847,777,576,daskShared_local/images/Image_120.jpg,120,"[array([[[  0,  53, 217],
        [  0,  53, 217],
        [  0,  53, 217],
        ...,
        [  0,  53, 217],
        [  0,  53, 217],
        [  0,  53, 217]],

       [[  0,  53, 217],
        [  0,  53, 217],
        [  0,  53, 217],
        ...,
        [  0,  53, 217],
        [  0,  53, 217],
        [  0,  53, 217]],

       [[  0,  53, 217],
        [  0,  53, 217],
        [  0,  53, 217],
        ...,
        [  0,  53, 217],
        [  0,  53, 217],
        [  0,  53, 217]],

       ...,

       [[ 76,  86,  57],
        [ 63,  73,  46],
        [ 54,  64,  39],
        ...,
        [  0,  53, 217],
        [  0,  53, 217],
        [  0,  53, 217]],

       [[ 75,  85,  59],
        [ 69,  79,  54],
        [ 62,  71,  49],
        ...,
        [  0,  53, 217],
        [  0,  53, 217],
        [  0,  53, 217]],

       [[ 80,  90,  65],
        [ 77,  86,  64],
        [ 64,  73,  54],
        ...,
        [  0,  53, 217],
        [  0,  53, 217],
        [  0,  53, 217]]], dtype=uint8)]"
Image_1200.jpg,571,167,189,189,1000,665,760,356,189,daskShared_local/images/Image_1200.jpg,1200,"[array([[[ 38, 132, 202],
        [ 35, 133, 200],
        [ 34, 131, 199],
        ...,
        [ 19, 129, 195],
        [ 31, 130, 197],
        [ 40, 134, 196]],

       [[ 42, 134, 201],
        [ 46, 134, 201],
        [ 44, 134, 200],
        ...,
        [ 30, 131, 196],
        [ 26, 132, 197],
        [ 42, 135, 198]],

       [[ 41, 134, 201],
        [ 46, 133, 200],
        [ 44, 135, 200],
        ...,
        [ 26, 130, 196],
        [ 28, 131, 197],
        [ 24, 130, 195]],

       ...,

       [[  7,  77,  85],
        [  5,  78,  89],
        [ 14,  82,  94],
        ...,
        [  5,  75,  81],
        [  7,  76,  83],
        [  2,  77,  83]],

       [[ 19,  88,  99],
        [ 24,  92, 108],
        [  8,  84,  99],
        ...,
        [ 11,  76,  80],
        [  9,  74,  81],
        [  5,  79,  85]],

       [[ 50, 117, 136],
        [ 30, 109, 132],
        [ 19, 106, 129],
        ...,
        [ 35,  97, 110],
        [ 25,  88,  97],
        [ 26,  90,  99]]], dtype=uint8)]"
Image_1201.jpg,784,565,1227,1434,3072,2304,2011,1999,1434,daskShared_local/images/Image_1201.jpg,1201,"[array([[[ 76,  66,  65],
        [ 77,  67,  68],
        [ 78,  68,  70],
        ...,
        [154, 119, 129],
        [116,  80,  90],
        [ 85,  55,  62]],

       [[ 79,  71,  69],
        [ 78,  68,  70],
        [ 72,  65,  66],
        ...,
        [137, 108, 117],
        [109,  80,  88],
        [ 92,  63,  71]],

       [[ 81,  76,  72],
        [ 77,  71,  70],
        [ 68,  65,  64],
        ...,
        [134, 109, 114],
        [114,  90,  96],
        [ 94,  70,  76]],

       ...,

       [[  6, 113, 120],
        [  7, 114, 124],
        [  7, 114, 124],
        ...,
        [ 15,  97, 116],
        [ 14,  98, 116],
        [ 11,  98, 113]],

       [[  7, 114, 120],
        [  8, 115, 124],
        [  8, 115, 125],
        ...,
        [ 18,  97, 118],
        [ 17,  98, 118],
        [ 12,  99, 114]],

       [[  7, 114, 120],
        [  7, 114, 124],
        [  8, 115, 125],
        ...,
        [ 13,  98, 115],
        [ 15,  99, 114],
        [ 13,  99, 112]]], dtype=uint8)]"
Image_1202.jpg,196,343,282,203,1024,768,478,546,282,daskShared_local/images/Image_1202.jpg,1202,"[array([[[ 93, 145, 166],
        [ 80, 131, 155],
        [ 54, 108, 135],
        ...,
        [ 16,  18,  43],
        [ 25,  27,  52],
        [ 21,  22,  47]],

       [[ 95, 144, 160],
        [ 98, 148, 166],
        [107, 157, 178],
        ...,
        [ 23,  23,  49],
        [ 24,  24,  50],
        [ 19,  19,  46]],

       [[ 46,  91,  98],
        [ 76, 120, 132],
        [105, 150, 165],
        ...,
        [ 24,  21,  50],
        [ 23,  20,  49],
        [ 21,  18,  47]],

       ...,

       [[118, 170, 173],
        [158, 213, 212],
        [144, 201, 192],
        ...,
        [ 21,   7,   7],
        [ 20,   6,   6],
        [ 19,   5,   5]],

       [[148, 205, 197],
        [163, 220, 209],
        [146, 202, 183],
        ...,
        [ 18,   4,   4],
        [ 20,   6,   6],
        [ 20,   6,   6]],

       [[135, 194, 182],
        [134, 190, 174],
        [104, 158, 137],
        ...,
        [ 17,   3,   3],
        [ 18,   4,   4],
        [ 20,   6,   6]]], dtype=uint8)]"
Image_1203.jpg,490,139,223,164,800,600,713,303,223,daskShared_local/images/Image_1203.jpg,1203,"[array([[[  2,  36,  63],
        [  5,  36,  64],
        [  2,  31,  59],
        ...,
        [  8,   7,  14],
        [  8,   6,  12],
        [ 10,   8,   9]],

       [[  3,  37,  66],
        [  3,  36,  66],
        [  4,  33,  64],
        ...,
        [ 11,  11,  19],
        [ 11,   9,  16],
        [  6,   9,  15]],

       [[  1,  33,  68],
        [  3,  35,  75],
        [  2,  32,  69],
        ...,
        [  9,   9,  17],
        [ 10,   9,  17],
        [  8,  11,  15]],

       ...,

       [[207, 180, 133],
        [199, 174, 124],
        [199, 172, 117],
        ...,
        [ 27,  12,  11],
        [ 29,  14,  14],
        [ 14,   7,   8]],

       [[203, 176, 137],
        [201, 176, 136],
        [197, 171, 126],
        ...,
        [ 26,  11,  10],
        [ 27,  12,  12],
        [ 18,   9,  10]],

       [[201, 171, 143],
        [194, 169, 140],
        [195, 170, 137],
        ...,
        [ 29,  20,  17],
        [ 30,  19,  17],
        [ 20,  14,  11]]], dtype=uint8)]"
Image_1204.jpg,102,108,400,290,800,533,502,398,400,daskShared_local/images/Image_1204.jpg,1204,"[array([[[  2,  10,  57],
        [  3,  11,  57],
        [  4,  11,  57],
        ...,
        [  7,  19,  72],
        [  6,  19,  72],
        [  6,  19,  71]],

       [[  3,  11,  55],
        [  3,  11,  54],
        [  4,   9,  56],
        ...,
        [ 10,  21,  74],
        [  8,  20,  73],
        [  6,  18,  71]],

       [[  4,  11,  55],
        [  6,  11,  56],
        [  5,  10,  56],
        ...,
        [ 10,  22,  75],
        [  7,  21,  73],
        [  8,  20,  74]],

       ...,

       [[  4,  13,  59],
        [  6,  15,  60],
        [  7,  15,  59],
        ...,
        [ 52,  43,   4],
        [ 71,  56,  15],
        [ 81,  70,  26]],

       [[  7,  14,  60],
        [  7,  15,  61],
        [ 10,  18,  62],
        ...,
        [ 73,  63,  27],
        [100,  80,  43],
        [113,  95,  54]],

       [[  7,  14,  60],
        [  7,  15,  59],
        [  8,  15,  59],
        ...,
        [105, 101,  71],
        [111,  99,  69],
        [115, 101,  67]]], dtype=uint8)]"
Image_1205.jpg,116,379,342,297,1715,1286,458,676,342,daskShared_local/images/Image_1205.jpg,1205,"[array([[[144, 154, 151],
        [147, 159, 155],
        [152, 165, 161],
        ...,
        [ 58,  49,  59],
        [ 56,  48,  58],
        [ 59,  51,  59]],

       [[144, 154, 153],
        [148, 160, 155],
        [150, 164, 160],
        ...,
        [ 57,  48,  62],
        [ 61,  51,  59],
        [ 59,  54,  60]],

       [[146, 156, 152],
        [148, 160, 156],
        [152, 164, 160],
        ...,
        [ 59,  47,  56],
        [ 56,  49,  56],
        [ 59,  55,  60]],

       ...,

       [[166, 175, 142],
        [169, 177, 144],
        [167, 168, 140],
        ...,
        [179, 187, 194],
        [188, 181, 205],
        [194, 182, 218]],

       [[177, 182, 156],
        [184, 180, 148],
        [169, 169, 134],
        ...,
        [174, 187, 190],
        [177, 188, 195],
        [185, 194, 201]],

       [[180, 190, 165],
        [181, 185, 156],
        [177, 178, 140],
        ...,
        [172, 184, 185],
        [177, 188, 187],
        [181, 192, 191]]], dtype=uint8)]"
Image_1206.jpg,317,282,134,119,1280,720,451,401,134,daskShared_local/images/Image_1206.jpg,1206,"[array([[[  0,  60, 133],
        [  0,  60, 133],
        [  0,  60, 133],
        ...,
        [  0,  61, 136],
        [  0,  61, 136],
        [  0,  61, 136]],

       [[  1,  61, 134],
        [  1,  61, 134],
        [  1,  61, 134],
        ...,
        [  0,  62, 137],
        [  0,  62, 137],
        [  0,  62, 137]],

       [[  1,  61, 134],
        [  1,  61, 134],
        [  1,  61, 134],
        ...,
        [  0,  62, 137],
        [  0,  62, 137],
        [  0,  62, 137]],

       ...,

       [[ 31, 105, 134],
        [ 31, 105, 134],
        [ 31, 105, 134],
        ...,
        [ 21,  95, 130],
        [ 21,  95, 130],
        [ 21,  95, 130]],

       [[ 32, 106, 134],
        [ 32, 106, 134],
        [ 31, 105, 134],
        ...,
        [ 21,  95, 130],
        [ 21,  95, 130],
        [ 21,  95, 130]],

       [[ 32, 106, 133],
        [ 32, 106, 133],
        [ 32, 106, 133],
        ...,
        [ 21,  95, 130],
        [ 21,  95, 130],
        [ 21,  95, 130]]], dtype=uint8)]"
Image_1207.jpg,349,16,613,516,1190,595,962,532,613,daskShared_local/images/Image_1207.jpg,1207,"[array([[[215, 233, 241],
        [215, 231, 240],
        [215, 231, 241],
        ...,
        [204, 215, 206],
        [203, 216, 206],
        [202, 215, 205]],

       [[204, 222, 234],
        [208, 225, 235],
        [207, 224, 234],
        ...,
        [205, 217, 207],
        [204, 216, 206],
        [202, 217, 207]],

       [[203, 220, 232],
        [205, 223, 233],
        [208, 225, 235],
        ...,
        [205, 217, 207],
        [205, 217, 207],
        [205, 216, 207]],

       ...,

       [[ 40,  29,  37],
        [ 50,  33,  37],
        [ 53,  39,  41],
        ...,
        [169, 106,  87],
        [174, 115, 101],
        [182, 130, 115]],

       [[ 48,  30,  31],
        [ 50,  31,  31],
        [ 51,  37,  36],
        ...,
        [169, 106,  86],
        [172, 120, 102],
        [176, 129, 117]],

       [[ 53,  33,  33],
        [ 49,  32,  32],
        [ 48,  35,  34],
        ...,
        [168, 101,  88],
        [168, 111,  96],
        [167, 111, 102]]], dtype=uint8)]"
Image_1208.jpg,1615,515,817,513,4100,2660,2432,1028,817,daskShared_local/images/Image_1208.jpg,1208,"[array([[[181, 168, 158],
        [181, 172, 162],
        [180, 170, 160],
        ...,
        [143, 134, 119],
        [142, 134, 122],
        [137, 129, 118]],

       [[180, 169, 158],
        [175, 165, 155],
        [180, 169, 159],
        ...,
        [134, 125, 110],
        [134, 125, 111],
        [136, 127, 113]],

       [[180, 169, 159],
        [184, 174, 164],
        [184, 171, 162],
        ...,
        [137, 128, 116],
        [135, 126, 112],
        [134, 125, 111]],

       ...,

       [[137, 141, 147],
        [135, 141, 141],
        [130, 134, 140],
        ...,
        [232, 238, 247],
        [228, 236, 248],
        [222, 229, 248]],

       [[129, 134, 138],
        [126, 132, 131],
        [127, 127, 133],
        ...,
        [227, 231, 246],
        [226, 228, 245],
        [215, 217, 234]],

       [[119, 121, 123],
        [115, 117, 119],
        [122, 119, 121],
        ...,
        [218, 222, 243],
        [223, 223, 242],
        [219, 220, 230]]], dtype=uint8)]"
Image_1209.jpg,350,131,182,196,770,422,532,327,196,daskShared_local/images/Image_1209.jpg,1209,"[array([[[ 76,  76,  88],
        [ 76,  74,  85],
        [ 88,  83,  87],
        ...,
        [ 25, 100, 193],
        [ 22,  97, 188],
        [ 20,  93, 185]],

       [[ 67,  74,  82],
        [ 72,  79,  85],
        [ 83,  84,  88],
        ...,
        [ 27, 102, 195],
        [ 24,  97, 191],
        [ 20,  93, 185]],

       [[ 68,  82,  85],
        [ 76,  87,  91],
        [ 80,  88,  90],
        ...,
        [ 28, 101, 195],
        [ 25,  98, 192],
        [ 22,  95, 189]],

       ...,

       [[ 17,  25,  14],
        [ 48,  60,  46],
        [ 61,  75,  60],
        ...,
        [  3,  21,  43],
        [  3,  21,  41],
        [  2,  21,  38]],

       [[  5,  10,   6],
        [ 22,  32,  23],
        [ 46,  58,  46],
        ...,
        [  3,  21,  43],
        [  2,  20,  40],
        [  1,  20,  37]],

       [[  0,   3,   2],
        [  5,  12,   5],
        [ 24,  34,  25],
        ...,
        [  0,  21,  40],
        [  2,  20,  40],
        [  1,  20,  37]]], dtype=uint8)]"
Image_121.jpg,519,375,179,162,1024,678,698,537,179,daskShared_local/images/Image_121.jpg,121,"[array([[[ 98,  78,  62],
        [107,  83,  71],
        [112,  86,  78],
        ...,
        [158, 126, 111],
        [132, 105, 109],
        [ 90,  63,  76]],

       [[ 62,  30,  24],
        [131, 109, 104],
        [132, 118, 113],
        ...,
        [185, 156, 106],
        [164, 137, 103],
        [154, 126, 108]],

       [[145, 128, 116],
        [164, 152, 141],
        [136, 126, 122],
        ...,
        [207, 173, 109],
        [186, 156, 106],
        [168, 142, 107]],

       ...,

       [[234, 215, 171],
        [237, 227, 192],
        [235, 229, 202],
        ...,
        [225, 211, 167],
        [236, 221, 173],
        [248, 225, 174]],

       [[230, 206, 165],
        [238, 222, 188],
        [246, 238, 211],
        ...,
        [236, 218, 170],
        [239, 224, 175],
        [251, 235, 184]],

       [[241, 222, 182],
        [246, 235, 203],
        [247, 244, 220],
        ...,
        [240, 219, 172],
        [243, 222, 174],
        [247, 227, 176]]], dtype=uint8)]"
Image_1210.jpg,440,205,201,196,900,600,641,401,201,daskShared_local/images/Image_1210.jpg,1210,"[array([[[  0, 129, 237],
        [  0, 128, 237],
        [  0, 127, 236],
        ...,
        [  0,  89, 207],
        [  0,  88, 206],
        [  0,  91, 208]],

       [[  0, 127, 236],
        [  0, 127, 236],
        [  0, 126, 236],
        ...,
        [  0,  89, 207],
        [  0,  88, 206],
        [  0,  90, 207]],

       [[  0, 127, 236],
        [  0, 126, 236],
        [  1, 126, 236],
        ...,
        [  0,  88, 204],
        [  0,  88, 204],
        [  0,  88, 208]],

       ...,

       [[149, 141,  75],
        [134, 125,  58],
        [127, 114,  46],
        ...,
        [  0,  52, 165],
        [  1,  58, 174],
        [  0,  52, 166]],

       [[184, 175, 118],
        [149, 140,  83],
        [183, 171, 113],
        ...,
        [  0,  51, 167],
        [  0,  56, 175],
        [  0,  52, 166]],

       [[119, 111,  62],
        [157, 149, 100],
        [240, 230, 179],
        ...,
        [  2,  54, 174],
        [  0,  50, 174],
        [  0,  52, 166]]], dtype=uint8)]"
Image_1211.jpg,97,100,147,135,500,375,244,235,147,daskShared_local/images/Image_1211.jpg,1211,"[array([[[ 36, 107, 125],
        [ 38, 107, 124],
        [ 40, 106, 123],
        ...,
        [ 35,  90, 111],
        [ 39,  94, 115],
        [ 42,  97, 118]],

       [[ 41, 114, 134],
        [ 43, 114, 132],
        [ 44, 112, 130],
        ...,
        [ 35,  89, 112],
        [ 38,  93, 115],
        [ 40,  94, 116]],

       [[ 46, 118, 138],
        [ 47, 118, 137],
        [ 48, 117, 135],
        ...,
        [ 34,  87, 111],
        [ 37,  90, 113],
        [ 37,  91, 113]],

       ...,

       [[ 21, 115, 141],
        [ 22, 116, 142],
        [ 23, 117, 143],
        ...,
        [214, 214, 212],
        [220, 219, 217],
        [223, 222, 220]],

       [[ 20, 113, 138],
        [ 21, 114, 139],
        [ 21, 115, 139],
        ...,
        [210, 209, 206],
        [214, 214, 213],
        [217, 217, 217]],

       [[ 19, 111, 134],
        [ 20, 112, 135],
        [ 21, 113, 136],
        ...,
        [206, 205, 201],
        [208, 210, 209],
        [211, 214, 216]]], dtype=uint8)]"
Image_1212.jpg,320,276,268,221,750,740,588,497,268,daskShared_local/images/Image_1212.jpg,1212,"[array([[[126, 236, 249],
        [124, 235, 247],
        [123, 235, 247],
        ...,
        [ 16, 202, 225],
        [ 17, 199, 222],
        [ 16, 195, 216]],

       [[126, 230, 244],
        [128, 232, 246],
        [128, 233, 247],
        ...,
        [ 10, 197, 221],
        [ 12, 195, 218],
        [ 12, 192, 215]],

       [[ 95, 244, 254],
        [ 96, 243, 254],
        [ 95, 240, 254],
        ...,
        [  7, 188, 215],
        [  6, 189, 215],
        [  3, 192, 216]],

       ...,

       [[133, 181, 131],
        [136, 184, 134],
        [140, 189, 139],
        ...,
        [142, 188, 199],
        [139, 186, 199],
        [137, 185, 199]],

       [[129, 175, 130],
        [132, 179, 133],
        [137, 184, 137],
        ...,
        [137, 181, 192],
        [133, 179, 193],
        [130, 178, 192]],

       [[130, 173, 134],
        [129, 171, 132],
        [126, 168, 127],
        ...,
        [132, 173, 185],
        [126, 169, 183],
        [126, 172, 185]]], dtype=uint8)]"
Image_1213.jpg,624,452,235,186,1024,672,859,638,235,daskShared_local/images/Image_1213.jpg,1213,"[array([[[119, 114, 125],
        [122, 117, 128],
        [124, 121, 132],
        ...,
        [192, 196, 151],
        [184, 190, 147],
        [171, 176, 135]],

       [[108, 106, 114],
        [114, 112, 121],
        [119, 117, 128],
        ...,
        [178, 179, 128],
        [181, 182, 135],
        [162, 163, 121]],

       [[ 95,  94, 100],
        [102, 102, 109],
        [111, 111, 120],
        ...,
        [172, 170, 121],
        [177, 176, 132],
        [161, 160, 122]],

       ...,

       [[ 34,  93, 151],
        [ 34,  92, 149],
        [ 34,  90, 145],
        ...,
        [ 14, 119, 231],
        [ 12, 117, 231],
        [ 11, 116, 231]],

       [[ 34,  93, 152],
        [ 33,  91, 151],
        [ 34,  89, 147],
        ...,
        [  7, 112, 225],
        [  6, 112, 226],
        [  5, 110, 225]],

       [[ 36,  95, 155],
        [ 36,  92, 153],
        [ 35,  90, 148],
        ...,
        [  6, 112, 224],
        [  7, 112, 226],
        [  6, 111, 226]]], dtype=uint8)]"
Image_1214.jpg,312,114,226,298,1000,667,538,412,298,daskShared_local/images/Image_1214.jpg,1214,"[array([[[199, 164, 133],
        [227, 193, 165],
        [234, 206, 183],
        ...,
        [184, 173, 161],
        [139, 128, 116],
        [121, 111,  98]],

       [[193, 199, 199],
        [140, 158, 177],
        [ 90, 117, 149],
        ...,
        [119, 107,  93],
        [147, 135, 121],
        [164, 152, 138]],

       [[ 62,  95, 131],
        [ 43,  83, 122],
        [ 64,  98, 131],
        ...,
        [189, 176, 160],
        [163, 150, 134],
        [127, 114,  98]],

       ...,

       [[ 25, 116, 168],
        [ 24, 116, 167],
        [ 25, 115, 168],
        ...,
        [143, 108,  63],
        [114,  89,  45],
        [108,  86,  41]],

       [[ 34, 120, 171],
        [ 33, 119, 170],
        [ 33, 119, 171],
        ...,
        [161, 123,  77],
        [114,  88,  48],
        [ 93,  74,  35]],

       [[ 48, 125, 177],
        [ 47, 124, 176],
        [ 45, 124, 177],
        ...,
        [135, 101,  51],
        [ 72,  53,  17],
        [ 52,  41,  19]]], dtype=uint8)]"
Image_1215.jpg,389,6,88,59,530,180,477,65,88,daskShared_local/images/Image_1215.jpg,1215,"[array([[[  8,  37,  76],
        [  8,  37,  77],
        [  7,  37,  75],
        ...,
        [  3,  12,  56],
        [  1,  11,  56],
        [  1,  11,  56]],

       [[  9,  34,  71],
        [  9,  34,  72],
        [  7,  34,  70],
        ...,
        [  3,  14,  58],
        [  1,  12,  57],
        [  1,  12,  57]],

       [[  7,  41,  82],
        [  8,  41,  83],
        [  6,  40,  80],
        ...,
        [  2,  10,  54],
        [  0,  10,  56],
        [  1,  10,  56]],

       ...,

       [[ 79,  66,  72],
        [ 78,  65,  70],
        [ 81,  70,  77],
        ...,
        [ 25,  18,  42],
        [ 28,  18,  45],
        [ 28,  18,  44]],

       [[143, 118,  87],
        [141, 115,  85],
        [146, 126,  94],
        ...,
        [ 31,  22,  48],
        [ 34,  21,  50],
        [ 33,  21,  49]],

       [[112,  93,  80],
        [111,  91,  78],
        [115,  99,  86],
        ...,
        [ 28,  20,  45],
        [ 31,  19,  48],
        [ 30,  20,  47]]], dtype=uint8)]"
Image_1216.jpg,740,254,377,325,1200,906,1117,579,377,daskShared_local/images/Image_1216.jpg,1216,"[array([[[183, 171, 176],
        [184, 172, 176],
        [187, 176, 181],
        ...,
        [ 14,  47,  68],
        [ 16,  49,  70],
        [ 16,  48,  69]],

       [[177, 162, 166],
        [186, 172, 175],
        [182, 170, 175],
        ...,
        [ 17,  48,  69],
        [ 14,  46,  67],
        [ 13,  45,  66]],

       [[150, 136, 140],
        [174, 161, 163],
        [180, 168, 173],
        ...,
        [ 14,  44,  66],
        [ 12,  42,  64],
        [ 13,  44,  66]],

       ...,

       [[ 73, 100, 109],
        [ 88, 114, 124],
        [115, 137, 148],
        ...,
        [ 20,  50,  68],
        [ 29,  50,  70],
        [ 37,  55,  74]],

       [[ 62,  90,  99],
        [ 98, 125, 134],
        [175, 199, 210],
        ...,
        [ 19,  49,  67],
        [ 31,  53,  71],
        [ 36,  55,  72]],

       [[ 63,  92, 101],
        [ 96, 125, 136],
        [168, 196, 207],
        ...,
        [ 25,  55,  72],
        [ 35,  58,  75],
        [ 36,  57,  74]]], dtype=uint8)]"
Image_1217.jpg,285,125,138,129,800,505,423,254,138,daskShared_local/images/Image_1217.jpg,1217,"[array([[[  1,  37,  35],
        [  1,  38,  35],
        [  2,  40,  38],
        ...,
        [  9,  27,  37],
        [  8,  26,  36],
        [  9,  27,  37]],

       [[  4,  40,  39],
        [  3,  41,  39],
        [  5,  43,  41],
        ...,
        [ 10,  28,  38],
        [  9,  27,  37],
        [  9,  27,  37]],

       [[ 19,  55,  54],
        [ 18,  55,  54],
        [ 20,  58,  57],
        ...,
        [ 11,  29,  39],
        [ 11,  29,  39],
        [ 10,  28,  38]],

       ...,

       [[111, 114,  78],
        [105, 107,  73],
        [ 96,  97,  65],
        ...,
        [172, 165, 149],
        [157, 149, 132],
        [145, 136, 120]],

       [[112, 117,  81],
        [106, 109,  74],
        [ 97,  99,  66],
        ...,
        [155, 149, 131],
        [150, 143, 126],
        [146, 138, 121]],

       [[111, 117,  81],
        [105, 109,  74],
        [ 97,  99,  65],
        ...,
        [143, 138, 119],
        [147, 141, 123],
        [148, 141, 123]]], dtype=uint8)]"
Image_1218.jpg,428,209,124,152,900,600,552,361,152,daskShared_local/images/Image_1218.jpg,1218,"[array([[[  7, 111, 166],
        [  6, 110, 165],
        [  6, 110, 165],
        ...,
        [  3, 117, 169],
        [  3, 117, 169],
        [  3, 117, 169]],

       [[  7, 111, 166],
        [  6, 110, 165],
        [  5, 109, 164],
        ...,
        [  3, 117, 169],
        [  3, 117, 169],
        [  3, 117, 169]],

       [[  6, 110, 165],
        [  6, 110, 165],
        [  5, 109, 164],
        ...,
        [  3, 117, 169],
        [  3, 117, 169],
        [  3, 117, 169]],

       ...,

       [[ 41,  72,  67],
        [ 45,  76,  71],
        [ 45,  79,  75],
        ...,
        [  2,  96, 147],
        [  3,  97, 148],
        [  3,  97, 148]],

       [[ 38,  69,  64],
        [ 42,  72,  68],
        [ 46,  77,  74],
        ...,
        [  3,  97, 148],
        [  3,  97, 148],
        [  4,  98, 149]],

       [[ 50,  81,  76],
        [ 45,  75,  70],
        [ 48,  78,  74],
        ...,
        [  4,  98, 149],
        [  5,  99, 150],
        [  5,  99, 150]]], dtype=uint8)]"
Image_1219.jpg,745,151,262,203,1050,700,1007,354,262,daskShared_local/images/Image_1219.jpg,1219,"[array([[[  2, 147, 138],
        [ 15, 170, 160],
        [ 26, 187, 178],
        ...,
        [ 24,  33,  48],
        [ 18,  32,  44],
        [ 14,  36,  44]],

       [[  3, 167, 151],
        [  1, 172, 153],
        [  4, 177, 159],
        ...,
        [ 33,  45,  52],
        [ 35,  45,  53],
        [ 28,  39,  47]],

       [[  1, 175, 154],
        [  0, 175, 152],
        [  0, 174, 151],
        ...,
        [ 26,  42,  42],
        [ 33,  46,  49],
        [ 32,  43,  48]],

       ...,

       [[ 34,  48,  51],
        [ 32,  46,  49],
        [ 32,  46,  49],
        ...,
        [ 97, 170, 124],
        [ 96, 190, 129],
        [124, 207, 156]],

       [[ 37,  51,  54],
        [ 35,  49,  52],
        [ 32,  46,  49],
        ...,
        [160, 207, 180],
        [173, 217, 190],
        [199, 229, 215]],

       [[ 37,  51,  54],
        [ 39,  53,  56],
        [ 38,  52,  55],
        ...,
        [142, 191, 167],
        [184, 220, 205],
        [192, 230, 221]]], dtype=uint8)]"
Image_122.jpg,473,118,107,83,685,360,580,201,107,daskShared_local/images/Image_122.jpg,122,"[array([[[  1, 109, 150],
        [  1, 109, 150],
        [  3, 109, 151],
        ...,
        [  0, 101, 145],
        [  0, 101, 145],
        [  0, 101, 145]],

       [[  1, 109, 150],
        [  1, 109, 150],
        [  3, 109, 151],
        ...,
        [  0, 101, 145],
        [  0, 101, 145],
        [  0, 101, 145]],

       [[  1, 106, 148],
        [  1, 106, 148],
        [  3, 107, 150],
        ...,
        [  0, 101, 145],
        [  0, 101, 145],
        [  0, 101, 145]],

       ...,

       [[  0,  35,  72],
        [  0,  33,  69],
        [  0,  17,  49],
        ...,
        [  0,  83, 119],
        [  0,  83, 119],
        [  0,  83, 119]],

       [[  1,  42,  79],
        [  0,  39,  76],
        [  0,  21,  54],
        ...,
        [  0,  83, 119],
        [  0,  83, 119],
        [  0,  83, 119]],

       [[  1,  43,  81],
        [  1,  40,  77],
        [  0,  22,  54],
        ...,
        [  0,  83, 119],
        [  0,  83, 119],
        [  0,  83, 119]]], dtype=uint8)]"
Image_1220.jpg,360,99,301,292,1024,670,661,391,301,daskShared_local/images/Image_1220.jpg,1220,"[array([[[  1,  61, 105],
        [  5,  67, 112],
        [  4,  65, 110],
        ...,
        [  9,  20,  38],
        [  6,  17,  34],
        [  1,  13,  28]],

       [[  4,  68, 112],
        [  2,  68, 114],
        [  1,  68, 112],
        ...,
        [  7,  17,  45],
        [  4,  15,  38],
        [  4,  16,  33]],

       [[  2,  63, 109],
        [  0,  60, 107],
        [  2,  66, 108],
        ...,
        [ 10,  20,  46],
        [  8,  19,  41],
        [  5,  16,  33]],

       ...,

       [[  4,  45,  18],
        [ 37,  70,  28],
        [100, 131,  76],
        ...,
        [ 11,  30,  34],
        [  8,  28,  31],
        [  8,  29,  32]],

       [[  9,  54,  23],
        [ 33,  68,  26],
        [ 57,  89,  37],
        ...,
        [ 12,  29,  33],
        [  6,  25,  29],
        [  4,  24,  27]],

       [[ 17,  61,  21],
        [ 15,  54,  10],
        [ 17,  55,   9],
        ...,
        [  9,  23,  28],
        [  7,  23,  28],
        [  5,  23,  27]]], dtype=uint8)]"
Image_1221.jpg,268,325,153,120,900,599,421,445,153,daskShared_local/images/Image_1221.jpg,1221,"[array([[[ 68, 135, 213],
        [ 68, 135, 213],
        [ 68, 135, 213],
        ...,
        [138, 184, 211],
        [161, 200, 222],
        [177, 210, 228]],

       [[ 67, 134, 212],
        [ 68, 135, 213],
        [ 68, 135, 213],
        ...,
        [153, 194, 214],
        [173, 205, 222],
        [187, 213, 226]],

       [[ 67, 134, 212],
        [ 68, 135, 213],
        [ 68, 135, 213],
        ...,
        [172, 205, 216],
        [187, 211, 220],
        [199, 217, 223]],

       ...,

       [[ 46,  85, 164],
        [ 46,  85, 164],
        [ 46,  85, 164],
        ...,
        [ 47,  90, 168],
        [ 47,  90, 168],
        [ 47,  90, 168]],

       [[ 46,  85, 164],
        [ 46,  85, 164],
        [ 46,  85, 164],
        ...,
        [ 47,  90, 168],
        [ 47,  90, 168],
        [ 47,  90, 168]],

       [[ 45,  84, 163],
        [ 45,  84, 163],
        [ 45,  84, 163],
        ...,
        [ 46,  89, 167],
        [ 46,  89, 167],
        [ 46,  89, 167]]], dtype=uint8)]"
Image_1222.jpg,274,161,271,243,1000,541,545,404,271,daskShared_local/images/Image_1222.jpg,1222,"[array([[[  0, 116, 149],
        [  0, 124, 158],
        [  0, 131, 168],
        ...,
        [ 35,  72,  86],
        [ 39,  76,  89],
        [ 39,  84,  98]],

       [[  1, 110, 141],
        [  0, 116, 149],
        [  0, 124, 159],
        ...,
        [ 35,  68,  84],
        [ 38,  70,  84],
        [ 41,  77,  92]],

       [[  3, 105, 132],
        [  1, 110, 140],
        [  2, 116, 150],
        ...,
        [ 33,  72,  89],
        [ 36,  71,  88],
        [ 41,  73,  92]],

       ...,

       [[  1,  72,  89],
        [  1,  67,  85],
        [  6,  64,  79],
        ...,
        [154, 176, 200],
        [135, 162, 185],
        [ 95, 128, 153]],

       [[  0,  54,  69],
        [  1,  50,  64],
        [  6,  52,  65],
        ...,
        [144, 167, 194],
        [ 90, 120, 146],
        [ 52,  93, 117]],

       [[  0,  45,  57],
        [  1,  39,  48],
        [  4,  44,  56],
        ...,
        [ 88, 118, 151],
        [ 65, 102, 132],
        [ 70, 110, 136]]], dtype=uint8)]"
Image_1223.jpg,394,186,155,126,770,578,549,312,155,daskShared_local/images/Image_1223.jpg,1223,"[array([[[ 61,  69,  71],
        [ 60,  68,  70],
        [ 62,  69,  70],
        ...,
        [ 73,  72,  66],
        [ 76,  75,  72],
        [ 79,  78,  76]],

       [[ 60,  68,  72],
        [ 60,  68,  71],
        [ 62,  70,  71],
        ...,
        [ 76,  76,  71],
        [ 77,  77,  75],
        [ 79,  79,  78]],

       [[ 60,  67,  74],
        [ 61,  68,  73],
        [ 63,  71,  73],
        ...,
        [ 83,  82,  80],
        [ 83,  82,  81],
        [ 83,  82,  83]],

       ...,

       [[100, 104, 105],
        [ 97, 101, 102],
        [101, 105, 106],
        ...,
        [ 52,  52,  45],
        [ 41,  41,  35],
        [ 43,  43,  38]],

       [[ 98, 102, 103],
        [100, 104, 105],
        [102, 106, 107],
        ...,
        [ 80,  80,  71],
        [ 67,  66,  57],
        [ 87,  86,  78]],

       [[ 98, 102, 103],
        [101, 105, 106],
        [100, 104, 105],
        ...,
        [ 99,  98,  88],
        [ 80,  77,  69],
        [105, 102,  93]]], dtype=uint8)]"
Image_1224.jpg,295,368,179,151,1024,683,474,519,179,daskShared_local/images/Image_1224.jpg,1224,"[array([[[150, 168, 168],
        [138, 163, 169],
        [138, 162, 169],
        ...,
        [ 79,  75,  69],
        [ 70,  69,  59],
        [ 81,  78,  69]],

       [[140, 158, 153],
        [129, 155, 163],
        [129, 153, 163],
        ...,
        [ 76,  65,  60],
        [ 76,  68,  61],
        [ 78,  70,  62]],

       [[144, 158, 149],
        [126, 147, 153],
        [123, 145, 155],
        ...,
        [ 80,  64,  58],
        [ 76,  64,  56],
        [ 77,  65,  57]],

       ...,

       [[  0, 104, 131],
        [  0, 106, 132],
        [  0, 106, 132],
        ...,
        [  0, 113, 139],
        [  0, 114, 140],
        [  0, 114, 140]],

       [[  0, 104, 131],
        [  0, 106, 132],
        [  0, 106, 132],
        ...,
        [  0, 113, 139],
        [  0, 113, 139],
        [  0, 113, 139]],

       [[  0, 104, 131],
        [  0, 106, 132],
        [  0, 106, 132],
        ...,
        [  0, 112, 138],
        [  0, 113, 139],
        [  0, 113, 139]]], dtype=uint8)]"
Image_1225.jpg,190,194,451,338,1599,1065,641,532,451,daskShared_local/images/Image_1225.jpg,1225,"[array([[[  3,   1,   2],
        [  5,   1,   2],
        [  5,   1,   2],
        ...,
        [  5,   1,   2],
        [  5,   1,   2],
        [  4,   1,   2]],

       [[  3,   2,   2],
        [  5,   1,   2],
        [  5,   1,   2],
        ...,
        [  5,   1,   2],
        [  5,   1,   2],
        [  4,   1,   2]],

       [[  3,   2,   2],
        [  5,   1,   2],
        [  5,   1,   2],
        ...,
        [  5,   1,   2],
        [  5,   1,   2],
        [  5,   1,   2]],

       ...,

       [[  3,   1,   2],
        [  3,   1,   2],
        [  3,   1,   2],
        ...,
        [ 41,  47,  35],
        [ 30,  53,  32],
        [ 36,  65,  47]],

       [[  3,   1,   2],
        [  3,   1,   2],
        [  3,   1,   2],
        ...,
        [ 27,  45,  52],
        [ 52,  77,  91],
        [105, 137, 141]],

       [[  3,   1,   2],
        [  3,   1,   2],
        [  3,   1,   2],
        ...,
        [ 33,  62,  45],
        [ 53,  82,  67],
        [108, 143, 140]]], dtype=uint8)]"
Image_1226.JPG,301,448,1521,1472,2560,1920,1822,1920,1521,daskShared_local/images/Image_1226.JPG,1226,"[array([[[ 86,  76,  27],
        [ 87,  82,  29],
        [ 93,  79,  30],
        ...,
        [198, 180, 152],
        [172, 155, 131],
        [134, 122,  95]],

       [[ 85,  75,  28],
        [ 85,  77,  31],
        [ 89,  77,  34],
        ...,
        [170, 159, 123],
        [158, 146, 111],
        [144, 129,  97]],

       [[ 91,  76,  32],
        [ 91,  75,  30],
        [ 91,  73,  33],
        ...,
        [150, 137, 106],
        [146, 133,  99],
        [140, 128,  90]],

       ...,

       [[ 75,  87,  18],
        [ 77,  85,  20],
        [ 76,  84,  27],
        ...,
        [ 92, 101,  31],
        [ 92,  99,  28],
        [ 88,  99,  27]],

       [[ 74,  85,  22],
        [ 74,  84,  26],
        [ 76,  86,  34],
        ...,
        [ 90,  99,  32],
        [ 88, 101,  27],
        [ 90,  98,  29]],

       [[ 73,  86,  21],
        [ 70,  86,  23],
        [ 76,  88,  36],
        ...,
        [ 89, 100,  32],
        [ 89, 101,  26],
        [ 88,  97,  29]]], dtype=uint8)]"
Image_1227.jpg,279,419,203,184,1024,768,482,603,203,daskShared_local/images/Image_1227.jpg,1227,"[array([[[ 56,  47,  42],
        [172, 170, 172],
        [190, 189, 194],
        ...,
        [ 81,  62,  38],
        [ 74,  52,  38],
        [ 77,  58,  44]],

       [[ 79,  68,  64],
        [ 59,  53,  57],
        [ 63,  65,  74],
        ...,
        [ 87,  70,  44],
        [ 67,  47,  29],
        [ 71,  54,  40]],

       [[114, 103,  97],
        [122, 111, 109],
        [ 66,  60,  62],
        ...,
        [ 90,  72,  48],
        [ 58,  39,  24],
        [ 60,  46,  33]],

       ...,

       [[238, 215, 185],
        [224, 203, 174],
        [238, 219, 189],
        ...,
        [204, 176, 139],
        [207, 183, 148],
        [211, 184, 154]],

       [[224, 202, 165],
        [230, 207, 173],
        [238, 216, 185],
        ...,
        [180, 150, 114],
        [190, 164, 129],
        [181, 152, 120]],

       [[234, 212, 173],
        [227, 202, 165],
        [238, 211, 181],
        ...,
        [193, 161, 122],
        [218, 189, 149],
        [218, 188, 150]]], dtype=uint8)]"
Image_1228.jpg,533,196,316,286,986,653,849,482,316,daskShared_local/images/Image_1228.jpg,1228,"[array([[[ 64,  79,  45],
        [ 62,  76,  49],
        [ 56,  69,  47],
        ...,
        [ 59, 122,  98],
        [ 59, 122,  99],
        [ 59, 124, 100]],

       [[ 66,  79,  46],
        [ 65,  78,  51],
        [ 54,  66,  45],
        ...,
        [ 59, 121,  98],
        [ 59, 121,  98],
        [ 60, 123,  99]],

       [[ 64,  77,  45],
        [ 56,  68,  42],
        [ 57,  68,  47],
        ...,
        [ 59, 120,  98],
        [ 60, 121,  98],
        [ 59, 122,  98]],

       ...,

       [[ 64,  83,  37],
        [ 60,  76,  36],
        [ 63,  79,  37],
        ...,
        [ 48,  74,  37],
        [ 46,  72,  36],
        [ 49,  75,  38]],

       [[ 61,  80,  31],
        [ 63,  81,  36],
        [ 66,  82,  39],
        ...,
        [ 46,  72,  35],
        [ 45,  71,  34],
        [ 48,  74,  37]],

       [[ 66,  86,  40],
        [ 70,  87,  46],
        [ 76,  92,  49],
        ...,
        [ 45,  70,  37],
        [ 45,  70,  37],
        [ 48,  74,  37]]], dtype=uint8)]"
Image_1229.jpg,648,211,363,340,2121,1063,1011,551,363,daskShared_local/images/Image_1229.jpg,1229,"[array([[[176, 182, 176],
        [175, 181, 177],
        [171, 181, 180],
        ...,
        [178, 202, 212],
        [180, 202, 212],
        [181, 202, 213]],

       [[164, 181, 181],
        [164, 177, 176],
        [167, 180, 180],
        ...,
        [176, 203, 212],
        [174, 199, 209],
        [173, 197, 207]],

       [[120, 149, 158],
        [151, 174, 179],
        [156, 173, 174],
        ...,
        [161, 188, 199],
        [155, 182, 192],
        [161, 186, 196]],

       ...,

       [[ 50, 101, 120],
        [ 53, 104, 123],
        [ 55, 106, 125],
        ...,
        [164, 163, 151],
        [157, 154, 139],
        [170, 164, 148]],

       [[ 54, 105, 124],
        [ 54, 105, 124],
        [ 54, 105, 124],
        ...,
        [170, 169, 153],
        [157, 153, 138],
        [160, 153, 137]],

       [[ 56, 107, 126],
        [ 55, 106, 125],
        [ 54, 105, 124],
        ...,
        [163, 161, 145],
        [168, 163, 148],
        [169, 163, 148]]], dtype=uint8)]"
Image_123.jpg,325,265,134,134,1000,667,459,399,134,daskShared_local/images/Image_123.jpg,123,"[array([[[ 18, 212, 229],
        [ 15, 211, 229],
        [ 12, 210, 229],
        ...,
        [ 65, 214, 233],
        [ 63, 213, 232],
        [ 64, 213, 232]],

       [[ 14, 211, 228],
        [ 11, 211, 228],
        [  7, 210, 228],
        ...,
        [ 61, 214, 233],
        [ 64, 213, 233],
        [ 69, 214, 233]],

       [[  8, 211, 227],
        [  5, 211, 227],
        [  1, 210, 228],
        ...,
        [ 56, 213, 232],
        [ 65, 214, 233],
        [ 74, 214, 233]],

       ...,

       [[154,  92,   0],
        [144,  87,   1],
        [127,  78,   2],
        ...,
        [ 23,  71, 124],
        [ 11,  63, 117],
        [  3,  59, 117]],

       [[159,  97,   0],
        [155,  95,   1],
        [144,  88,   2],
        ...,
        [ 34,  63, 111],
        [ 31,  63, 112],
        [ 26,  64, 115]],

       [[159,  98,   0],
        [160,  98,   1],
        [154,  94,   2],
        ...,
        [ 43,  60, 107],
        [ 45,  67, 113],
        [ 42,  73, 119]]], dtype=uint8)]"
Image_1230.jpg,1829,410,349,276,3840,2160,2178,686,349,daskShared_local/images/Image_1230.jpg,1230,"[array([[[137, 210, 237],
        [136, 209, 236],
        [130, 204, 231],
        ...,
        [ 53, 139, 171],
        [ 71, 155, 189],
        [ 59, 152, 180]],

       [[146, 212, 233],
        [158, 224, 247],
        [145, 211, 237],
        ...,
        [ 79, 164, 195],
        [ 63, 144, 176],
        [ 40, 135, 156]],

       [[143, 202, 217],
        [150, 209, 228],
        [155, 215, 239],
        ...,
        [ 56, 135, 165],
        [ 70, 147, 177],
        [ 68, 157, 174]],

       ...,

       [[ 28,  99, 121],
        [ 28,  96, 117],
        [ 27,  93, 115],
        ...,
        [119, 120,  78],
        [111, 112,  68],
        [101, 104,  64]],

       [[ 29, 103, 123],
        [ 28, 100, 119],
        [ 28,  96, 115],
        ...,
        [121, 119,  77],
        [116, 114,  71],
        [111, 111,  73]],

       [[ 28, 102, 123],
        [ 29, 102, 121],
        [ 29,  99, 118],
        ...,
        [112, 109,  68],
        [113, 110,  69],
        [114, 114,  76]]], dtype=uint8)]"
Image_1231.jpg,67,142,115,103,525,340,182,245,115,daskShared_local/images/Image_1231.jpg,1231,"[array([[[ 37,  86, 102],
        [ 41,  89, 104],
        [ 52, 101, 114],
        ...,
        [119, 137, 110],
        [145, 163, 136],
        [152, 171, 144]],

       [[ 39,  87, 102],
        [ 42,  90, 105],
        [ 52, 101, 113],
        ...,
        [122, 139, 112],
        [149, 167, 140],
        [156, 174, 148]],

       [[ 44,  90, 104],
        [ 46,  93, 106],
        [ 53, 100, 111],
        ...,
        [131, 145, 119],
        [162, 178, 152],
        [171, 187, 161]],

       ...,

       [[ 31,  40,  32],
        [ 33,  43,  35],
        [ 44,  53,  45],
        ...,
        [ 77, 100,  80],
        [ 58,  81,  61],
        [ 53,  76,  56]],

       [[ 34,  37,  32],
        [ 33,  36,  30],
        [ 29,  30,  25],
        ...,
        [ 63,  85,  65],
        [ 53,  75,  55],
        [ 50,  72,  53]],

       [[ 36,  36,  32],
        [ 33,  34,  29],
        [ 25,  24,  20],
        ...,
        [ 59,  80,  61],
        [ 51,  73,  54],
        [ 49,  71,  52]]], dtype=uint8)]"
Image_1232.jpg,567,180,92,84,1000,700,659,264,92,daskShared_local/images/Image_1232.jpg,1232,"[array([[[  1, 155, 228],
        [  1, 155, 228],
        [  1, 156, 229],
        ...,
        [  0, 159, 227],
        [  0, 159, 227],
        [  0, 159, 227]],

       [[  1, 155, 229],
        [  1, 155, 228],
        [  0, 156, 229],
        ...,
        [  0, 159, 227],
        [  0, 159, 227],
        [  0, 159, 227]],

       [[  1, 156, 227],
        [  1, 155, 227],
        [  1, 157, 227],
        ...,
        [  0, 159, 227],
        [  0, 158, 226],
        [  0, 159, 227]],

       ...,

       [[  3,  71, 103],
        [  3,  71, 103],
        [  2,  72, 104],
        ...,
        [  0, 151, 223],
        [  0, 151, 224],
        [  0, 151, 224]],

       [[  2,  68, 105],
        [  2,  67, 104],
        [  2,  70, 105],
        ...,
        [  0, 151, 223],
        [  0, 151, 223],
        [  0, 151, 223]],

       [[  2,  68, 104],
        [  2,  68, 104],
        [  2,  70, 105],
        ...,
        [  0, 151, 223],
        [  0, 151, 223],
        [  0, 151, 223]]], dtype=uint8)]"
Image_1233.jpg,380,17,1125,1001,1920,1080,1505,1018,1125,daskShared_local/images/Image_1233.jpg,1233,"[array([[[  1, 124, 156],
        [  1, 123, 156],
        [  1, 124, 157],
        ...,
        [164, 166, 115],
        [146, 159, 122],
        [113, 131, 120]],

       [[  0, 123, 156],
        [  1, 123, 156],
        [  0, 123, 156],
        ...,
        [115, 130, 108],
        [ 86, 109, 104],
        [ 59,  82,  91]],

       [[  0, 124, 156],
        [  0, 124, 156],
        [  0, 124, 156],
        ...,
        [ 56,  86,  95],
        [ 50,  80,  89],
        [ 30,  58,  66]],

       ...,

       [[ 98,  89,  33],
        [ 87,  83,  39],
        [ 80,  80,  40],
        ...,
        [ 12,  28,  28],
        [ 12,  28,  28],
        [ 12,  27,  28]],

       [[ 95,  94,  47],
        [ 86,  86,  47],
        [ 80,  83,  42],
        ...,
        [ 13,  27,  28],
        [ 12,  27,  27],
        [ 12,  26,  27]],

       [[ 84,  86,  47],
        [ 74,  77,  39],
        [ 74,  78,  38],
        ...,
        [ 12,  26,  27],
        [ 13,  26,  27],
        [ 12,  25,  26]]], dtype=uint8)]"
Image_1234.jpg,291,83,174,172,732,420,465,255,174,daskShared_local/images/Image_1234.jpg,1234,"[array([[[  1, 162, 214],
        [  1, 162, 214],
        [  1, 162, 214],
        ...,
        [  6, 187, 213],
        [  4, 189, 213],
        [  6, 182, 218]],

       [[  1, 162, 214],
        [  1, 162, 214],
        [  1, 162, 214],
        ...,
        [ 52, 195, 228],
        [ 44, 192, 225],
        [ 24, 188, 223]],

       [[  1, 162, 214],
        [  1, 162, 214],
        [  1, 162, 214],
        ...,
        [ 87, 205, 241],
        [ 74, 196, 234],
        [ 48, 195, 232]],

       ...,

       [[207, 200, 195],
        [208, 206, 199],
        [213, 216, 205],
        ...,
        [  7,  46,  48],
        [ 11,  48,  50],
        [  2,  61,  56]],

       [[195, 189, 191],
        [187, 190, 190],
        [189, 198, 191],
        ...,
        [  3,  27,  30],
        [  3,  15,  21],
        [  5,  28,  34]],

       [[211, 199, 206],
        [212, 211, 214],
        [203, 210, 205],
        ...,
        [  2,   9,   8],
        [  8,   2,   7],
        [ 12,   2,  11]]], dtype=uint8)]"
Image_1235.jpg,432,358,221,230,1024,683,653,588,230,daskShared_local/images/Image_1235.jpg,1235,"[array([[[120, 101,  69],
        [128, 109,  88],
        [121, 104,  96],
        ...,
        [137, 112,  96],
        [118,  95,  81],
        [ 99,  78,  60]],

       [[112,  90,  59],
        [ 76,  57,  40],
        [ 48,  34,  32],
        ...,
        [136, 109,  83],
        [113,  90,  74],
        [126, 106,  86]],

       [[ 81,  51,  46],
        [ 57,  34,  31],
        [ 45,  31,  29],
        ...,
        [103,  77,  59],
        [ 88,  61,  43],
        [ 93,  66,  46]],

       ...,

       [[228, 200, 158],
        [245, 220, 175],
        [229, 195, 161],
        ...,
        [235, 210, 155],
        [245, 232, 209],
        [244, 222, 199]],

       [[241, 210, 170],
        [233, 201, 155],
        [207, 168, 126],
        ...,
        [210, 171, 129],
        [226, 195, 169],
        [233, 197, 167]],

       [[241, 211, 176],
        [229, 199, 160],
        [250, 222, 183],
        ...,
        [239, 198, 165],
        [246, 210, 178],
        [253, 226, 188]]], dtype=uint8)]"
Image_1236.jpg,527,86,311,305,1024,770,838,391,311,daskShared_local/images/Image_1236.jpg,1236,"[array([[[  3, 116, 189],
        [  2, 115, 188],
        [  1, 115, 188],
        ...,
        [ 38,  36,  39],
        [ 32,  31,  36],
        [ 34,  35,  40]],

       [[  5, 117, 191],
        [  2, 114, 188],
        [  2, 114, 188],
        ...,
        [ 34,  32,  35],
        [ 31,  31,  36],
        [ 37,  38,  42]],

       [[  5, 115, 190],
        [  3, 115, 189],
        [  2, 114, 188],
        ...,
        [ 34,  34,  37],
        [ 32,  32,  37],
        [ 35,  38,  42]],

       ...,

       [[151, 128,  82],
        [183, 164, 131],
        [102,  85,  65],
        ...,
        [ 48,  44,  45],
        [ 50,  46,  45],
        [ 46,  41,  41]],

       [[137, 107,  62],
        [186, 163, 127],
        [135, 114,  92],
        ...,
        [ 41,  37,  38],
        [ 41,  36,  35],
        [ 45,  39,  39]],

       [[136, 104,  57],
        [187, 162, 124],
        [134, 109,  86],
        ...,
        [ 41,  37,  38],
        [ 40,  36,  35],
        [ 39,  34,  34]]], dtype=uint8)]"
Image_1237.jpg,2246,249,604,515,3033,1757,2850,764,604,daskShared_local/images/Image_1237.jpg,1237,"[array([[[  0,  53, 217],
        [  0,  53, 217],
        [  0,  53, 217],
        ...,
        [  0,  53, 217],
        [  0,  53, 217],
        [  0,  53, 217]],

       [[  0,  53, 217],
        [  0,  53, 217],
        [  0,  53, 217],
        ...,
        [  0,  53, 217],
        [  0,  53, 217],
        [  0,  53, 217]],

       [[  0,  53, 217],
        [  0,  53, 217],
        [  0,  53, 217],
        ...,
        [  0,  53, 217],
        [  0,  53, 217],
        [  0,  53, 217]],

       ...,

       [[112, 122,  70],
        [115, 126,  74],
        [113, 126,  73],
        ...,
        [  0,  53, 217],
        [  0,  53, 217],
        [  0,  53, 217]],

       [[107, 117,  66],
        [110, 121,  70],
        [105, 117,  66],
        ...,
        [  0,  53, 217],
        [  0,  53, 217],
        [  0,  53, 217]],

       [[105, 114,  66],
        [107, 117,  69],
        [100, 112,  63],
        ...,
        [  0,  53, 217],
        [  0,  53, 217],
        [  0,  53, 217]]], dtype=uint8)]"
Image_1238.jpg,508,371,186,158,1024,678,694,529,186,daskShared_local/images/Image_1238.jpg,1238,"[array([[[162, 158, 149],
        [131, 127, 115],
        [155, 146, 137],
        ...,
        [223, 194, 132],
        [223, 196, 147],
        [200, 178, 140]],

       [[142, 133, 123],
        [138, 126, 113],
        [141, 129, 119],
        ...,
        [190, 162, 120],
        [188, 160, 119],
        [200, 176, 140]],

       [[145, 122, 102],
        [142, 124, 103],
        [132, 117, 104],
        ...,
        [147, 120, 101],
        [121,  93,  75],
        [176, 149, 133]],

       ...,

       [[237, 218, 167],
        [240, 226, 179],
        [244, 228, 181],
        ...,
        [236, 212, 165],
        [238, 213, 164],
        [239, 212, 162]],

       [[222, 204, 166],
        [223, 211, 177],
        [242, 230, 192],
        ...,
        [240, 213, 162],
        [241, 211, 158],
        [244, 213, 158]],

       [[239, 222, 177],
        [239, 223, 177],
        [245, 230, 188],
        ...,
        [244, 213, 152],
        [242, 210, 150],
        [240, 211, 155]]], dtype=uint8)]"
Image_1239.jpg,465,119,114,86,685,360,579,205,114,daskShared_local/images/Image_1239.jpg,1239,"[array([[[  1, 110, 153],
        [  1, 110, 153],
        [  0, 109, 152],
        ...,
        [  0, 101, 145],
        [  0, 101, 145],
        [  0, 101, 145]],

       [[  1, 110, 153],
        [  1, 110, 153],
        [  0, 109, 152],
        ...,
        [  0, 101, 145],
        [  0, 101, 145],
        [  0, 101, 145]],

       [[  2, 111, 154],
        [  2, 111, 154],
        [  1, 110, 153],
        ...,
        [  0, 101, 145],
        [  0, 101, 145],
        [  0, 101, 145]],

       ...,

       [[  1,  85, 121],
        [  1,  85, 121],
        [  1,  85, 121],
        ...,
        [  0,  81, 118],
        [  0,  82, 117],
        [  0,  82, 116]],

       [[  1,  85, 121],
        [  1,  85, 121],
        [  1,  85, 121],
        ...,
        [  0,  81, 118],
        [  0,  82, 117],
        [  0,  82, 116]],

       [[  1,  85, 121],
        [  1,  85, 121],
        [  1,  85, 121],
        ...,
        [  0,  81, 118],
        [  0,  82, 117],
        [  0,  82, 116]]], dtype=uint8)]"
Image_124.jpg,575,51,174,174,930,500,749,225,174,daskShared_local/images/Image_124.jpg,124,"[array([[[ 11, 149, 212],
        [ 11, 149, 211],
        [ 11, 149, 211],
        ...,
        [ 10, 146, 204],
        [ 10, 146, 204],
        [ 10, 146, 204]],

       [[ 11, 149, 212],
        [  9, 147, 210],
        [ 10, 148, 211],
        ...,
        [ 11, 147, 205],
        [ 11, 147, 205],
        [ 10, 146, 204]],

       [[ 10, 148, 211],
        [  8, 146, 209],
        [  9, 147, 210],
        ...,
        [ 11, 147, 205],
        [ 11, 147, 205],
        [ 10, 146, 204]],

       ...,

       [[235, 235, 235],
        [237, 237, 236],
        [224, 224, 222],
        ...,
        [  6, 134, 199],
        [  6, 134, 199],
        [  7, 135, 200]],

       [[234, 235, 235],
        [226, 227, 224],
        [211, 211, 208],
        ...,
        [  6, 134, 199],
        [  7, 135, 200],
        [  7, 135, 200]],

       [[225, 231, 230],
        [198, 201, 197],
        [182, 184, 179],
        ...,
        [  6, 134, 199],
        [  6, 134, 199],
        [  6, 134, 199]]], dtype=uint8)]"
Image_1240.jpg,322,255,135,144,1000,667,457,399,144,daskShared_local/images/Image_1240.jpg,1240,"[array([[[  2, 203, 225],
        [  1, 203, 226],
        [  1, 203, 227],
        ...,
        [105, 216, 238],
        [129, 220, 239],
        [142, 221, 240]],

       [[  1, 206, 225],
        [  1, 205, 226],
        [  2, 205, 227],
        ...,
        [107, 216, 238],
        [121, 218, 238],
        [123, 219, 238]],

       [[  1, 207, 225],
        [  1, 206, 226],
        [  2, 206, 227],
        ...,
        [106, 216, 238],
        [107, 217, 237],
        [103, 216, 236]],

       ...,

       [[167, 104,  19],
        [170, 111,  13],
        [160, 105,   6],
        ...,
        [ 16,  75, 131],
        [ 21,  70, 121],
        [ 26,  68, 113]],

       [[157,  97,  21],
        [166, 109,  20],
        [172, 117,  16],
        ...,
        [ 10,  64, 116],
        [ 14,  61, 106],
        [ 21,  61,  99]],

       [[129,  74,  15],
        [148,  92,  24],
        [170, 113,  24],
        ...,
        [ 12,  65, 110],
        [  8,  58,  99],
        [  8,  56,  93]]], dtype=uint8)]"
Image_1241.jpg,580,46,168,169,930,500,748,215,169,daskShared_local/images/Image_1241.jpg,1241,"[array([[[ 10, 148, 211],
        [ 12, 150, 213],
        [ 14, 152, 215],
        ...,
        [ 10, 148, 210],
        [  9, 147, 209],
        [  8, 146, 208]],

       [[ 12, 150, 213],
        [ 15, 153, 216],
        [ 15, 153, 216],
        ...,
        [  9, 147, 209],
        [  7, 145, 207],
        [  6, 144, 206]],

       [[ 10, 148, 209],
        [ 11, 150, 210],
        [ 11, 150, 210],
        ...,
        [  7, 144, 204],
        [  7, 144, 203],
        [  7, 144, 204]],

       ...,

       [[238, 238, 238],
        [233, 233, 233],
        [225, 225, 225],
        ...,
        [  7, 136, 201],
        [  6, 135, 200],
        [  6, 135, 200]],

       [[230, 230, 230],
        [228, 228, 228],
        [223, 223, 223],
        ...,
        [  8, 137, 202],
        [  7, 136, 201],
        [  7, 136, 201]],

       [[226, 226, 226],
        [224, 224, 224],
        [221, 221, 221],
        ...,
        [  8, 137, 202],
        [  8, 137, 202],
        [  8, 137, 202]]], dtype=uint8)]"
Image_1242.jpg,1279,628,343,269,2106,1578,1622,897,343,daskShared_local/images/Image_1242.jpg,1242,"[array([[[ 25, 146, 146],
        [ 27, 147, 149],
        [ 21, 145, 144],
        ...,
        [ 15, 144, 140],
        [ 18, 144, 142],
        [ 20, 143, 141]],

       [[ 25, 145, 144],
        [ 24, 148, 146],
        [ 25, 150, 148],
        ...,
        [ 22, 147, 148],
        [ 20, 143, 145],
        [ 21, 142, 143]],

       [[ 22, 146, 143],
        [ 21, 144, 142],
        [ 25, 146, 145],
        ...,
        [ 15, 147, 149],
        [ 10, 144, 144],
        [ 13, 144, 147]],

       ...,

       [[ 34, 154, 150],
        [ 35, 155, 151],
        [ 31, 154, 149],
        ...,
        [ 34, 163, 155],
        [ 32, 162, 154],
        [ 35, 162, 155]],

       [[ 36, 156, 149],
        [ 39, 158, 152],
        [ 34, 154, 148],
        ...,
        [ 29, 165, 155],
        [ 30, 164, 155],
        [ 28, 162, 155]],

       [[ 41, 157, 153],
        [ 39, 157, 153],
        [ 35, 153, 147],
        ...,
        [ 30, 162, 157],
        [ 31, 162, 156],
        [ 30, 161, 155]]], dtype=uint8)]"
Image_1243.jpg,953,266,208,163,1600,1280,1161,429,208,daskShared_local/images/Image_1243.jpg,1243,"[array([[[  0, 110, 127],
        [  0, 100, 119],
        [  1, 106, 127],
        ...,
        [ 19, 157, 124],
        [ 12, 148, 116],
        [  8, 139, 108]],

       [[  4, 132, 142],
        [  1, 129, 138],
        [  9, 134, 148],
        ...,
        [ 18, 157, 124],
        [ 12, 150, 117],
        [  1, 133, 102]],

       [[  5, 147, 141],
        [  4, 140, 135],
        [  6, 141, 140],
        ...,
        [ 20, 161, 126],
        [ 19, 157, 124],
        [  9, 142, 111]],

       ...,

       [[119,  52,  42],
        [141,  87,  46],
        [179, 137,  66],
        ...,
        [ 39, 119, 113],
        [ 49, 133, 106],
        [ 51, 142, 101]],

       [[101,  38,  32],
        [129,  72,  32],
        [185, 139,  67],
        ...,
        [ 39, 119, 113],
        [ 48, 133, 106],
        [ 52, 140, 100]],

       [[ 87,  27,  34],
        [ 92,  33,   6],
        [169, 118,  55],
        ...,
        [ 42, 125, 117],
        [ 56, 140, 115],
        [ 54, 140, 101]]], dtype=uint8)]"
Image_1244.jpg,367,183,481,400,1280,854,848,583,481,daskShared_local/images/Image_1244.jpg,1244,"[array([[[116, 149, 178],
        [118, 150, 179],
        [118, 150, 179],
        ...,
        [ 20, 210, 241],
        [ 20, 211, 246],
        [ 18, 210, 246]],

       [[118, 150, 179],
        [116, 147, 176],
        [115, 146, 175],
        ...,
        [ 20, 211, 240],
        [ 20, 210, 244],
        [ 19, 210, 247]],

       [[121, 153, 182],
        [117, 148, 177],
        [115, 146, 175],
        ...,
        [ 17, 210, 241],
        [ 19, 209, 243],
        [ 19, 209, 245]],

       ...,

       [[ 69, 181, 208],
        [ 59, 179, 205],
        [ 47, 175, 205],
        ...,
        [ 15, 196, 241],
        [ 11, 192, 237],
        [  9, 190, 235]],

       [[ 52, 175, 206],
        [ 46, 173, 203],
        [ 39, 170, 202],
        ...,
        [ 15, 196, 241],
        [ 12, 193, 238],
        [ 11, 192, 237]],

       [[ 32, 164, 196],
        [ 32, 166, 198],
        [ 35, 169, 204],
        ...,
        [ 16, 197, 242],
        [ 15, 196, 241],
        [ 15, 196, 241]]], dtype=uint8)]"
Image_1245.jpg,54,118,223,178,600,350,277,296,223,daskShared_local/images/Image_1245.jpg,1245,"[array([[[ 33,  64,  49],
        [ 35,  65,  51],
        [ 38,  65,  55],
        ...,
        [ 66,  84, 104],
        [ 62,  78,  94],
        [ 53,  68,  83]],

       [[ 32,  63,  47],
        [ 33,  64,  48],
        [ 36,  64,  52],
        ...,
        [ 97, 112, 122],
        [ 95, 110, 117],
        [ 99, 114, 119]],

       [[ 31,  62,  43],
        [ 32,  62,  44],
        [ 34,  62,  48],
        ...,
        [ 65,  76,  99],
        [ 52,  64,  84],
        [ 52,  63,  82]],

       ...,

       [[150, 136, 109],
        [156, 140, 109],
        [158, 143, 112],
        ...,
        [167, 152, 125],
        [169, 155, 130],
        [161, 147, 123]],

       [[157, 146, 121],
        [163, 153, 124],
        [162, 155, 132],
        ...,
        [162, 150, 125],
        [173, 165, 141],
        [165, 158, 134]],

       [[167, 159, 133],
        [167, 157, 129],
        [165, 156, 129],
        ...,
        [163, 154, 128],
        [166, 159, 135],
        [162, 157, 132]]], dtype=uint8)]"
Image_1246.jpg,129,89,158,125,500,333,287,214,158,daskShared_local/images/Image_1246.jpg,1246,"[array([[[ 27,  42,  61],
        [ 27,  42,  61],
        [ 27,  42,  61],
        ...,
        [ 26,  44,  66],
        [ 26,  44,  66],
        [ 25,  43,  65]],

       [[ 27,  42,  61],
        [ 27,  42,  61],
        [ 27,  42,  61],
        ...,
        [ 26,  44,  66],
        [ 26,  44,  66],
        [ 25,  43,  65]],

       [[ 27,  42,  61],
        [ 27,  42,  61],
        [ 27,  42,  61],
        ...,
        [ 26,  44,  66],
        [ 26,  44,  66],
        [ 25,  43,  65]],

       ...,

       [[ 24,  42,  56],
        [ 25,  43,  57],
        [ 25,  43,  57],
        ...,
        [116, 133, 125],
        [115, 132, 124],
        [114, 131, 123]],

       [[ 24,  42,  56],
        [ 25,  43,  57],
        [ 25,  43,  57],
        ...,
        [117, 134, 126],
        [116, 133, 125],
        [115, 132, 124]],

       [[ 25,  43,  57],
        [ 25,  43,  57],
        [ 25,  43,  57],
        ...,
        [119, 136, 128],
        [117, 134, 126],
        [116, 133, 125]]], dtype=uint8)]"
Image_1247.jpg,389,182,100,48,800,600,489,230,100,daskShared_local/images/Image_1247.jpg,1247,"[array([[[ 62,  88, 116],
        [ 62,  88, 116],
        [ 64,  90, 123],
        ...,
        [104, 111, 181],
        [ 97, 113, 158],
        [ 97, 113, 158]],

       [[ 62,  88, 116],
        [ 62,  88, 116],
        [ 64,  90, 123],
        ...,
        [104, 111, 181],
        [ 97, 113, 158],
        [ 97, 113, 158]],

       [[ 62,  87, 117],
        [ 62,  87, 117],
        [ 63,  90, 124],
        ...,
        [ 98, 113, 172],
        [ 91, 112, 164],
        [ 91, 112, 164]],

       ...,

       [[108, 113, 117],
        [108, 113, 117],
        [110, 116, 118],
        ...,
        [ 24, 133, 248],
        [ 24, 133, 251],
        [ 24, 133, 251]],

       [[109, 119, 112],
        [109, 119, 112],
        [112, 122, 113],
        ...,
        [ 26, 134, 249],
        [ 25, 133, 251],
        [ 25, 133, 251]],

       [[109, 119, 112],
        [109, 119, 112],
        [112, 122, 113],
        ...,
        [ 26, 134, 249],
        [ 25, 133, 251],
        [ 25, 133, 251]]], dtype=uint8)]"
Image_1248.jpg,887,508,209,216,1920,1200,1096,724,216,daskShared_local/images/Image_1248.jpg,1248,"[array([[[  1, 109, 111],
        [  2, 110, 112],
        [  1, 109, 111],
        ...,
        [  0, 121, 122],
        [  2, 124, 123],
        [  2, 126, 124]],

       [[  0, 110, 111],
        [  1, 111, 112],
        [  0, 110, 109],
        ...,
        [  3, 124, 125],
        [  1, 124, 123],
        [  0, 124, 122]],

       [[  0, 112, 112],
        [  0, 113, 111],
        [  1, 114, 112],
        ...,
        [  4, 125, 126],
        [  1, 125, 123],
        [  0, 124, 122]],

       ...,

       [[112,  98,  63],
        [127, 111,  74],
        [128, 110,  72],
        ...,
        [122, 103,  75],
        [ 68,  45,  20],
        [ 63,  36,  10]],

       [[112,  98,  63],
        [140, 122,  86],
        [132, 114,  77],
        ...,
        [220, 197, 168],
        [118,  93,  68],
        [ 61,  32,   6]],

       [[104,  88,  55],
        [132, 114,  80],
        [132, 114,  77],
        ...,
        [254, 233, 203],
        [245, 217, 190],
        [170, 140, 114]]], dtype=uint8)]"
Image_1249.jpg,162,7,110,106,498,272,272,113,110,daskShared_local/images/Image_1249.jpg,1249,"[array([[[  2,  29,  60],
        [  2,  30,  60],
        [  3,  31,  61],
        ...,
        [  0,  32,  55],
        [  0,  32,  55],
        [  0,  32,  55]],

       [[  2,  29,  60],
        [  2,  30,  60],
        [  3,  30,  61],
        ...,
        [  0,  32,  55],
        [  0,  32,  55],
        [  0,  32,  55]],

       [[  0,  29,  61],
        [  1,  29,  61],
        [  1,  30,  62],
        ...,
        [  0,  33,  55],
        [  0,  33,  55],
        [  0,  33,  55]],

       ...,

       [[126, 137, 134],
        [127, 138, 134],
        [130, 140, 137],
        ...,
        [ 96, 100, 101],
        [ 78,  83,  84],
        [ 75,  79,  80]],

       [[129, 141, 140],
        [127, 140, 138],
        [120, 132, 129],
        ...,
        [ 94,  97,  87],
        [ 93,  95,  85],
        [ 93,  95,  84]],

       [[129, 142, 141],
        [127, 140, 139],
        [118, 130, 128],
        ...,
        [ 94,  96,  84],
        [ 96,  98,  85],
        [ 96,  98,  85]]], dtype=uint8)]"
Image_125.jpg,1306,635,312,264,2106,1578,1618,899,312,daskShared_local/images/Image_125.jpg,125,"[array([[[ 25, 146, 149],
        [ 27, 145, 146],
        [ 25, 143, 142],
        ...,
        [ 18, 143, 142],
        [ 18, 144, 142],
        [ 17, 145, 146]],

       [[ 21, 145, 144],
        [ 25, 144, 144],
        [ 25, 144, 143],
        ...,
        [ 17, 145, 147],
        [ 18, 145, 145],
        [ 17, 145, 144]],

       [[ 26, 146, 148],
        [ 25, 144, 143],
        [ 27, 145, 144],
        ...,
        [ 18, 142, 143],
        [ 19, 143, 144],
        [ 20, 145, 147]],

       ...,

       [[ 28, 152, 151],
        [ 29, 151, 148],
        [ 32, 154, 150],
        ...,
        [ 27, 162, 156],
        [ 28, 163, 156],
        [ 30, 163, 158]],

       [[ 27, 152, 147],
        [ 32, 156, 151],
        [ 36, 159, 153],
        ...,
        [ 30, 163, 154],
        [ 33, 165, 157],
        [ 33, 164, 156]],

       [[ 34, 153, 147],
        [ 35, 155, 148],
        [ 34, 153, 147],
        ...,
        [ 30, 164, 156],
        [ 33, 166, 157],
        [ 34, 165, 156]]], dtype=uint8)]"
Image_1250.JPG,547,383,472,345,1600,1467,1019,728,472,daskShared_local/images/Image_1250.JPG,1250,"[array([[[ 54,  64,  65],
        [ 51,  59,  61],
        [ 49,  57,  59],
        ...,
        [132, 141, 105],
        [115, 125,  94],
        [ 94, 101,  78]],

       [[ 50,  60,  62],
        [ 55,  64,  65],
        [ 52,  60,  63],
        ...,
        [123, 131, 103],
        [121, 131, 106],
        [ 83,  91,  70]],

       [[ 45,  56,  58],
        [ 48,  58,  59],
        [ 53,  63,  65],
        ...,
        [ 93, 101,  83],
        [117, 127, 109],
        [ 79,  89,  72]],

       ...,

       [[217, 225, 177],
        [218, 228, 178],
        [217, 227, 176],
        ...,
        [232, 238, 226],
        [230, 234, 218],
        [225, 228, 209]],

       [[230, 239, 188],
        [232, 242, 191],
        [231, 241, 189],
        ...,
        [219, 223, 204],
        [215, 217, 194],
        [212, 213, 187]],

       [[230, 240, 187],
        [229, 239, 187],
        [228, 238, 185],
        ...,
        [218, 219, 196],
        [216, 215, 189],
        [208, 206, 178]]], dtype=uint8)]"
Image_1251.jpg,672,276,294,342,1600,900,966,618,342,daskShared_local/images/Image_1251.jpg,1251,"[array([[[  1, 117, 202],
        [  1, 117, 202],
        [  1, 117, 202],
        ...,
        [  0, 121, 202],
        [  0, 121, 202],
        [  0, 120, 201]],

       [[  1, 117, 202],
        [  1, 117, 202],
        [  1, 117, 202],
        ...,
        [  0, 121, 202],
        [  0, 121, 202],
        [  0, 120, 201]],

       [[  0, 116, 199],
        [  0, 116, 199],
        [  0, 116, 199],
        ...,
        [  0, 121, 202],
        [  0, 121, 202],
        [  0, 121, 202]],

       ...,

       [[226, 222, 180],
        [223, 219, 173],
        [219, 218, 169],
        ...,
        [149, 150, 113],
        [ 87,  92,  51],
        [140, 147, 105]],

       [[214, 213, 157],
        [198, 197, 140],
        [191, 193, 131],
        ...,
        [121, 122,  89],
        [104, 108,  69],
        [101, 106,  68]],

       [[171, 172, 105],
        [174, 177, 109],
        [177, 182, 109],
        ...,
        [ 84,  86,  58],
        [129, 132, 102],
        [120, 123,  93]]], dtype=uint8)]"
Image_1252.jpg,72,73,95,90,300,260,167,163,95,daskShared_local/images/Image_1252.jpg,1252,"[array([[[  1, 228, 253],
        [  1, 228, 253],
        [  3, 228, 254],
        ...,
        [ 61, 217, 242],
        [ 61, 218, 243],
        [ 61, 218, 243]],

       [[  1, 228, 253],
        [  1, 228, 253],
        [  3, 228, 254],
        ...,
        [ 52, 216, 242],
        [ 52, 217, 243],
        [ 52, 217, 243]],

       [[  2, 229, 254],
        [  2, 229, 254],
        [  2, 228, 253],
        ...,
        [160, 230, 249],
        [160, 231, 248],
        [160, 231, 248]],

       ...,

       [[  1, 192, 239],
        [  1, 192, 239],
        [  1, 192, 238],
        ...,
        [ 27, 120,  70],
        [ 35, 135,  89],
        [ 34, 134,  88]],

       [[  2, 193, 240],
        [  2, 193, 240],
        [  2, 192, 240],
        ...,
        [ 49, 166, 134],
        [ 41, 160, 131],
        [ 42, 160, 131]],

       [[  2, 192, 240],
        [  2, 193, 240],
        [  2, 192, 239],
        ...,
        [ 47, 162, 129],
        [ 40, 158, 127],
        [ 41, 158, 127]]], dtype=uint8)]"
Image_1253.jpg,326,269,93,76,800,600,419,345,93,daskShared_local/images/Image_1253.jpg,1253,"[array([[[  0, 158, 255],
        [  0, 158, 255],
        [  0, 158, 255],
        ...,
        [  1, 162, 254],
        [  1, 163, 254],
        [  1, 163, 254]],

       [[  0, 158, 255],
        [  0, 158, 255],
        [  1, 159, 255],
        ...,
        [  1, 162, 253],
        [  1, 163, 254],
        [  1, 163, 254]],

       [[  0, 158, 255],
        [  0, 158, 255],
        [  0, 158, 255],
        ...,
        [  2, 162, 254],
        [  2, 163, 254],
        [  2, 163, 254]],

       ...,

       [[152, 194, 180],
        [150, 192, 178],
        [166, 208, 192],
        ...,
        [ 40,  46,  36],
        [ 40,  45,  35],
        [ 40,  46,  35]],

       [[149, 191, 167],
        [147, 189, 165],
        [161, 204, 179],
        ...,
        [ 42,  47,  39],
        [ 42,  48,  38],
        [ 42,  48,  38]],

       [[149, 192, 169],
        [147, 190, 167],
        [162, 204, 181],
        ...,
        [ 42,  47,  39],
        [ 42,  48,  38],
        [ 42,  48,  38]]], dtype=uint8)]"
Image_1254.jpg,297,223,315,298,1000,664,612,521,315,daskShared_local/images/Image_1254.jpg,1254,"[array([[[183, 187, 190],
        [182, 186, 189],
        [181, 185, 188],
        ...,
        [175, 151, 145],
        [187, 163, 153],
        [209, 186, 175]],

       [[184, 188, 191],
        [183, 187, 190],
        [182, 186, 189],
        ...,
        [165, 143, 138],
        [173, 150, 141],
        [190, 166, 156]],

       [[189, 193, 196],
        [188, 192, 195],
        [188, 192, 195],
        ...,
        [152, 134, 131],
        [159, 137, 132],
        [177, 154, 145]],

       ...,

       [[141, 140, 141],
        [139, 138, 137],
        [138, 138, 135],
        ...,
        [165, 159, 150],
        [167, 158, 150],
        [165, 157, 148]],

       [[160, 159, 163],
        [153, 152, 153],
        [151, 150, 150],
        ...,
        [166, 159, 149],
        [169, 159, 148],
        [168, 157, 147]],

       [[146, 142, 138],
        [143, 138, 133],
        [143, 136, 131],
        ...,
        [172, 161, 147],
        [174, 161, 144],
        [173, 160, 142]]], dtype=uint8)]"
Image_1255.jpg,312,150,184,195,1200,735,496,345,195,daskShared_local/images/Image_1255.jpg,1255,"[array([[[ 84, 160, 186],
        [ 84, 160, 186],
        [ 85, 161, 187],
        ...,
        [ 72,  66,  76],
        [ 66,  64,  77],
        [ 60,  63,  78]],

       [[ 95, 169, 194],
        [ 97, 171, 196],
        [ 94, 168, 193],
        ...,
        [ 89,  77,  87],
        [ 72,  64,  77],
        [ 61,  60,  74]],

       [[107, 180, 204],
        [106, 178, 202],
        [106, 178, 202],
        ...,
        [ 93,  81,  91],
        [ 63,  57,  71],
        [ 44,  46,  61]],

       ...,

       [[142, 176, 186],
        [141, 173, 184],
        [142, 170, 182],
        ...,
        [ 37,   8,   4],
        [ 61,  34,  30],
        [ 61,  32,  28]],

       [[141, 177, 189],
        [142, 174, 185],
        [142, 172, 183],
        ...,
        [ 48,  19,  14],
        [ 47,  22,  18],
        [ 38,  12,  11]],

       [[138, 176, 185],
        [141, 175, 184],
        [140, 173, 180],
        ...,
        [ 59,  35,  31],
        [ 41,  20,  19],
        [ 17,   0,   0]]], dtype=uint8)]"
Image_1256.jpg,293,205,836,662,1500,1125,1129,867,836,daskShared_local/images/Image_1256.jpg,1256,"[array([[[ 95, 169, 170],
        [ 96, 168, 170],
        [ 97, 168, 172],
        ...,
        [114, 136, 142],
        [115, 136, 141],
        [117, 137, 141]],

       [[ 92, 169, 169],
        [ 94, 169, 172],
        [ 95, 169, 171],
        ...,
        [112, 130, 142],
        [114, 132, 138],
        [116, 135, 143]],

       [[ 95, 169, 168],
        [ 95, 169, 168],
        [ 93, 169, 171],
        ...,
        [110, 128, 139],
        [111, 130, 140],
        [116, 135, 146]],

       ...,

       [[ 92, 187, 232],
        [ 90, 185, 231],
        [ 90, 183, 228],
        ...,
        [ 91, 136, 142],
        [ 91, 136, 140],
        [ 89, 135, 142]],

       [[ 93, 189, 233],
        [ 91, 187, 233],
        [ 91, 184, 232],
        ...,
        [ 89, 137, 142],
        [ 88, 136, 139],
        [ 89, 135, 139]],

       [[ 94, 190, 238],
        [ 93, 189, 236],
        [ 93, 188, 235],
        ...,
        [ 91, 136, 139],
        [ 88, 134, 140],
        [ 88, 133, 139]]], dtype=uint8)]"
Image_1257.jpg,422,192,214,205,1024,683,636,397,214,daskShared_local/images/Image_1257.jpg,1257,"[array([[[132, 212, 202],
        [140, 210, 195],
        [147, 208, 185],
        ...,
        [159, 125,  96],
        [219, 188, 158],
        [221, 189, 148]],

       [[132, 210, 195],
        [139, 210, 186],
        [152, 209, 179],
        ...,
        [202, 168, 108],
        [220, 187, 133],
        [222, 189, 134]],

       [[127, 206, 186],
        [137, 206, 177],
        [144, 201, 164],
        ...,
        [236, 201, 109],
        [238, 204, 127],
        [191, 156,  86]],

       ...,

       [[  3, 198, 204],
        [  4, 197, 204],
        [  5, 196, 204],
        ...,
        [  1, 141, 158],
        [  3, 140, 158],
        [  3, 138, 157]],

       [[  3, 196, 201],
        [  5, 197, 202],
        [  9, 198, 204],
        ...,
        [  1, 145, 155],
        [  1, 143, 154],
        [  1, 142, 153]],

       [[  4, 196, 201],
        [  8, 196, 202],
        [ 12, 199, 206],
        ...,
        [  2, 146, 156],
        [  1, 145, 154],
        [  1, 143, 153]]], dtype=uint8)]"
Image_1258.jpg,353,96,213,195,800,600,566,291,213,daskShared_local/images/Image_1258.jpg,1258,"[array([[[ 40, 120, 121],
        [ 18,  98,  99],
        [ 22, 100, 102],
        ...,
        [ 44, 107,  99],
        [ 53, 114, 106],
        [ 46, 108,  97]],

       [[ 29, 110, 113],
        [ 25, 104, 108],
        [ 23, 102, 106],
        ...,
        [ 53, 112, 106],
        [ 53, 113, 103],
        [ 48, 108,  96]],

       [[ 32, 113, 116],
        [ 28, 107, 111],
        [ 27, 105, 110],
        ...,
        [ 62, 123, 115],
        [ 63, 123, 111],
        [ 63, 124, 110]],

       ...,

       [[229, 128,  24],
        [226, 127,  26],
        [226, 126,  29],
        ...,
        [ 31,  13,  28],
        [ 21,   7,  20],
        [ 28,  16,  25]],

       [[225, 124,  21],
        [224, 124,  23],
        [224, 124,  27],
        ...,
        [ 37,  18,  34],
        [ 19,   4,  18],
        [ 26,  16,  27]],

       [[220, 121,  19],
        [220, 120,  22],
        [222, 122,  29],
        ...,
        [ 25,   6,  22],
        [ 17,   2,  16],
        [ 17,   5,  15]]], dtype=uint8)]"
Image_1259.jpg,401,345,327,257,1536,1024,728,602,327,daskShared_local/images/Image_1259.jpg,1259,"[array([[[ 17, 136, 249],
        [ 15, 135, 247],
        [ 12, 132, 244],
        ...,
        [ 13, 174, 245],
        [ 14, 175, 246],
        [ 11, 172, 243]],

       [[ 18, 135, 249],
        [ 21, 141, 254],
        [ 17, 137, 249],
        ...,
        [ 13, 174, 247],
        [ 15, 175, 249],
        [ 13, 172, 246]],

       [[ 12, 132, 244],
        [ 12, 132, 244],
        [ 13, 133, 245],
        ...,
        [ 13, 173, 247],
        [ 11, 171, 247],
        [ 12, 169, 246]],

       ...,

       [[  9,  60, 205],
        [  9,  60, 205],
        [  9,  60, 205],
        ...,
        [ 21,  34,  22],
        [ 33,  39,  27],
        [ 28,  29,  23]],

       [[  9,  60, 205],
        [  9,  60, 205],
        [  9,  60, 205],
        ...,
        [ 38,  35,  34],
        [ 27,  34,  27],
        [ 24,  31,  23]],

       [[  8,  59, 202],
        [  8,  59, 202],
        [  8,  59, 202],
        ...,
        [ 30,  22,  22],
        [ 25,  32,  29],
        [ 20,  35,  25]]], dtype=uint8)]"
Image_126.jpg,958,255,212,174,1600,1280,1170,429,212,daskShared_local/images/Image_126.jpg,126,"[array([[[ 19,  95,  57],
        [ 20,  97,  56],
        [  2,  80,  50],
        ...,
        [ 36, 154, 119],
        [ 22, 151, 133],
        [ 23, 154, 138]],

       [[ 10,  84,  51],
        [ 13,  87,  52],
        [  8,  81,  57],
        ...,
        [ 28, 152, 123],
        [ 21, 153, 137],
        [ 19, 151, 135]],

       [[ 13,  83,  55],
        [ 16,  86,  56],
        [ 21,  91,  73],
        ...,
        [ 22, 151, 126],
        [ 25, 159, 143],
        [ 24, 156, 142]],

       ...,

       [[126,  85,  87],
        [123,  68,  92],
        [ 87,  26,  57],
        ...,
        [ 46, 173, 120],
        [ 53, 186, 129],
        [ 52, 188, 132]],

       [[128,  87,  89],
        [127,  63, 105],
        [103,  36,  88],
        ...,
        [ 43, 175, 118],
        [ 44, 183, 123],
        [ 45, 186, 128]],

       [[129,  87,  90],
        [141,  72, 126],
        [123,  55, 117],
        ...,
        [ 41, 174, 117],
        [ 41, 183, 120],
        [ 38, 182, 123]]], dtype=uint8)]"
Image_1260.jpg,382,129,235,206,869,574,617,335,235,daskShared_local/images/Image_1260.jpg,1260,"[array([[[  4, 151, 219],
        [  7, 155, 223],
        [  4, 153, 221],
        ...,
        [ 89, 169, 242],
        [ 89, 170, 242],
        [ 81, 168, 237]],

       [[ 44, 159, 228],
        [ 42, 159, 229],
        [ 45, 159, 231],
        ...,
        [ 89, 172, 246],
        [ 83, 172, 245],
        [ 80, 167, 240]],

       [[ 83, 165, 238],
        [ 83, 165, 239],
        [ 86, 169, 243],
        ...,
        [ 79, 168, 246],
        [ 66, 165, 242],
        [ 45, 157, 228]],

       ...,

       [[  4,  22,  15],
        [  2,   8,   4],
        [  5,   3,   1],
        ...,
        [  2, 104, 179],
        [  2, 104, 179],
        [  2, 105, 180]],

       [[  3,  14,   8],
        [  9,  30,  21],
        [  7,  34,  22],
        ...,
        [  2, 104, 179],
        [  2, 104, 179],
        [  1, 104, 179]],

       [[  5,  78,  54],
        [ 20, 101,  73],
        [ 16,  93,  65],
        ...,
        [  2, 104, 179],
        [  2, 104, 179],
        [  1, 104, 179]]], dtype=uint8)]"
Image_1261.jpg,279,148,222,206,900,600,501,354,222,daskShared_local/images/Image_1261.jpg,1261,"[array([[[ 81, 178, 210],
        [ 78, 177, 208],
        [ 81, 180, 211],
        ...,
        [ 77, 166, 210],
        [ 77, 166, 210],
        [ 77, 166, 210]],

       [[ 80, 177, 209],
        [ 77, 176, 207],
        [ 79, 178, 209],
        ...,
        [ 78, 167, 211],
        [ 78, 167, 211],
        [ 78, 167, 211]],

       [[ 79, 176, 208],
        [ 78, 177, 208],
        [ 78, 177, 208],
        ...,
        [ 78, 167, 211],
        [ 78, 167, 211],
        [ 78, 167, 211]],

       ...,

       [[ 52, 111, 141],
        [ 53, 117, 145],
        [ 55, 120, 148],
        ...,
        [ 19,  69,  49],
        [ 13,  60,  42],
        [ 36,  81,  65]],

       [[ 50, 111, 139],
        [ 50, 115, 143],
        [ 52, 117, 145],
        ...,
        [  2,  46,  26],
        [ 40,  89,  73],
        [ 65, 119, 102]],

       [[ 50, 111, 139],
        [ 48, 113, 141],
        [ 51, 116, 144],
        ...,
        [ 47,  97,  77],
        [ 41,  94,  76],
        [ 36,  91,  73]]], dtype=uint8)]"
Image_1262.jpg,596,216,413,453,1600,1070,1009,669,453,daskShared_local/images/Image_1262.jpg,1262,"[array([[[ 22,  75, 145],
        [ 22,  75, 145],
        [ 22,  75, 145],
        ...,
        [ 28,  69, 133],
        [ 30,  68, 133],
        [ 30,  68, 133]],

       [[ 22,  75, 145],
        [ 22,  75, 145],
        [ 22,  75, 145],
        ...,
        [ 28,  69, 133],
        [ 30,  68, 133],
        [ 30,  68, 133]],

       [[ 22,  75, 145],
        [ 22,  75, 145],
        [ 22,  75, 145],
        ...,
        [ 28,  69, 133],
        [ 30,  68, 133],
        [ 30,  68, 133]],

       ...,

       [[145, 117,  66],
        [136, 104,  67],
        [156, 121,  93],
        ...,
        [227, 187, 140],
        [246, 206, 181],
        [231, 194, 170]],

       [[150, 122,  75],
        [140, 111,  68],
        [146, 113,  72],
        ...,
        [245, 212, 165],
        [240, 199, 157],
        [243, 204, 164]],

       [[147, 115,  79],
        [147, 115,  67],
        [155, 123,  59],
        ...,
        [249, 224, 191],
        [252, 218, 166],
        [254, 222, 174]]], dtype=uint8)]"
Image_1263.jpeg,644,147,253,234,1200,800,897,381,253,daskShared_local/images/Image_1263.jpeg,1263,"[array([[[156, 204, 218],
        [161, 209, 222],
        [163, 211, 223],
        ...,
        [181, 214, 229],
        [183, 216, 231],
        [178, 211, 228]],

       [[161, 207, 221],
        [164, 209, 222],
        [165, 209, 222],
        ...,
        [181, 214, 230],
        [182, 215, 231],
        [177, 210, 227]],

       [[166, 209, 222],
        [167, 207, 221],
        [164, 204, 217],
        ...,
        [181, 214, 231],
        [181, 214, 231],
        [179, 212, 229]],

       ...,

       [[157, 113,   7],
        [144, 101,   5],
        [154, 111,  28],
        ...,
        [227, 184, 170],
        [236, 188, 166],
        [215, 172, 154]],

       [[190, 146,  41],
        [119,  74,   0],
        [118,  73,   2],
        ...,
        [214, 175, 162],
        [237, 191, 174],
        [224, 181, 167]],

       [[186, 141,  48],
        [104,  58,   0],
        [142,  97,  24],
        ...,
        [218, 183, 166],
        [224, 184, 167],
        [221, 179, 168]]], dtype=uint8)]"
Image_1264.jpg,293,167,216,207,1000,664,509,374,216,daskShared_local/images/Image_1264.jpg,1264,"[array([[[  1,  79, 145],
        [  0,  77, 145],
        [  0,  78, 145],
        ...,
        [  1,  94, 137],
        [  1,  95, 144],
        [  0,  98, 158]],

       [[  1,  79, 145],
        [  0,  78, 145],
        [  0,  79, 145],
        ...,
        [  0,  92, 137],
        [  1,  93, 138],
        [  1,  97, 156]],

       [[  0,  78, 144],
        [  0,  78, 146],
        [  0,  78, 145],
        ...,
        [  1,  90, 134],
        [  0,  91, 128],
        [  0,  96, 148]],

       ...,

       [[ 40,  46,  41],
        [ 36,  50,  39],
        [ 32,  41,  34],
        ...,
        [187, 181, 161],
        [205, 198, 175],
        [214, 210, 184]],

       [[ 40,  40,  36],
        [ 37,  43,  37],
        [ 39,  42,  35],
        ...,
        [190, 187, 172],
        [202, 195, 177],
        [209, 202, 182]],

       [[ 38,  35,  28],
        [ 33,  38,  33],
        [ 43,  47,  42],
        ...,
        [194, 195, 184],
        [202, 197, 181],
        [207, 202, 182]]], dtype=uint8)]"
Image_1265.jpg,675,643,410,279,2793,2090,1085,922,410,daskShared_local/images/Image_1265.jpg,1265,"[array([[[  5,  69, 195],
        [  5,  69, 195],
        [  5,  69, 195],
        ...,
        [  3,  67, 190],
        [  3,  67, 190],
        [  3,  67, 190]],

       [[  5,  69, 195],
        [  5,  69, 195],
        [  5,  69, 195],
        ...,
        [  3,  67, 190],
        [  3,  67, 190],
        [  3,  67, 190]],

       [[  5,  69, 195],
        [  5,  69, 195],
        [  5,  69, 195],
        ...,
        [  3,  67, 190],
        [  3,  67, 190],
        [  3,  67, 190]],

       ...,

       [[  3,  50, 154],
        [  3,  50, 154],
        [  3,  50, 154],
        ...,
        [109, 104,  60],
        [160, 151, 100],
        [158, 145,  90]],

       [[  3,  50, 154],
        [  3,  50, 154],
        [  3,  50, 154],
        ...,
        [ 88,  89,  51],
        [126, 122,  76],
        [133, 124,  72]],

       [[  3,  50, 154],
        [  3,  50, 154],
        [  3,  50, 154],
        ...,
        [ 80,  88,  53],
        [137, 138,  96],
        [133, 129,  79]]], dtype=uint8)]"
Image_1266.jpg,442,220,185,191,1200,630,627,411,191,daskShared_local/images/Image_1266.jpg,1266,"[array([[[ 27, 100, 169],
        [ 29, 102, 171],
        [ 28, 101, 170],
        ...,
        [ 34,  68,  65],
        [ 21,  51,  51],
        [ 23,  47,  49]],

       [[ 29, 102, 171],
        [ 31, 104, 173],
        [ 29, 104, 172],
        ...,
        [ 32,  64,  61],
        [ 28,  57,  55],
        [ 26,  47,  50]],

       [[ 33, 106, 175],
        [ 30, 103, 172],
        [ 29, 104, 172],
        ...,
        [ 64,  96,  93],
        [ 56,  82,  81],
        [ 45,  66,  69]],

       ...,

       [[ 40,  92, 113],
        [ 23,  74,  95],
        [ 30,  77, 100],
        ...,
        [ 25,  25,  27],
        [ 20,  21,  23],
        [ 15,  19,  20]],

       [[ 35,  87, 106],
        [ 23,  74,  95],
        [ 29,  77,  99],
        ...,
        [ 23,  25,  26],
        [ 23,  27,  28],
        [ 24,  30,  30]],

       [[ 49, 100, 119],
        [ 28,  79,  98],
        [ 32,  80, 102],
        ...,
        [ 31,  33,  32],
        [ 32,  38,  36],
        [ 36,  45,  42]]], dtype=uint8)]"
Image_1267.jpg,450,229,165,170,900,586,615,399,170,daskShared_local/images/Image_1267.jpg,1267,"[array([[[  1, 174, 208],
        [  1, 174, 208],
        [  1, 174, 208],
        ...,
        [102, 204, 226],
        [101, 203, 225],
        [101, 203, 225]],

       [[  1, 174, 208],
        [  1, 174, 208],
        [  1, 174, 208],
        ...,
        [102, 204, 226],
        [102, 204, 226],
        [102, 204, 226]],

       [[  1, 174, 208],
        [  1, 174, 208],
        [  1, 174, 208],
        ...,
        [102, 204, 226],
        [102, 204, 226],
        [102, 204, 226]],

       ...,

       [[  5,  82,  76],
        [  1,  84,  72],
        [  0,  72,  61],
        ...,
        [  1, 163, 209],
        [  1, 163, 209],
        [  1, 163, 209]],

       [[  2,  91,  81],
        [  2,  82,  72],
        [  4,  71,  63],
        ...,
        [  1, 163, 209],
        [  1, 163, 209],
        [  1, 163, 209]],

       [[  7, 105,  92],
        [  8,  86,  78],
        [ 16,  74,  70],
        ...,
        [  1, 163, 209],
        [  1, 163, 209],
        [  1, 163, 209]]], dtype=uint8)]"
Image_1268.jpg,421,133,229,226,1024,686,650,359,229,daskShared_local/images/Image_1268.jpg,1268,"[array([[[ 37, 189, 239],
        [ 37, 189, 239],
        [ 36, 189, 239],
        ...,
        [  0, 158, 218],
        [  1, 159, 219],
        [  1, 159, 220]],

       [[ 36, 188, 238],
        [ 36, 188, 238],
        [ 35, 188, 239],
        ...,
        [  0, 158, 218],
        [  2, 158, 219],
        [  2, 158, 219]],

       [[ 37, 189, 239],
        [ 37, 189, 239],
        [ 35, 189, 239],
        ...,
        [  0, 158, 219],
        [  2, 158, 219],
        [  2, 158, 219]],

       ...,

       [[229, 217, 206],
        [226, 215, 208],
        [211, 199, 197],
        ...,
        [  2, 115, 183],
        [  3, 115, 183],
        [  2, 113, 182]],

       [[219, 210, 201],
        [213, 204, 200],
        [204, 196, 196],
        ...,
        [  2, 115, 183],
        [  4, 115, 184],
        [  2, 113, 182]],

       [[203, 187, 177],
        [196, 183, 174],
        [227, 219, 216],
        ...,
        [  3, 115, 181],
        [  3, 114, 183],
        [  2, 113, 182]]], dtype=uint8)]"
Image_1269.jpg,1891,590,1211,1224,4752,3168,3102,1814,1224,daskShared_local/images/Image_1269.jpg,1269,"[array([[[ 68,  65,  42],
        [ 69,  66,  42],
        [ 70,  66,  40],
        ...,
        [ 55, 128, 150],
        [ 53, 127, 150],
        [ 52, 124, 149]],

       [[ 70,  65,  40],
        [ 70,  66,  42],
        [ 72,  69,  42],
        ...,
        [ 54, 126, 148],
        [ 53, 126, 149],
        [ 52, 124, 149]],

       [[ 68,  62,  35],
        [ 73,  67,  39],
        [ 74,  68,  39],
        ...,
        [ 53, 123, 148],
        [ 53, 123, 149],
        [ 53, 123, 148]],

       ...,

       [[ 16,  99, 141],
        [ 19, 100, 142],
        [ 18, 101, 142],
        ...,
        [113,  94,  64],
        [170, 160, 107],
        [192, 194, 153]],

       [[ 30, 111, 143],
        [ 35, 114, 145],
        [ 34, 115, 146],
        ...,
        [171, 160, 110],
        [199, 202, 156],
        [185, 193, 172]],

       [[ 48, 131, 153],
        [ 50, 134, 154],
        [ 51, 133, 154],
        ...,
        [200, 200, 159],
        [196, 202, 178],
        [166, 171, 170]]], dtype=uint8)]"
Image_127.jpg,347,182,492,432,1280,854,839,614,492,daskShared_local/images/Image_127.jpg,127,"[array([[[134, 157, 188],
        [133, 156, 187],
        [129, 158, 185],
        ...,
        [ 34, 202, 236],
        [ 21, 199, 232],
        [ 18, 202, 236]],

       [[131, 152, 183],
        [133, 155, 186],
        [129, 158, 184],
        ...,
        [ 56, 199, 228],
        [ 43, 198, 229],
        [ 27, 196, 228]],

       [[129, 148, 179],
        [131, 152, 183],
        [126, 155, 181],
        ...,
        [ 72, 193, 218],
        [ 61, 197, 225],
        [ 44, 199, 230]],

       ...,

       [[  8, 124, 178],
        [  7, 124, 178],
        [  9, 126, 176],
        ...,
        [ 10, 192, 238],
        [ 10, 187, 236],
        [ 10, 182, 233]],

       [[  8, 120, 174],
        [ 13, 124, 179],
        [ 10, 123, 179],
        ...,
        [ 13, 192, 240],
        [ 13, 190, 240],
        [ 12, 187, 238]],

       [[  8, 120, 173],
        [ 12, 122, 177],
        [ 11, 123, 181],
        ...,
        [  8, 187, 236],
        [  7, 187, 236],
        [  8, 186, 236]]], dtype=uint8)]"
Image_1270.jpg,710,408,424,355,2119,1414,1134,763,424,daskShared_local/images/Image_1270.jpg,1270,"[array([[[105, 165, 195],
        [105, 165, 195],
        [106, 166, 195],
        ...,
        [ 86, 151, 179],
        [ 97, 162, 190],
        [ 89, 153, 181]],

       [[100, 159, 189],
        [100, 159, 189],
        [100, 158, 188],
        ...,
        [ 83, 147, 175],
        [ 86, 150, 178],
        [ 83, 147, 175]],

       [[102, 159, 189],
        [100, 157, 187],
        [ 96, 152, 182],
        ...,
        [ 88, 152, 180],
        [ 85, 148, 176],
        [ 86, 147, 176]],

       ...,

       [[ 86, 174, 198],
        [ 88, 176, 200],
        [ 87, 175, 199],
        ...,
        [120, 104,  82],
        [107,  89,  67],
        [115,  94,  73]],

       [[ 86, 174, 198],
        [ 87, 175, 199],
        [ 85, 173, 197],
        ...,
        [123, 109,  88],
        [121, 104,  85],
        [125, 108,  88]],

       [[ 88, 176, 200],
        [ 86, 174, 198],
        [ 85, 173, 197],
        ...,
        [125, 110,  91],
        [134, 119, 100],
        [136, 120, 101]]], dtype=uint8)]"
Image_1271.png,244,33,82,81,589,295,326,114,82,daskShared_local/images/Image_1271.png,1271,"[array([[[  0, 167, 184],
        [  0, 167, 182],
        [  0, 167, 187],
        ...,
        [  0, 169, 192],
        [  0, 170, 194],
        [  0, 170, 193]],

       [[  0, 167, 185],
        [  0, 167, 183],
        [  0, 167, 188],
        ...,
        [  0, 170, 193],
        [  0, 170, 196],
        [  0, 170, 195]],

       [[  0, 165, 183],
        [  0, 165, 181],
        [  0, 166, 185],
        ...,
        [  0, 169, 190],
        [  0, 169, 192],
        [  0, 169, 191]],

       ...,

       [[ 60,  30,  30],
        [ 63,  31,  31],
        [ 56,  28,  29],
        ...,
        [156,  88,  78],
        [153,  80,  71],
        [154,  83,  74]],

       [[ 66,  34,  34],
        [ 69,  35,  34],
        [ 63,  33,  34],
        ...,
        [ 98,  57,  50],
        [ 89,  42,  40],
        [ 93,  48,  44]],

       [[ 64,  32,  32],
        [ 67,  33,  33],
        [ 60,  31,  32],
        ...,
        [122,  70,  62],
        [116,  58,  53],
        [118,  63,  56]]], dtype=uint8)]"
Image_1272.jpg,224,186,160,169,500,559,384,355,169,daskShared_local/images/Image_1272.jpg,1272,"[array([[[128, 189, 184],
        [120, 186, 181],
        [112, 184, 180],
        ...,
        [125, 215, 201],
        [128, 215, 199],
        [129, 216, 200]],

       [[122, 186, 182],
        [114, 181, 178],
        [103, 176, 173],
        ...,
        [129, 213, 200],
        [132, 214, 200],
        [134, 217, 201]],

       [[113, 187, 185],
        [105, 181, 180],
        [ 93, 175, 174],
        ...,
        [137, 212, 201],
        [141, 214, 202],
        [143, 216, 203]],

       ...,

       [[ 53,  40,   9],
        [ 59,  44,  13],
        [ 58,  41,  14],
        ...,
        [ 66, 140,  70],
        [ 71, 138,  64],
        [ 73, 134,  57]],

       [[ 33,  21,  13],
        [ 47,  34,  23],
        [ 55,  41,  30],
        ...,
        [ 20, 151, 118],
        [ 22, 146, 109],
        [ 20, 140, 101]],

       [[ 15,   7,   2],
        [ 31,  22,   8],
        [ 43,  32,  16],
        ...,
        [  2, 174, 169],
        [  2, 170, 162],
        [  2, 165, 155]]], dtype=uint8)]"
Image_1273.jpg,585,196,332,312,924,924,917,508,332,daskShared_local/images/Image_1273.jpg,1273,"[array([[[  4, 141, 177],
        [  4, 140, 177],
        [  3, 137, 176],
        ...,
        [  2, 131, 162],
        [  2, 131, 162],
        [  2, 131, 162]],

       [[  9, 142, 173],
        [  5, 142, 176],
        [  3, 141, 176],
        ...,
        [  2, 131, 162],
        [  2, 131, 162],
        [  2, 131, 162]],

       [[ 39, 131, 159],
        [ 28, 135, 162],
        [ 19, 136, 164],
        ...,
        [  2, 131, 162],
        [  2, 131, 162],
        [  2, 131, 162]],

       ...,

       [[ 74,  65,  36],
        [ 85,  75,  48],
        [ 91,  81,  54],
        ...,
        [ 73,  62,  40],
        [ 57,  46,  24],
        [ 60,  49,  27]],

       [[ 75,  65,  37],
        [ 83,  73,  46],
        [ 91,  81,  54],
        ...,
        [ 66,  55,  33],
        [ 56,  45,  23],
        [ 58,  47,  25]],

       [[ 54,  44,  17],
        [ 60,  50,  25],
        [ 59,  49,  24],
        ...,
        [ 65,  54,  32],
        [ 63,  52,  30],
        [ 60,  49,  27]]], dtype=uint8)]"
Image_1274.jpg,352,123,254,234,845,563,606,357,254,daskShared_local/images/Image_1274.jpg,1274,"[array([[[ 73, 198, 199],
        [ 79, 200, 203],
        [ 86, 201, 204],
        ...,
        [ 92, 196, 195],
        [ 92, 196, 195],
        [ 92, 196, 195]],

       [[ 75, 199, 198],
        [ 79, 199, 199],
        [ 85, 200, 199],
        ...,
        [ 89, 196, 196],
        [ 88, 196, 195],
        [ 87, 195, 194]],

       [[ 76, 197, 195],
        [ 80, 198, 195],
        [ 84, 199, 195],
        ...,
        [ 83, 195, 195],
        [ 84, 196, 194],
        [ 84, 196, 194]],

       ...,

       [[ 64,  93,  46],
        [ 67,  98,  50],
        [ 67, 100,  52],
        ...,
        [  6, 182, 176],
        [ 10, 185, 180],
        [ 11, 185, 180]],

       [[ 55,  82,  30],
        [ 61,  89,  36],
        [ 67,  99,  45],
        ...,
        [  9, 183, 179],
        [ 15, 187, 183],
        [ 18, 189, 186]],

       [[ 64,  90,  32],
        [ 67,  94,  36],
        [ 69, 100,  40],
        ...,
        [ 15, 187, 184],
        [ 21, 191, 188],
        [ 25, 194, 191]]], dtype=uint8)]"
Image_1275.jpg,352,92,163,203,728,486,515,295,203,daskShared_local/images/Image_1275.jpg,1275,"[array([[[  2,  67, 255],
        [  0,  68, 251],
        [  0,  68, 253],
        ...,
        [  1, 112, 254],
        [  1, 114, 254],
        [  2, 113, 255]],

       [[  2,  67, 255],
        [  2,  67, 255],
        [  0,  68, 253],
        ...,
        [  1, 110, 253],
        [  3, 114, 255],
        [  1, 112, 254]],

       [[  2,  65, 255],
        [  1,  64, 253],
        [  1,  66, 254],
        ...,
        [  1, 110, 253],
        [  0, 111, 252],
        [  0, 111, 253]],

       ...,

       [[194, 152, 115],
        [193, 146,  99],
        [195, 153, 111],
        ...,
        [176, 182, 154],
        [126, 150, 111],
        [102, 122, 114]],

       [[201, 149, 112],
        [201, 153, 116],
        [196, 153, 115],
        ...,
        [201, 194, 175],
        [182, 193, 176],
        [128, 149, 130]],

       [[194, 150, 115],
        [193, 133,  97],
        [172, 125,  94],
        ...,
        [223, 221, 217],
        [218, 204, 181],
        [188, 196, 173]]], dtype=uint8)]"
Image_1276.jpg,494,235,355,221,1200,900,849,456,355,daskShared_local/images/Image_1276.jpg,1276,"[array([[[ 57, 175, 183],
        [ 75, 182, 193],
        [ 63, 177, 185],
        ...,
        [ 77, 186, 210],
        [ 62, 181, 198],
        [ 68, 180, 190]],

       [[ 60, 171, 181],
        [ 70, 175, 182],
        [ 58, 172, 183],
        ...,
        [ 79, 187, 213],
        [ 52, 174, 203],
        [ 36, 168, 191]],

       [[ 61, 170, 175],
        [ 42, 169, 175],
        [ 47, 169, 180],
        ...,
        [ 91, 190, 217],
        [ 72, 183, 211],
        [ 61, 172, 194]],

       ...,

       [[ 82, 145, 135],
        [ 70, 138, 123],
        [ 80, 141, 126],
        ...,
        [152, 210, 218],
        [156, 212, 226],
        [162, 213, 221]],

       [[ 69, 131, 119],
        [ 72, 135, 121],
        [ 91, 145, 129],
        ...,
        [ 89, 185, 190],
        [140, 205, 215],
        [152, 209, 221]],

       [[ 60, 121, 106],
        [ 73, 141, 117],
        [ 73, 139, 117],
        ...,
        [ 87, 185, 189],
        [141, 203, 211],
        [150, 207, 218]]], dtype=uint8)]"
Image_1277.jpg,1686,515,1465,1634,4631,3087,3151,2149,1634,daskShared_local/images/Image_1277.jpg,1277,"[array([[[ 20,  94, 241],
        [ 19,  95, 241],
        [ 19,  95, 241],
        ...,
        [  1,  60, 199],
        [  1,  60, 199],
        [  1,  60, 198]],

       [[ 20,  94, 241],
        [ 20,  94, 241],
        [ 20,  94, 241],
        ...,
        [  1,  60, 198],
        [  1,  60, 198],
        [  1,  60, 198]],

       [[ 20,  94, 241],
        [ 20,  94, 241],
        [ 20,  94, 241],
        ...,
        [  1,  60, 196],
        [  1,  60, 197],
        [  1,  60, 196]],

       ...,

       [[ 24,  38,  55],
        [ 26,  41,  52],
        [ 27,  38,  43],
        ...,
        [ 30,  37,  18],
        [ 37,  45,  22],
        [ 46,  53,  29]],

       [[ 23,  31,  39],
        [ 23,  31,  39],
        [ 24,  31,  37],
        ...,
        [ 39,  45,  24],
        [ 37,  43,  22],
        [ 34,  42,  22]],

       [[ 22,  31,  35],
        [ 23,  29,  34],
        [ 23,  29,  33],
        ...,
        [ 37,  44,  27],
        [ 32,  40,  21],
        [ 27,  36,  17]]], dtype=uint8)]"
Image_1278.png,377,185,329,289,900,600,706,474,329,daskShared_local/images/Image_1278.png,1278,"[array([[[115, 118, 107],
        [110, 106, 103],
        [114, 113, 108],
        ...,
        [ 17, 150, 185],
        [ 18, 152, 184],
        [ 19, 150, 185]],

       [[125, 106,  87],
        [128, 109,  98],
        [129, 109, 100],
        ...,
        [ 24, 150, 183],
        [ 28, 149, 184],
        [ 27, 148, 184]],

       [[ 95,  80,  81],
        [107,  89,  94],
        [ 96,  88,  83],
        ...,
        [ 26, 150, 181],
        [ 23, 152, 183],
        [ 28, 150, 182]],

       ...,

       [[ 21,  68,  64],
        [ 23,  69,  64],
        [ 23,  69,  65],
        ...,
        [ 89, 149, 152],
        [ 83, 153, 148],
        [ 87, 150, 146]],

       [[ 24,  69,  61],
        [ 25,  64,  68],
        [ 25,  67,  59],
        ...,
        [ 85, 146, 146],
        [ 88, 140, 149],
        [ 79, 142, 148]],

       [[ 23,  66,  65],
        [ 20,  67,  63],
        [ 27,  63,  60],
        ...,
        [ 86, 147, 146],
        [ 80, 137, 138],
        [ 77, 135, 135]]], dtype=uint8)]"
Image_1279.jpg,279,164,176,173,800,533,455,337,176,daskShared_local/images/Image_1279.jpg,1279,"[array([[[230, 205, 175],
        [229, 206, 171],
        [232, 210, 173],
        ...,
        [ 73,  71,  93],
        [ 59,  57,  78],
        [ 48,  47,  65]],

       [[232, 205, 182],
        [234, 212, 182],
        [236, 215, 183],
        ...,
        [ 91,  89, 110],
        [ 63,  62,  80],
        [ 41,  40,  57]],

       [[237, 213, 199],
        [240, 218, 197],
        [237, 216, 194],
        ...,
        [ 88,  87, 105],
        [ 89,  88, 104],
        [ 68,  67,  83]],

       ...,

       [[168, 132, 118],
        [173, 146, 126],
        [172, 147, 125],
        ...,
        [102,  88,  79],
        [ 98,  84,  75],
        [ 94,  80,  71]],

       [[164, 129, 114],
        [174, 147, 128],
        [171, 146, 126],
        ...,
        [ 97,  83,  74],
        [ 92,  78,  69],
        [ 89,  75,  66]],

       [[159, 124, 108],
        [182, 154, 135],
        [181, 154, 135],
        ...,
        [ 98,  84,  75],
        [ 94,  80,  71],
        [ 93,  79,  70]]], dtype=uint8)]"
Image_128.jpg,59,121,195,176,600,350,254,297,195,daskShared_local/images/Image_128.jpg,128,"[array([[[ 29,  47,  33],
        [ 29,  47,  35],
        [ 28,  48,  36],
        ...,
        [ 62,  50,  50],
        [ 54,  44,  45],
        [ 45,  35,  36]],

       [[ 29,  47,  33],
        [ 27,  48,  33],
        [ 27,  49,  36],
        ...,
        [ 40,  29,  37],
        [ 40,  28,  38],
        [ 35,  23,  33]],

       [[ 26,  49,  33],
        [ 26,  49,  33],
        [ 26,  50,  34],
        ...,
        [ 40,  30,  38],
        [ 50,  40,  48],
        [ 48,  38,  47]],

       ...,

       [[149, 134, 111],
        [150, 136, 110],
        [148, 131, 103],
        ...,
        [134,  86,  55],
        [126,  76,  49],
        [111,  64,  38]],

       [[143, 131, 107],
        [153, 141, 115],
        [160, 145, 116],
        ...,
        [126,  83,  49],
        [126,  82,  49],
        [126,  83,  53]],

       [[156, 146, 121],
        [165, 153, 127],
        [168, 154, 125],
        ...,
        [131,  99,  61],
        [136, 102,  65],
        [143, 107,  73]]], dtype=uint8)]"
Image_1280.jpg,311,206,192,208,1000,600,503,414,208,daskShared_local/images/Image_1280.jpg,1280,"[array([[[  1, 146, 193],
        [  0, 147, 193],
        [  0, 147, 193],
        ...,
        [  1, 157, 205],
        [  1, 157, 205],
        [  1, 157, 205]],

       [[  1, 146, 193],
        [  0, 146, 192],
        [  0, 146, 192],
        ...,
        [  1, 157, 205],
        [  1, 157, 205],
        [  1, 157, 205]],

       [[  1, 146, 193],
        [  1, 146, 193],
        [  1, 146, 193],
        ...,
        [  1, 158, 201],
        [  1, 158, 201],
        [  1, 158, 201]],

       ...,

       [[175, 135,  49],
        [203, 155,  77],
        [221, 178,  98],
        ...,
        [246, 220, 146],
        [246, 219, 142],
        [246, 217, 139]],

       [[204, 152,  76],
        [219, 164, 109],
        [216, 174,  82],
        ...,
        [245, 221, 151],
        [246, 220, 146],
        [246, 218, 144]],

       [[223, 171,  96],
        [218, 169, 107],
        [184, 149,  57],
        ...,
        [245, 221, 157],
        [244, 219, 152],
        [246, 219, 150]]], dtype=uint8)]"
Image_1281.jpg,419,140,255,264,1200,822,674,404,264,daskShared_local/images/Image_1281.jpg,1281,"[array([[[  1, 148, 173],
        [  0, 152, 176],
        [  1, 151, 176],
        ...,
        [  1, 159, 188],
        [  1, 159, 188],
        [  1, 159, 188]],

       [[  0, 147, 172],
        [  0, 149, 174],
        [  0, 149, 174],
        ...,
        [  1, 159, 188],
        [  0, 159, 188],
        [  0, 158, 187]],

       [[  1, 147, 172],
        [  2, 147, 174],
        [  1, 146, 173],
        ...,
        [  1, 160, 189],
        [  0, 159, 188],
        [  0, 157, 186]],

       ...,

       [[ 95, 124,  73],
        [ 91, 121,  62],
        [ 62,  89,  37],
        ...,
        [106,  74,  52],
        [102,  71,  47],
        [121,  92,  56]],

       [[ 89, 115,  61],
        [ 86, 114,  54],
        [ 70,  93,  41],
        ...,
        [155, 131,  94],
        [175, 147, 110],
        [210, 179, 137]],

       [[ 88, 109,  47],
        [ 85, 107,  48],
        [ 81, 100,  47],
        ...,
        [182, 163, 111],
        [202, 177, 126],
        [218, 186, 136]]], dtype=uint8)]"
Image_1282.jpg,679,262,485,507,1920,1080,1164,769,507,daskShared_local/images/Image_1282.jpg,1282,"[array([[[  0, 118, 201],
        [  0, 117, 201],
        [  0, 118, 202],
        ...,
        [  2, 116, 202],
        [  2, 116, 201],
        [  2, 116, 201]],

       [[  0, 119, 203],
        [  0, 119, 203],
        [  0, 118, 202],
        ...,
        [  2, 117, 200],
        [  1, 116, 199],
        [  1, 116, 199]],

       [[  0, 119, 203],
        [  0, 119, 203],
        [  0, 118, 202],
        ...,
        [  2, 117, 200],
        [  1, 116, 199],
        [  1, 116, 199]],

       ...,

       [[ 96,  99,  69],
        [160, 164, 123],
        [154, 157, 112],
        ...,
        [189, 190, 146],
        [214, 215, 173],
        [194, 191, 151]],

       [[109, 114,  90],
        [168, 171, 132],
        [185, 188, 141],
        ...,
        [206, 206, 161],
        [226, 227, 183],
        [206, 202, 160]],

       [[120, 130, 107],
        [154, 158, 119],
        [178, 181, 136],
        ...,
        [194, 193, 150],
        [223, 223, 178],
        [208, 205, 160]]], dtype=uint8)]"
Image_1283.jpg,27,75,227,172,800,600,254,247,227,daskShared_local/images/Image_1283.jpg,1283,"[array([[[ 12, 157, 212],
        [  6, 154, 207],
        [  2, 153, 206],
        ...,
        [ 24, 175, 223],
        [ 23, 174, 221],
        [ 27, 179, 226]],

       [[  8, 153, 209],
        [  4, 154, 208],
        [  3, 155, 209],
        ...,
        [ 24, 177, 224],
        [ 26, 178, 225],
        [ 26, 178, 225]],

       [[  5, 151, 207],
        [  2, 152, 207],
        [  0, 153, 207],
        ...,
        [ 21, 175, 222],
        [ 24, 177, 223],
        [ 23, 179, 224]],

       ...,

       [[ 50, 101, 106],
        [ 47, 100, 106],
        [ 49, 102, 107],
        ...,
        [101,  76,  57],
        [103,  77,  58],
        [102,  77,  55]],

       [[ 61, 112, 114],
        [ 58, 112, 114],
        [ 57, 110, 111],
        ...,
        [100,  76,  55],
        [ 95,  68,  46],
        [ 78,  50,  26]],

       [[ 67, 122, 119],
        [ 68, 124, 121],
        [ 64, 121, 115],
        ...,
        [ 99,  75,  53],
        [ 98,  72,  48],
        [ 96,  69,  42]]], dtype=uint8)]"
Image_1284.jpg,423,161,861,653,1500,1000,1284,814,861,daskShared_local/images/Image_1284.jpg,1284,"[array([[[  1,  60,  66],
        [  1,  60,  66],
        [  1,  60,  66],
        ...,
        [144, 138, 174],
        [144, 139, 174],
        [126, 123, 156]],

       [[  2,  59,  66],
        [  2,  59,  66],
        [  0,  59,  65],
        ...,
        [119, 114, 156],
        [114, 109, 150],
        [ 85,  87, 130]],

       [[  3,  58,  65],
        [  3,  58,  65],
        [  1,  58,  65],
        ...,
        [ 84,  86, 134],
        [ 79,  81, 121],
        [ 62,  70, 104]],

       ...,

       [[163, 174, 199],
        [176, 185, 202],
        [176, 184, 203],
        ...,
        [ 63, 103,  59],
        [ 63, 104,  60],
        [ 63, 104,  59]],

       [[155, 168, 198],
        [169, 180, 203],
        [170, 178, 203],
        ...,
        [ 63, 105,  60],
        [ 63, 104,  60],
        [ 66, 104,  60]],

       [[154, 167, 197],
        [166, 177, 204],
        [168, 177, 204],
        ...,
        [ 61, 106,  60],
        [ 63, 104,  59],
        [ 66, 104,  61]]], dtype=uint8)]"
Image_1285.jpg,979,134,265,350,1686,1216,1244,484,350,daskShared_local/images/Image_1285.jpg,1285,"[array([[[124, 183, 215],
        [123, 182, 214],
        [123, 182, 214],
        ...,
        [162, 202, 227],
        [163, 203, 228],
        [163, 203, 228]],

       [[123, 182, 214],
        [123, 182, 214],
        [124, 183, 215],
        ...,
        [163, 203, 228],
        [163, 203, 228],
        [163, 203, 228]],

       [[123, 182, 214],
        [122, 181, 213],
        [121, 180, 212],
        ...,
        [162, 202, 227],
        [162, 202, 227],
        [162, 202, 227]],

       ...,

       [[178, 201, 196],
        [181, 203, 197],
        [190, 211, 199],
        ...,
        [ 80, 162, 199],
        [ 78, 160, 197],
        [ 80, 162, 199]],

       [[170, 189, 168],
        [171, 193, 174],
        [184, 208, 192],
        ...,
        [ 78, 160, 197],
        [ 79, 161, 198],
        [ 81, 163, 200]],

       [[177, 192, 170],
        [160, 177, 158],
        [178, 196, 180],
        ...,
        [ 80, 162, 199],
        [ 81, 163, 200],
        [ 80, 162, 199]]], dtype=uint8)]"
Image_1286.jpg,460,118,296,322,1600,1019,756,440,322,daskShared_local/images/Image_1286.jpg,1286,"[array([[[ 30, 107, 213],
        [ 30, 107, 213],
        [ 30, 107, 213],
        ...,
        [ 28, 116, 213],
        [ 28, 116, 213],
        [ 28, 116, 213]],

       [[ 30, 107, 213],
        [ 30, 107, 213],
        [ 30, 107, 213],
        ...,
        [ 28, 116, 213],
        [ 28, 116, 213],
        [ 28, 116, 213]],

       [[ 30, 107, 213],
        [ 30, 107, 213],
        [ 30, 107, 213],
        ...,
        [ 28, 116, 213],
        [ 28, 116, 213],
        [ 28, 116, 213]],

       ...,

       [[231, 239, 231],
        [205, 209, 188],
        [198, 201, 182],
        ...,
        [202, 222, 208],
        [172, 196, 182],
        [188, 193, 187]],

       [[226, 232, 221],
        [214, 217, 200],
        [216, 219, 202],
        ...,
        [193, 197, 186],
        [183, 190, 178],
        [177, 165, 161]],

       [[237, 239, 227],
        [244, 246, 233],
        [250, 250, 238],
        ...,
        [162, 146, 138],
        [189, 175, 167],
        [181, 147, 146]]], dtype=uint8)]"
Image_1287.jpg,247,369,876,661,1512,1231,1123,1030,876,daskShared_local/images/Image_1287.jpg,1287,"[array([[[ 82, 102, 106],
        [ 82, 101, 107],
        [ 82, 102, 106],
        ...,
        [104, 133, 100],
        [ 84, 119,  85],
        [ 72, 109,  76]],

       [[ 77,  94,  94],
        [ 79,  96,  98],
        [ 81,  97,  97],
        ...,
        [103, 130,  99],
        [ 93, 125,  93],
        [ 74, 110,  77]],

       [[ 77,  93,  89],
        [ 78,  94,  92],
        [ 78,  93,  89],
        ...,
        [ 89, 114,  84],
        [102, 130,  99],
        [ 83, 117,  82]],

       ...,

       [[254, 238, 214],
        [254, 237, 213],
        [254, 237, 216],
        ...,
        [231, 203, 173],
        [227, 198, 166],
        [228, 197, 163]],

       [[253, 235, 211],
        [254, 235, 211],
        [254, 236, 214],
        ...,
        [241, 217, 186],
        [240, 215, 184],
        [238, 214, 179]],

       [[252, 235, 209],
        [254, 235, 212],
        [252, 234, 210],
        ...,
        [245, 226, 200],
        [246, 229, 206],
        [245, 233, 211]]], dtype=uint8)]"
Image_1288.jpg,443,270,178,186,850,567,621,456,186,daskShared_local/images/Image_1288.jpg,1288,"[array([[[117,  77,  74],
        [ 99,  65,  61],
        [ 58,  40,  33],
        ...,
        [134, 153, 154],
        [110, 102, 126],
        [ 54,  58,  89]],

       [[124,  76,  64],
        [ 97,  60,  62],
        [ 73,  51,  52],
        ...,
        [106, 129, 133],
        [148, 141, 147],
        [ 96,  83,  88]],

       [[149,  88,  82],
        [118,  73,  71],
        [ 93,  60,  58],
        ...,
        [ 76,  90,  99],
        [157, 139, 147],
        [139, 122, 114]],

       ...,

       [[ 11, 125, 237],
        [  8, 122, 234],
        [ 10, 124, 236],
        ...,
        [  9, 125, 234],
        [ 11, 127, 236],
        [ 10, 128, 236]],

       [[ 10, 124, 236],
        [  8, 122, 234],
        [ 10, 124, 236],
        ...,
        [  9, 125, 234],
        [ 11, 127, 236],
        [ 10, 128, 236]],

       [[  9, 123, 237],
        [  7, 121, 235],
        [  9, 123, 237],
        ...,
        [  9, 125, 234],
        [ 11, 127, 236],
        [  8, 126, 234]]], dtype=uint8)]"
Image_1289.jpg,647,275,322,343,1600,1000,969,618,343,daskShared_local/images/Image_1289.jpg,1289,"[array([[[  1,  71, 166],
        [  1,  71, 166],
        [  1,  71, 166],
        ...,
        [  0,  69, 162],
        [  0,  69, 162],
        [  0,  69, 162]],

       [[  1,  71, 166],
        [  1,  71, 166],
        [  1,  71, 166],
        ...,
        [  0,  69, 162],
        [  0,  69, 162],
        [  0,  69, 162]],

       [[  1,  71, 166],
        [  1,  71, 166],
        [  1,  72, 164],
        ...,
        [  0,  68, 161],
        [  0,  69, 162],
        [  0,  69, 162]],

       ...,

       [[ 69,  86,  56],
        [ 75,  88,  65],
        [ 46,  50,  32],
        ...,
        [127, 108,  78],
        [ 99,  83,  49],
        [107,  91,  57]],

       [[ 90,  99,  65],
        [ 98, 104,  82],
        [ 49,  56,  37],
        ...,
        [166, 150, 107],
        [138, 122,  89],
        [108,  92,  59]],

       [[ 82,  87,  50],
        [ 74,  75,  53],
        [ 32,  39,  21],
        ...,
        [162, 150, 107],
        [153, 140, 108],
        [148, 132, 104]]], dtype=uint8)]"
Image_129.jpg,131,92,152,121,500,333,283,213,152,daskShared_local/images/Image_129.jpg,129,"[array([[[ 27,  42,  61],
        [ 27,  42,  61],
        [ 27,  42,  61],
        ...,
        [ 25,  43,  65],
        [ 25,  43,  65],
        [ 26,  44,  66]],

       [[ 27,  42,  61],
        [ 27,  42,  61],
        [ 27,  42,  61],
        ...,
        [ 25,  43,  65],
        [ 25,  43,  65],
        [ 26,  44,  66]],

       [[ 27,  42,  61],
        [ 27,  42,  61],
        [ 27,  42,  61],
        ...,
        [ 25,  43,  65],
        [ 25,  43,  65],
        [ 26,  44,  66]],

       ...,

       [[ 25,  43,  57],
        [ 25,  43,  57],
        [ 24,  42,  56],
        ...,
        [113, 130, 122],
        [114, 130, 122],
        [114, 130, 123]],

       [[ 25,  43,  57],
        [ 25,  43,  57],
        [ 25,  43,  57],
        ...,
        [116, 133, 125],
        [116, 133, 125],
        [116, 133, 125]],

       [[ 25,  43,  57],
        [ 25,  43,  57],
        [ 25,  43,  57],
        ...,
        [118, 135, 127],
        [118, 135, 127],
        [118, 135, 127]]], dtype=uint8)]"
Image_1290.jpg,2368,903,693,575,3840,2160,3061,1478,693,daskShared_local/images/Image_1290.jpg,1290,"[array([[[ 93,  66,  45],
        [110,  84,  63],
        [ 95,  70,  50],
        ...,
        [  0, 130, 174],
        [  0, 130, 174],
        [  0, 129, 173]],

       [[ 94,  68,  46],
        [106,  80,  57],
        [143, 117,  95],
        ...,
        [  0, 130, 174],
        [  1, 132, 176],
        [  0, 131, 175]],

       [[128, 101,  79],
        [129, 102,  79],
        [159, 132, 110],
        ...,
        [  1, 131, 175],
        [  1, 132, 176],
        [  0, 131, 175]],

       ...,

       [[  1, 123, 164],
        [  3, 123, 165],
        [  3, 125, 164],
        ...,
        [  2, 121, 161],
        [  1, 122, 160],
        [  1, 123, 159]],

       [[  2, 123, 165],
        [  3, 122, 164],
        [  2, 122, 163],
        ...,
        [  2, 122, 158],
        [  3, 123, 157],
        [  3, 123, 156]],

       [[  3, 124, 166],
        [  1, 122, 163],
        [  1, 121, 162],
        ...,
        [  3, 122, 155],
        [  5, 122, 155],
        [  6, 122, 152]]], dtype=uint8)]"
Image_1291.jpg,350,106,214,196,1280,720,564,302,214,daskShared_local/images/Image_1291.jpg,1291,"[array([[[  8, 104, 191],
        [  9, 105, 192],
        [ 12, 108, 195],
        ...,
        [ 14, 143, 211],
        [ 18, 146, 214],
        [ 17, 146, 214]],

       [[  9, 105, 192],
        [ 11, 107, 194],
        [ 14, 110, 197],
        ...,
        [ 15, 142, 211],
        [ 15, 142, 211],
        [ 15, 142, 211]],

       [[ 14, 110, 197],
        [ 13, 109, 196],
        [ 15, 111, 198],
        ...,
        [ 16, 143, 212],
        [ 15, 142, 211],
        [ 15, 142, 211]],

       ...,

       [[ 11,  76, 168],
        [ 11,  76, 168],
        [ 11,  81, 169],
        ...,
        [186, 171, 141],
        [232, 218, 188],
        [240, 227, 197]],

       [[ 15,  80, 172],
        [ 14,  80, 171],
        [ 10,  80, 168],
        ...,
        [174, 162, 135],
        [229, 217, 191],
        [222, 211, 182]],

       [[ 18,  83, 175],
        [ 17,  82, 174],
        [  9,  79, 167],
        ...,
        [191, 180, 157],
        [170, 160, 135],
        [144, 132, 108]]], dtype=uint8)]"
Image_1292.jpg,205,441,189,195,2015,1510,394,636,195,daskShared_local/images/Image_1292.jpg,1292,"[array([[[ 75,  72,  65],
        [ 67,  64,  57],
        [ 62,  59,  52],
        ...,
        [ 41,  35,  35],
        [ 31,  25,  25],
        [ 29,  23,  23]],

       [[ 73,  70,  63],
        [ 57,  54,  47],
        [ 44,  41,  34],
        ...,
        [ 54,  48,  48],
        [ 45,  39,  39],
        [ 38,  32,  32]],

       [[ 42,  41,  36],
        [ 37,  37,  29],
        [ 25,  25,  17],
        ...,
        [ 50,  44,  44],
        [ 47,  41,  41],
        [ 43,  37,  37]],

       ...,

       [[215, 206, 191],
        [210, 202, 189],
        [167, 163, 151],
        ...,
        [145, 150, 153],
        [147, 151, 154],
        [132, 136, 139]],

       [[226, 219, 203],
        [214, 208, 194],
        [176, 172, 160],
        ...,
        [145, 150, 153],
        [154, 158, 161],
        [144, 148, 151]],

       [[204, 197, 181],
        [186, 180, 166],
        [160, 156, 144],
        ...,
        [140, 146, 146],
        [149, 153, 154],
        [144, 148, 149]]], dtype=uint8)]"
Image_1293.jpg,598,313,209,156,1400,933,807,469,209,daskShared_local/images/Image_1293.jpg,1293,"[array([[[  1, 172, 228],
        [  1, 172, 228],
        [  1, 172, 228],
        ...,
        [  1, 213, 250],
        [  1, 213, 250],
        [  1, 213, 250]],

       [[  4, 170, 228],
        [  4, 170, 228],
        [  1, 172, 228],
        ...,
        [  1, 210, 251],
        [  3, 210, 252],
        [  3, 210, 252]],

       [[  4, 170, 228],
        [  3, 169, 227],
        [  1, 172, 228],
        ...,
        [  2, 211, 252],
        [  2, 211, 252],
        [  3, 210, 252]],

       ...,

       [[227, 214, 180],
        [249, 242, 220],
        [253, 250, 246],
        ...,
        [  1, 181, 234],
        [  1, 181, 234],
        [  1, 181, 234]],

       [[214, 188, 159],
        [174, 149, 136],
        [234, 214, 209],
        ...,
        [  1, 181, 234],
        [  1, 181, 234],
        [  3, 180, 234]],

       [[220, 179, 152],
        [140,  98,  93],
        [116,  83,  66],
        ...,
        [  1, 181, 234],
        [  3, 180, 234],
        [  3, 180, 234]]], dtype=uint8)]"
Image_1294.jpg,865,435,753,580,3008,2000,1618,1015,753,daskShared_local/images/Image_1294.jpg,1294,"[array([[[150, 189, 196],
        [150, 189, 196],
        [148, 187, 194],
        ...,
        [130, 176, 190],
        [130, 176, 190],
        [129, 176, 190]],

       [[150, 189, 196],
        [150, 189, 196],
        [148, 187, 194],
        ...,
        [135, 177, 189],
        [135, 177, 189],
        [133, 178, 191]],

       [[150, 189, 196],
        [149, 188, 195],
        [148, 187, 194],
        ...,
        [135, 177, 189],
        [135, 177, 189],
        [133, 178, 191]],

       ...,

       [[111, 169, 180],
        [111, 169, 180],
        [109, 167, 178],
        ...,
        [ 72,  81,  88],
        [ 71,  80,  87],
        [ 52,  67,  75]],

       [[110, 168, 179],
        [110, 168, 179],
        [109, 167, 178],
        ...,
        [ 63,  72,  79],
        [ 75,  84,  91],
        [ 60,  75,  83]],

       [[109, 167, 178],
        [109, 167, 178],
        [109, 167, 178],
        ...,
        [ 52,  61,  68],
        [ 78,  87,  94],
        [ 70,  84,  92]]], dtype=uint8)]"
Image_1295.jpg,414,1,420,521,1280,720,834,522,521,daskShared_local/images/Image_1295.jpg,1295,"[array([[[164, 231, 240],
        [162, 228, 238],
        [159, 227, 238],
        ...,
        [ 55, 180, 209],
        [ 59, 183, 213],
        [ 62, 183, 213]],

       [[162, 229, 238],
        [160, 227, 236],
        [158, 226, 237],
        ...,
        [ 44, 181, 210],
        [ 62, 183, 213],
        [ 72, 185, 215]],

       [[160, 228, 237],
        [160, 226, 237],
        [160, 227, 239],
        ...,
        [ 76, 186, 217],
        [ 79, 188, 216],
        [ 75, 185, 214]],

       ...,

       [[ 90,  73,  35],
        [109,  87,  50],
        [113,  87,  49],
        ...,
        [  1,  71,  96],
        [  2,  71,  96],
        [  3,  70,  96]],

       [[119,  94,  54],
        [121,  94,  55],
        [118,  90,  49],
        ...,
        [  0,  70,  95],
        [  3,  69,  95],
        [  3,  69,  95]],

       [[128, 105,  65],
        [122,  97,  59],
        [112,  86,  48],
        ...,
        [  2,  70,  93],
        [  3,  69,  95],
        [  3,  69,  95]]], dtype=uint8)]"
Image_1296.jpg,368,954,853,646,4601,3200,1221,1600,853,daskShared_local/images/Image_1296.jpg,1296,"[array([[[ 38, 160, 245],
        [ 31, 147, 235],
        [ 28, 160, 237],
        ...,
        [ 48, 155, 230],
        [ 49, 154, 228],
        [ 50, 156, 231]],

       [[ 29, 166, 242],
        [ 24, 156, 227],
        [ 27, 155, 230],
        ...,
        [ 47, 160, 226],
        [ 50, 160, 227],
        [ 48, 157, 224]],

       [[ 31, 164, 243],
        [ 36, 165, 242],
        [ 32, 161, 237],
        ...,
        [ 44, 160, 225],
        [ 48, 165, 230],
        [ 46, 162, 228]],

       ...,

       [[ 24, 159, 227],
        [ 25, 166, 233],
        [ 23, 158, 221],
        ...,
        [ 50, 157, 217],
        [ 46, 151, 212],
        [ 49, 157, 217]],

       [[ 24, 158, 222],
        [ 23, 157, 222],
        [ 23, 157, 220],
        ...,
        [ 45, 155, 213],
        [ 47, 161, 221],
        [ 44, 155, 214]],

       [[ 26, 160, 224],
        [ 26, 159, 223],
        [ 25, 158, 223],
        ...,
        [ 43, 156, 215],
        [ 43, 158, 216],
        [ 38, 149, 204]]], dtype=uint8)]"
Image_1297.jpg,99,248,154,125,900,600,253,373,154,daskShared_local/images/Image_1297.jpg,1297,"[array([[[  3,  75,  83],
        [  4,  76,  83],
        [  4,  75,  83],
        ...,
        [ 48, 140, 158],
        [ 70, 152, 172],
        [ 87, 160, 181]],

       [[  1,  73,  81],
        [  2,  74,  82],
        [  2,  74,  83],
        ...,
        [ 35, 126, 143],
        [ 54, 137, 155],
        [ 70, 144, 162]],

       [[  0,  72,  81],
        [  0,  73,  81],
        [  0,  75,  83],
        ...,
        [ 18, 109, 124],
        [ 32, 117, 132],
        [ 42, 121, 135]],

       ...,

       [[  0,  66,  78],
        [  0,  66,  79],
        [  0,  66,  80],
        ...,
        [  7,  38,  38],
        [  9,  38,  39],
        [ 10,  39,  40]],

       [[  0,  66,  78],
        [  0,  66,  79],
        [  0,  66,  80],
        ...,
        [  4,  37,  35],
        [  5,  38,  36],
        [  5,  39,  37]],

       [[  0,  66,  78],
        [  0,  66,  78],
        [  0,  66,  79],
        ...,
        [  3,  37,  33],
        [  2,  37,  34],
        [  2,  38,  34]]], dtype=uint8)]"
Image_1298.jpg,213,25,215,185,900,521,428,210,215,daskShared_local/images/Image_1298.jpg,1298,"[array([[[ 17,  59, 171],
        [ 17,  59, 171],
        [ 17,  59, 171],
        ...,
        [ 33,  70, 185],
        [ 33,  70, 185],
        [ 33,  70, 185]],

       [[ 16,  58, 170],
        [ 16,  58, 170],
        [ 16,  58, 170],
        ...,
        [ 33,  70, 185],
        [ 33,  70, 185],
        [ 33,  70, 185]],

       [[ 16,  58, 170],
        [ 16,  58, 170],
        [ 16,  58, 170],
        ...,
        [ 33,  70, 185],
        [ 33,  70, 185],
        [ 33,  70, 185]],

       ...,

       [[  1,  51, 136],
        [  2,  52, 138],
        [  3,  53, 139],
        ...,
        [213, 229, 228],
        [215, 232, 227],
        [217, 232, 226]],

       [[  1,  51, 136],
        [  2,  52, 137],
        [  3,  53, 138],
        ...,
        [212, 228, 227],
        [210, 227, 221],
        [212, 228, 218]],

       [[  2,  52, 139],
        [  2,  52, 139],
        [  2,  52, 140],
        ...,
        [214, 229, 226],
        [220, 235, 230],
        [220, 235, 230]]], dtype=uint8)]"
Image_1299.jpg,716,173,176,162,1000,600,892,335,176,daskShared_local/images/Image_1299.jpg,1299,"[array([[[  2, 156, 208],
        [  2, 156, 208],
        [  2, 156, 208],
        ...,
        [  2, 147, 204],
        [  2, 147, 204],
        [  2, 147, 204]],

       [[  1, 155, 207],
        [  1, 155, 207],
        [  2, 156, 208],
        ...,
        [  2, 147, 204],
        [  2, 147, 204],
        [  3, 148, 205]],

       [[  3, 157, 208],
        [  3, 157, 207],
        [  4, 158, 208],
        ...,
        [  3, 148, 205],
        [  3, 148, 205],
        [  2, 148, 205]],

       ...,

       [[105,  94,  11],
        [123, 114,  28],
        [146, 137,  61],
        ...,
        [178, 185, 149],
        [189, 194, 176],
        [224, 227, 222]],

       [[156, 145,  57],
        [168, 157,  75],
        [190, 179, 113],
        ...,
        [193, 197, 177],
        [241, 243, 238],
        [245, 245, 252]],

       [[241, 227, 140],
        [229, 216, 141],
        [236, 220, 166],
        ...,
        [187, 188, 182],
        [231, 232, 236],
        [227, 226, 242]]], dtype=uint8)]"
Image_13.jpg,447,221,184,185,1200,630,631,406,185,daskShared_local/images/Image_13.jpg,13,"[array([[[ 27, 105, 169],
        [ 36, 108, 173],
        [ 32, 103, 167],
        ...,
        [ 26,  46,  50],
        [ 22,  39,  46],
        [ 27,  42,  49]],

       [[ 28, 106, 170],
        [ 31, 103, 169],
        [ 30, 104, 167],
        ...,
        [ 43,  63,  67],
        [ 33,  49,  57],
        [ 34,  47,  55]],

       [[ 30, 108, 172],
        [ 26, 100, 165],
        [ 49, 123, 185],
        ...,
        [ 51,  70,  74],
        [ 43,  58,  65],
        [ 25,  35,  44]],

       ...,

       [[ 39,  94, 100],
        [ 39,  91, 110],
        [ 37,  89, 110],
        ...,
        [ 32,  32,  37],
        [ 22,  23,  27],
        [ 18,  21,  24]],

       [[ 27,  80,  89],
        [ 24,  75,  95],
        [ 28,  79, 100],
        ...,
        [ 45,  45,  49],
        [ 42,  43,  47],
        [ 45,  46,  50]],

       [[ 15,  63,  77],
        [ 16,  64,  85],
        [ 22,  73,  94],
        ...,
        [ 37,  37,  39],
        [ 33,  34,  36],
        [ 34,  35,  37]]], dtype=uint8)]"
Image_130.jpg,397,181,89,61,800,600,486,242,89,daskShared_local/images/Image_130.jpg,130,"[array([[[ 65, 104, 135],
        [ 65, 103, 134],
        [ 64, 106, 135],
        ...,
        [ 65, 122, 197],
        [ 67, 119, 198],
        [ 67, 120, 198]],

       [[ 65, 104, 135],
        [ 66, 103, 135],
        [ 64, 106, 136],
        ...,
        [ 66, 122, 200],
        [ 68, 119, 201],
        [ 68, 119, 201]],

       [[ 63, 104, 133],
        [ 64, 103, 132],
        [ 63, 105, 134],
        ...,
        [ 62, 122, 186],
        [ 63, 121, 187],
        [ 63, 121, 187]],

       ...,

       [[ 93, 100, 128],
        [ 93, 100, 129],
        [ 92, 101, 127],
        ...,
        [ 24, 127, 246],
        [ 23, 127, 246],
        [ 23, 127, 246]],

       [[ 94, 101, 129],
        [ 93, 101, 129],
        [ 95, 102, 129],
        ...,
        [ 25, 127, 247],
        [ 24, 127, 246],
        [ 24, 127, 247]],

       [[ 93, 101, 129],
        [ 93, 100, 129],
        [ 94, 102, 129],
        ...,
        [ 25, 127, 247],
        [ 24, 127, 246],
        [ 24, 127, 246]]], dtype=uint8)]"
Image_1300.jpg,386,348,317,229,1904,803,703,577,317,daskShared_local/images/Image_1300.jpg,1300,"[array([[[  2,  51, 107],
        [  2,  51, 107],
        [  2,  51, 107],
        ...,
        [ 30, 125, 106],
        [ 32, 124, 106],
        [ 23, 112,  97]],

       [[  2,  51, 107],
        [  2,  51, 107],
        [  2,  51, 107],
        ...,
        [ 46, 136, 118],
        [ 49, 136, 120],
        [ 41, 124, 111]],

       [[  2,  51, 107],
        [  2,  51, 107],
        [  2,  51, 107],
        ...,
        [ 52, 134, 119],
        [ 52, 130, 117],
        [ 43, 116, 106]],

       ...,

       [[  2,  88, 134],
        [  0, 100, 134],
        [  0, 111, 133],
        ...,
        [  1,  52,  73],
        [  4,  53,  85],
        [  8,  53,  92]],

       [[  6,  72, 116],
        [  1,  80, 117],
        [  0,  87, 114],
        ...,
        [  3,  54,  78],
        [  4,  53,  87],
        [  6,  50,  94]],

       [[ 12,  57,  95],
        [  6,  60,  96],
        [  2,  63,  94],
        ...,
        [  5,  56,  83],
        [  5,  53,  92],
        [  6,  50,  98]]], dtype=uint8)]"
Image_1301.jpg,497,70,170,197,1200,630,667,267,197,daskShared_local/images/Image_1301.jpg,1301,"[array([[[  7, 161, 223],
        [  7, 159, 222],
        [  6, 158, 221],
        ...,
        [  4, 156, 223],
        [  4, 156, 223],
        [  5, 157, 224]],

       [[  8, 162, 226],
        [  7, 161, 225],
        [  6, 160, 224],
        ...,
        [  4, 156, 223],
        [  4, 156, 223],
        [  5, 157, 224]],

       [[  4, 159, 223],
        [  5, 159, 223],
        [  5, 159, 223],
        ...,
        [  4, 156, 223],
        [  5, 157, 224],
        [  5, 157, 224]],

       ...,

       [[ 32,  17,  20],
        [ 26,  14,  16],
        [ 25,  13,  17],
        ...,
        [ 11,  95, 132],
        [  0,  81, 118],
        [  2,  86, 123]],

       [[ 23,   9,   8],
        [ 22,  10,  10],
        [ 25,  13,  13],
        ...,
        [  3,  87, 124],
        [  0,  81, 118],
        [  3,  87, 124]],

       [[ 20,   6,   3],
        [ 20,   9,   7],
        [ 21,  10,   8],
        ...,
        [  0,  80, 118],
        [  0,  81, 119],
        [  0,  80, 118]]], dtype=uint8)]"
Image_1302.jpg,361,22,153,131,550,380,514,153,153,daskShared_local/images/Image_1302.jpg,1302,"[array([[[ 75,  94, 150],
        [ 74,  93, 149],
        [ 74,  93, 149],
        ...,
        [ 69,  84, 143],
        [ 69,  84, 143],
        [ 70,  85, 144]],

       [[ 75,  94, 150],
        [ 74,  93, 149],
        [ 74,  93, 149],
        ...,
        [ 68,  84, 143],
        [ 69,  84, 143],
        [ 69,  84, 143]],

       [[ 75,  94, 150],
        [ 74,  93, 149],
        [ 74,  93, 149],
        ...,
        [ 69,  84, 143],
        [ 68,  83, 142],
        [ 69,  84, 143]],

       ...,

       [[219, 196, 161],
        [211, 190, 150],
        [203, 185, 143],
        ...,
        [ 65,  77, 139],
        [ 66,  77, 139],
        [ 66,  77, 139]],

       [[210, 189, 153],
        [205, 187, 147],
        [195, 180, 139],
        ...,
        [ 65,  78, 139],
        [ 66,  77, 139],
        [ 66,  77, 139]],

       [[201, 183, 147],
        [198, 183, 143],
        [181, 168, 129],
        ...,
        [ 65,  78, 139],
        [ 65,  76, 138],
        [ 66,  77, 139]]], dtype=uint8)]"
Image_1303.jpg,1163,1006,530,457,2592,1944,1693,1463,530,daskShared_local/images/Image_1303.jpg,1303,"[array([[[160, 134, 105],
        [175, 148, 124],
        [147, 121, 105],
        ...,
        [ 46,  90, 133],
        [ 39,  79, 123],
        [ 38,  72, 118]],

       [[179, 151, 115],
        [179, 150, 118],
        [168, 135, 116],
        ...,
        [ 40,  75, 118],
        [ 40,  70, 116],
        [ 40,  70, 116]],

       [[132, 102,  69],
        [149, 123,  92],
        [135, 110,  90],
        ...,
        [ 37,  72, 112],
        [ 37,  70, 112],
        [ 39,  72, 115]],

       ...,

       [[ 38, 122, 168],
        [ 39, 123, 169],
        [ 38, 122, 168],
        ...,
        [ 40, 123, 169],
        [ 38, 122, 168],
        [ 38, 125, 170]],

       [[ 38, 122, 166],
        [ 39, 122, 166],
        [ 39, 122, 166],
        ...,
        [ 38, 122, 168],
        [ 35, 120, 166],
        [ 35, 122, 167]],

       [[ 40, 123, 167],
        [ 40, 122, 166],
        [ 40, 123, 167],
        ...,
        [ 36, 123, 168],
        [ 37, 124, 169],
        [ 37, 124, 169]]], dtype=uint8)]"
Image_1304.jpg,506,80,319,436,1600,900,825,516,436,daskShared_local/images/Image_1304.jpg,1304,"[array([[[  0, 154, 208],
        [  0, 154, 208],
        [  1, 155, 209],
        ...,
        [153, 200, 242],
        [155, 201, 242],
        [156, 201, 242]],

       [[  0, 154, 208],
        [  0, 154, 208],
        [  1, 155, 209],
        ...,
        [152, 199, 241],
        [155, 201, 242],
        [156, 201, 242]],

       [[  0, 154, 208],
        [  0, 154, 208],
        [  1, 155, 209],
        ...,
        [152, 199, 241],
        [155, 200, 242],
        [155, 200, 242]],

       ...,

       [[  0, 140, 201],
        [  0, 140, 201],
        [  1, 141, 202],
        ...,
        [141, 117,  79],
        [101,  83,  59],
        [ 98,  87,  79]],

       [[  0, 140, 201],
        [  0, 140, 201],
        [  0, 140, 201],
        ...,
        [112,  88,  63],
        [ 90,  82,  69],
        [ 91,  86,  77]],

       [[  0, 140, 201],
        [  0, 140, 201],
        [  0, 140, 201],
        ...,
        [ 94,  76,  49],
        [ 79,  79,  72],
        [ 76,  74,  70]]], dtype=uint8)]"
Image_1305.jpg,955,377,231,219,2000,1000,1186,596,231,daskShared_local/images/Image_1305.jpg,1305,"[array([[[210, 192, 156],
        [203, 185, 150],
        [204, 188, 154],
        ...,
        [204, 184, 149],
        [207, 188, 155],
        [208, 189, 156]],

       [[207, 187, 150],
        [202, 183, 147],
        [206, 189, 153],
        ...,
        [210, 189, 155],
        [206, 187, 156],
        [208, 190, 160]],

       [[203, 180, 143],
        [201, 180, 143],
        [205, 184, 148],
        ...,
        [210, 189, 156],
        [203, 186, 155],
        [205, 189, 159]],

       ...,

       [[ 55,  55,  54],
        [ 60,  60,  58],
        [ 79,  80,  76],
        ...,
        [212, 190, 151],
        [208, 184, 148],
        [203, 179, 141]],

       [[ 45,  46,  44],
        [ 47,  48,  44],
        [ 57,  58,  53],
        ...,
        [205, 183, 143],
        [212, 191, 149],
        [210, 187, 147]],

       [[ 38,  38,  36],
        [ 39,  39,  36],
        [ 42,  43,  38],
        ...,
        [205, 183, 143],
        [208, 190, 153],
        [205, 187, 150]]], dtype=uint8)]"
Image_1306.jpg,123,142,369,301,1152,768,492,443,369,daskShared_local/images/Image_1306.jpg,1306,"[array([[[191, 238, 230],
        [194, 240, 230],
        [197, 240, 231],
        ...,
        [176, 237, 229],
        [169, 233, 227],
        [163, 230, 224]],

       [[190, 237, 229],
        [193, 239, 229],
        [196, 239, 230],
        ...,
        [165, 233, 223],
        [161, 228, 223],
        [158, 228, 223]],

       [[186, 236, 229],
        [188, 238, 231],
        [190, 238, 231],
        ...,
        [153, 228, 223],
        [149, 224, 219],
        [149, 224, 219]],

       ...,

       [[102, 185, 193],
        [101, 184, 192],
        [101, 183, 191],
        ...,
        [ 95, 125, 123],
        [ 99, 127, 126],
        [101, 127, 120]],

       [[100, 183, 191],
        [100, 183, 191],
        [ 99, 181, 190],
        ...,
        [ 95, 129, 126],
        [100, 130, 130],
        [100, 130, 123]],

       [[101, 181, 190],
        [101, 181, 190],
        [100, 179, 189],
        ...,
        [ 89, 128, 124],
        [ 96, 129, 129],
        [ 97, 130, 126]]], dtype=uint8)]"
Image_1307.jpg,1027,90,2578,2674,4608,3072,3605,2764,2674,daskShared_local/images/Image_1307.jpg,1307,"[array([[[ 46,  46,  44],
        [ 44,  44,  41],
        [ 42,  42,  39],
        ...,
        [172, 165, 122],
        [172, 165, 122],
        [172, 165, 121]],

       [[ 41,  41,  40],
        [ 43,  43,  41],
        [ 47,  47,  46],
        ...,
        [172, 165, 123],
        [171, 165, 122],
        [172, 165, 119]],

       [[ 43,  43,  43],
        [ 46,  46,  45],
        [ 47,  47,  46],
        ...,
        [171, 165, 123],
        [171, 164, 121],
        [171, 164, 120]],

       ...,

       [[ 97,  81,  54],
        [ 97,  80,  52],
        [ 98,  80,  51],
        ...,
        [163, 140,  88],
        [158, 137,  92],
        [152, 130,  88]],

       [[ 93,  77,  47],
        [ 94,  77,  48],
        [ 97,  77,  47],
        ...,
        [146, 132,  97],
        [151, 135,  90],
        [157, 134,  78]],

       [[ 92,  74,  42],
        [ 90,  74,  46],
        [ 93,  75,  47],
        ...,
        [146, 123,  85],
        [153, 135,  95],
        [166, 144,  86]]], dtype=uint8)]"
Image_1308.jpg,619,217,136,111,1000,667,755,328,136,daskShared_local/images/Image_1308.jpg,1308,"[array([[[ 65, 126, 124],
        [ 65, 126, 124],
        [ 65, 126, 124],
        ...,
        [ 35, 117, 128],
        [ 39, 119, 130],
        [ 40, 120, 131]],

       [[ 67, 131, 129],
        [ 68, 131, 129],
        [ 68, 131, 129],
        ...,
        [ 40, 121, 133],
        [ 45, 124, 136],
        [ 48, 126, 138]],

       [[ 72, 139, 137],
        [ 72, 139, 137],
        [ 73, 140, 137],
        ...,
        [ 47, 124, 138],
        [ 54, 130, 144],
        [ 58, 132, 146]],

       ...,

       [[141, 143, 114],
        [155, 157, 127],
        [176, 177, 146],
        ...,
        [ 90, 170, 180],
        [ 91, 171, 180],
        [ 91, 171, 180]],

       [[122, 126,  97],
        [132, 135, 106],
        [152, 153, 123],
        ...,
        [ 89, 169, 177],
        [ 90, 170, 178],
        [ 91, 171, 179]],

       [[116, 120,  92],
        [119, 123,  94],
        [133, 135, 105],
        ...,
        [ 88, 169, 176],
        [ 90, 170, 177],
        [ 91, 171, 178]]], dtype=uint8)]"
Image_1309.jpg,213,202,146,164,800,600,359,366,164,daskShared_local/images/Image_1309.jpg,1309,"[array([[[ 92, 192, 215],
        [ 91, 191, 214],
        [ 89, 190, 213],
        ...,
        [ 38, 167, 196],
        [ 37, 169, 196],
        [ 36, 170, 197]],

       [[ 88, 192, 213],
        [ 88, 191, 213],
        [ 86, 191, 212],
        ...,
        [ 37, 167, 196],
        [ 37, 169, 196],
        [ 36, 170, 197]],

       [[ 83, 191, 212],
        [ 82, 191, 212],
        [ 82, 191, 211],
        ...,
        [ 36, 167, 196],
        [ 35, 168, 197],
        [ 35, 169, 197]],

       ...,

       [[ 22, 127, 116],
        [ 25, 129, 116],
        [ 26, 128, 115],
        ...,
        [221, 190, 118],
        [217, 189,  98],
        [228, 195, 133]],

       [[ 27, 127, 114],
        [ 27, 127, 113],
        [ 29, 127, 114],
        ...,
        [225, 191, 125],
        [225, 193, 121],
        [229, 198, 131]],

       [[ 31, 128, 116],
        [ 31, 127, 113],
        [ 33, 128, 114],
        ...,
        [225, 189, 122],
        [228, 195, 130],
        [228, 197, 133]]], dtype=uint8)]"
Image_131.jpg,883,517,213,195,1920,1200,1096,712,213,daskShared_local/images/Image_131.jpg,131,"[array([[[  0, 110, 111],
        [  1, 109, 111],
        [  2, 110, 112],
        ...,
        [  0, 120, 121],
        [  0, 120, 121],
        [  0, 120, 121]],

       [[  0, 110, 111],
        [  0, 110, 111],
        [  1, 111, 111],
        ...,
        [  4, 124, 125],
        [  2, 122, 123],
        [  2, 122, 123]],

       [[  0, 112, 112],
        [  0, 112, 112],
        [  0, 113, 111],
        ...,
        [  8, 127, 129],
        [  6, 126, 127],
        [  4, 124, 125]],

       ...,

       [[118, 103,  70],
        [129, 115,  80],
        [122, 108,  73],
        ...,
        [201, 190, 151],
        [242, 227, 191],
        [220, 202, 169]],

       [[123, 109,  74],
        [124, 110,  75],
        [124, 110,  75],
        ...,
        [145, 133,  91],
        [168, 153, 114],
        [204, 186, 150]],

       [[116, 103,  68],
        [128, 114,  77],
        [130, 114,  77],
        ...,
        [ 77,  73,  28],
        [ 84,  77,  35],
        [128, 118,  82]]], dtype=uint8)]"
Image_1310.png,351,52,204,152,600,600,555,204,204,daskShared_local/images/Image_1310.png,1310,"[array([[[  0, 100, 246],
        [  0, 100, 248],
        [  0, 100, 248],
        ...,
        [  2, 115, 255],
        [  2, 115, 255],
        [  2, 115, 255]],

       [[  0, 100, 246],
        [  0, 100, 248],
        [  0, 100, 248],
        ...,
        [  1, 117, 255],
        [  1, 117, 255],
        [  1, 117, 255]],

       [[  0, 100, 246],
        [  0, 100, 248],
        [  0, 100, 248],
        ...,
        [  1, 117, 254],
        [  1, 117, 254],
        [  1, 117, 254]],

       ...,

       [[216, 193,  88],
        [235, 242, 208],
        [232, 225, 201],
        ...,
        [236, 245, 198],
        [233, 243, 190],
        [239, 249, 185]],

       [[226, 205, 129],
        [214, 255, 252],
        [211, 246, 246],
        ...,
        [248, 254, 211],
        [237, 243, 209],
        [235, 241, 202]],

       [[171, 148,  74],
        [214, 245, 245],
        [172, 182, 222],
        ...,
        [220, 220, 213],
        [230, 237, 180],
        [235, 246, 171]]], dtype=uint8)]"
Image_1311.jpg,587,79,227,184,1068,601,814,263,227,daskShared_local/images/Image_1311.jpg,1311,"[array([[[  0,  72, 255],
        [  0,  72, 255],
        [  0,  72, 255],
        ...,
        [  0,  87, 255],
        [  0,  87, 255],
        [  0,  87, 255]],

       [[  0,  72, 255],
        [  0,  72, 255],
        [  0,  72, 255],
        ...,
        [  0,  88, 255],
        [  0,  88, 255],
        [  0,  88, 255]],

       [[  0,  72, 255],
        [  0,  72, 255],
        [  0,  72, 255],
        ...,
        [  0,  88, 255],
        [  0,  88, 255],
        [  0,  88, 255]],

       ...,

       [[152, 124,  82],
        [172, 150,  99],
        [196, 177, 137],
        ...,
        [217, 223, 201],
        [220, 225, 196],
        [221, 226, 187]],

       [[ 60,  31,  21],
        [125,  99,  67],
        [167, 140, 122],
        ...,
        [215, 224, 198],
        [219, 224, 195],
        [221, 225, 188]],

       [[ 74,  46,  35],
        [180, 153, 139],
        [205, 179, 173],
        ...,
        [214, 224, 195],
        [217, 224, 194],
        [220, 224, 191]]], dtype=uint8)]"
Image_1312.jpg,423,149,238,171,1000,667,661,320,238,daskShared_local/images/Image_1312.jpg,1312,"[array([[[ 43, 183, 254],
        [ 47, 185, 251],
        [ 50, 187, 251],
        ...,
        [ 13, 155, 234],
        [ 11, 153, 233],
        [  8, 152, 233]],

       [[ 50, 187, 254],
        [ 51, 189, 253],
        [ 52, 190, 253],
        ...,
        [ 10, 152, 231],
        [  9, 152, 231],
        [ 11, 154, 233]],

       [[ 53, 191, 253],
        [ 53, 191, 254],
        [ 55, 192, 254],
        ...,
        [  6, 151, 230],
        [  8, 153, 232],
        [ 10, 153, 234]],

       ...,

       [[202, 187, 131],
        [209, 197, 146],
        [204, 192, 145],
        ...,
        [  0,  62, 105],
        [  0,  62, 105],
        [  0,  62, 106]],

       [[190, 171, 120],
        [190, 175, 124],
        [188, 174, 124],
        ...,
        [  0,  63, 106],
        [  0,  62, 106],
        [  0,  62, 106]],

       [[174, 145,  92],
        [166, 141,  89],
        [167, 146,  95],
        ...,
        [  0,  63, 106],
        [  0,  63, 106],
        [  0,  63, 107]]], dtype=uint8)]"
Image_1313.jpg,426,136,726,627,1152,763,1152,763,726,daskShared_local/images/Image_1313.jpg,1313,"[array([[[  1, 180, 236],
        [  0, 181, 236],
        [  0, 180, 235],
        ...,
        [  0, 184, 238],
        [  0, 183, 237],
        [  0, 184, 238]],

       [[  0, 179, 235],
        [  0, 179, 235],
        [  1, 180, 236],
        ...,
        [  0, 184, 238],
        [  0, 183, 237],
        [  0, 184, 238]],

       [[  0, 179, 235],
        [  0, 179, 235],
        [  1, 180, 236],
        ...,
        [  0, 183, 237],
        [  0, 183, 237],
        [  0, 184, 238]],

       ...,

       [[149, 173, 143],
        [150, 174, 146],
        [151, 176, 152],
        ...,
        [141, 176, 155],
        [130, 167, 136],
        [133, 160, 132]],

       [[155, 178, 150],
        [156, 178, 153],
        [155, 179, 156],
        ...,
        [131, 160, 136],
        [146, 173, 141],
        [162, 178, 149]],

       [[158, 182, 155],
        [159, 181, 158],
        [159, 181, 158],
        ...,
        [160, 184, 165],
        [157, 182, 171],
        [174, 193, 173]]], dtype=uint8)]"
Image_1314.jpg,512,230,194,212,990,681,706,442,212,daskShared_local/images/Image_1314.jpg,1314,"[array([[[ 36,  35,  17],
        [ 32,  31,  13],
        [ 32,  31,  13],
        ...,
        [ 13,   5,   3],
        [ 17,   8,   3],
        [ 23,  10,   4]],

       [[ 34,  33,  13],
        [ 30,  29,  11],
        [ 31,  30,  12],
        ...,
        [ 13,   6,   2],
        [ 17,   6,   2],
        [ 22,   9,   1]],

       [[ 31,  30,  10],
        [ 28,  27,   9],
        [ 29,  28,  10],
        ...,
        [ 18,   9,   4],
        [ 18,   8,   1],
        [ 23,   9,   0]],

       ...,

       [[110,  96,  60],
        [155, 141, 103],
        [183, 170, 129],
        ...,
        [ 87,  97,  74],
        [ 79,  89,  65],
        [ 57,  67,  43]],

       [[137, 122,  84],
        [169, 154, 113],
        [180, 166, 123],
        ...,
        [ 80,  90,  66],
        [ 67,  77,  53],
        [ 50,  60,  36]],

       [[183, 168, 127],
        [193, 178, 135],
        [189, 172, 128],
        ...,
        [ 56,  66,  42],
        [ 48,  58,  34],
        [ 46,  56,  32]]], dtype=uint8)]"
Image_1315.jpg,481,161,117,89,660,438,598,250,117,daskShared_local/images/Image_1315.jpg,1315,"[array([[[  3,  30,  77],
        [  4,  31,  77],
        [  5,  32,  77],
        ...,
        [ 10,  24,  61],
        [ 10,  24,  60],
        [ 10,  24,  60]],

       [[  3,  30,  77],
        [  3,  30,  76],
        [  4,  30,  75],
        ...,
        [ 10,  25,  63],
        [  9,  23,  60],
        [  8,  23,  59]],

       [[  2,  29,  76],
        [  1,  29,  75],
        [  0,  26,  71],
        ...,
        [ 13,  28,  67],
        [  5,  21,  59],
        [  3,  19,  57]],

       ...,

       [[  3,  19,  73],
        [  3,  20,  75],
        [  2,  25,  81],
        ...,
        [101,  93, 107],
        [122, 118, 121],
        [128, 126, 125]],

       [[ 81,  85,  93],
        [ 77,  83,  94],
        [ 65,  77,  98],
        ...,
        [ 74,  68,  74],
        [ 97,  94,  90],
        [104, 102,  95]],

       [[105, 105, 100],
        [100, 102, 100],
        [ 84,  93, 103],
        ...,
        [ 66,  60,  64],
        [ 89,  87,  80],
        [ 96,  95,  86]]], dtype=uint8)]"
Image_1316.jpg,377,159,125,125,900,600,502,284,125,daskShared_local/images/Image_1316.jpg,1316,"[array([[[126, 127, 172],
        [126, 129, 173],
        [125, 133, 177],
        ...,
        [109, 110, 130],
        [118, 117, 133],
        [123, 121, 134]],

       [[110, 122, 172],
        [109, 124, 173],
        [108, 127, 177],
        ...,
        [106, 107, 128],
        [118, 117, 131],
        [124, 121, 133]],

       [[ 72, 110, 172],
        [ 71, 112, 173],
        [ 69, 115, 177],
        ...,
        [102, 103, 123],
        [118, 116, 129],
        [126, 122, 131]],

       ...,

       [[  0,  76, 162],
        [  0,  75, 161],
        [  0,  74, 161],
        ...,
        [120,  88, 113],
        [131,  99, 121],
        [135, 103, 125]],

       [[  0,  75, 163],
        [  0,  75, 163],
        [  1,  75, 164],
        ...,
        [129,  97, 117],
        [132, 101, 120],
        [134, 102, 122]],

       [[  0,  75, 163],
        [  0,  75, 164],
        [  1,  76, 166],
        ...,
        [132, 101, 119],
        [133, 101, 119],
        [132, 101, 119]]], dtype=uint8)]"
Image_1317.jpg,411,122,125,108,759,422,536,230,125,daskShared_local/images/Image_1317.jpg,1317,"[array([[[151, 220, 220],
        [143, 212, 212],
        [125, 193, 194],
        ...,
        [ 12, 142, 152],
        [  5, 137, 147],
        [  2, 135, 145]],

       [[141, 211, 211],
        [136, 206, 206],
        [125, 194, 195],
        ...,
        [ 11, 142, 152],
        [  5, 138, 148],
        [  3, 136, 146]],

       [[123, 193, 193],
        [124, 194, 194],
        [128, 198, 198],
        ...,
        [  9, 142, 151],
        [  6, 140, 150],
        [  5, 138, 149]],

       ...,

       [[  1, 154, 188],
        [  1, 154, 188],
        [  1, 154, 188],
        ...,
        [  1, 131, 153],
        [  1, 131, 153],
        [  1, 131, 153]],

       [[  2, 153, 188],
        [  2, 153, 188],
        [  2, 153, 188],
        ...,
        [  0, 130, 152],
        [  0, 130, 152],
        [  0, 130, 152]],

       [[  3, 153, 188],
        [  3, 153, 188],
        [  3, 153, 188],
        ...,
        [  0, 129, 151],
        [  0, 129, 151],
        [  0, 129, 151]]], dtype=uint8)]"
Image_1318.jpg,480,147,229,292,981,650,709,439,292,daskShared_local/images/Image_1318.jpg,1318,"[array([[[245, 245, 245],
        [245, 245, 245],
        [245, 245, 245],
        ...,
        [243, 243, 243],
        [243, 243, 243],
        [243, 243, 243]],

       [[245, 245, 245],
        [245, 245, 245],
        [245, 245, 245],
        ...,
        [243, 243, 243],
        [243, 243, 243],
        [243, 243, 243]],

       [[244, 244, 244],
        [244, 244, 244],
        [244, 244, 244],
        ...,
        [243, 243, 243],
        [243, 243, 243],
        [243, 243, 243]],

       ...,

       [[ 19,  90, 172],
        [ 19,  90, 172],
        [ 20,  91, 173],
        ...,
        [ 21,  89, 173],
        [ 19,  87, 170],
        [ 22,  90, 172]],

       [[ 19,  90, 172],
        [ 19,  90, 172],
        [ 19,  90, 172],
        ...,
        [ 17,  84, 171],
        [ 16,  84, 169],
        [ 20,  88, 171]],

       [[ 20,  91, 173],
        [ 20,  91, 173],
        [ 19,  90, 172],
        ...,
        [ 15,  82, 171],
        [ 15,  82, 169],
        [ 16,  84, 169]]], dtype=uint8)]"
Image_1319.jpg,403,298,227,239,1500,1000,630,537,239,daskShared_local/images/Image_1319.jpg,1319,"[array([[[  2, 143, 170],
        [  0, 141, 168],
        [  0, 138, 162],
        ...,
        [ 18, 134, 154],
        [ 12, 127, 146],
        [  8, 120, 140]],

       [[  2, 146, 172],
        [  0, 144, 169],
        [  0, 141, 164],
        ...,
        [ 11, 130, 149],
        [  6, 123, 141],
        [  3, 117, 136]],

       [[  2, 148, 173],
        [  0, 147, 172],
        [  0, 145, 167],
        ...,
        [  1, 118, 137],
        [  0, 113, 131],
        [  0, 111, 128]],

       ...,

       [[ 95, 126,  93],
        [ 96, 129,  95],
        [ 82, 117,  89],
        ...,
        [131, 123,  67],
        [181, 175, 120],
        [191, 186, 131]],

       [[ 86, 115,  77],
        [ 90, 122,  84],
        [ 85, 120,  91],
        ...,
        [152, 145,  88],
        [182, 177, 120],
        [189, 184, 129]],

       [[ 90, 116,  77],
        [ 90, 119,  79],
        [ 83, 118,  87],
        ...,
        [113, 107,  49],
        [140, 134,  78],
        [156, 151,  95]]], dtype=uint8)]"
Image_132.jpg,166,9,103,99,498,272,269,108,103,daskShared_local/images/Image_132.jpg,132,"[array([[[  2,  35,  69],
        [  2,  35,  69],
        [  2,  35,  69],
        ...,
        [  0,  28,  52],
        [  0,  29,  52],
        [  0,  29,  52]],

       [[  2,  35,  69],
        [  2,  35,  69],
        [  2,  35,  69],
        ...,
        [  0,  28,  52],
        [  0,  29,  52],
        [  0,  29,  52]],

       [[  2,  36,  72],
        [  2,  36,  72],
        [  2,  36,  72],
        ...,
        [  0,  29,  53],
        [  0,  29,  52],
        [  0,  29,  52]],

       ...,

       [[ 92,  99,  96],
        [ 92,  99,  96],
        [ 93,  99, 101],
        ...,
        [167, 180, 173],
        [170, 185, 179],
        [171, 185, 179]],

       [[ 96, 105, 107],
        [ 97, 105, 107],
        [100, 109, 112],
        ...,
        [175, 188, 180],
        [177, 191, 184],
        [177, 192, 185]],

       [[ 97, 106, 108],
        [ 97, 106, 108],
        [100, 110, 113],
        ...,
        [176, 189, 181],
        [177, 192, 185],
        [178, 192, 185]]], dtype=uint8)]"
Image_1320.jpg,1297,617,178,202,2304,1536,1475,819,202,daskShared_local/images/Image_1320.jpg,1320,"[array([[[  0, 107, 149],
        [  1, 107, 149],
        [  1, 107, 149],
        ...,
        [  0, 119, 149],
        [  0, 118, 150],
        [  0, 118, 150]],

       [[  1, 106, 151],
        [  1, 107, 149],
        [  2, 108, 150],
        ...,
        [  1, 119, 149],
        [  1, 119, 149],
        [  1, 118, 151]],

       [[  0, 105, 150],
        [  1, 106, 151],
        [  1, 107, 149],
        ...,
        [  1, 116, 147],
        [  2, 117, 148],
        [  4, 119, 150]],

       ...,

       [[ 76, 128, 146],
        [ 80, 127, 144],
        [ 78, 127, 136],
        ...,
        [ 23,  30,  48],
        [ 23,  30,  48],
        [ 20,  27,  45]],

       [[ 76, 131, 152],
        [ 85, 137, 160],
        [ 80, 131, 147],
        ...,
        [ 22,  32,  44],
        [ 23,  30,  46],
        [ 21,  28,  46]],

       [[ 77, 134, 154],
        [ 74, 131, 150],
        [ 61, 114, 128],
        ...,
        [ 24,  34,  44],
        [ 24,  33,  48],
        [ 22,  30,  49]]], dtype=uint8)]"
Image_1321.jpg,186,93,346,288,1024,670,532,381,346,daskShared_local/images/Image_1321.jpg,1321,"[array([[[ 28,  41,  53],
        [ 18,  34,  48],
        [ 26,  44,  59],
        ...,
        [ 24, 154, 142],
        [ 34,  99, 112],
        [ 19,  85,  99]],

       [[ 20,  34,  48],
        [ 18,  34,  49],
        [ 23,  40,  56],
        ...,
        [  6, 111, 115],
        [ 68, 131, 147],
        [ 45, 110, 128]],

       [[ 25,  41,  57],
        [ 28,  44,  62],
        [ 29,  46,  66],
        ...,
        [ 39, 114, 124],
        [ 44, 107, 124],
        [ 46, 113, 131]],

       ...,

       [[  8,  66,  57],
        [  8,  20,  27],
        [  2,   4,  20],
        ...,
        [ 77, 126, 128],
        [ 88, 189, 201],
        [ 50, 147, 163]],

       [[  1,  84,  61],
        [  1,  29,  20],
        [ 10,  10,  13],
        ...,
        [ 60, 123, 122],
        [ 55, 165, 176],
        [ 54, 164, 178]],

       [[ 34, 121,  98],
        [  8,  60,  41],
        [  2,  19,  10],
        ...,
        [ 64, 148, 148],
        [ 68, 161, 178],
        [ 78, 172, 191]]], dtype=uint8)]"
Image_1322.jpg,247,213,132,153,775,518,379,366,153,daskShared_local/images/Image_1322.jpg,1322,"[array([[[ 55,  61,  25],
        [ 57,  65,  26],
        [ 60,  69,  30],
        ...,
        [156, 127, 104],
        [154, 126, 104],
        [151, 123, 102]],

       [[ 53,  60,  22],
        [ 55,  63,  24],
        [ 57,  67,  27],
        ...,
        [153, 124,  99],
        [156, 127, 103],
        [150, 122,  99]],

       [[ 53,  60,  22],
        [ 55,  62,  23],
        [ 57,  66,  25],
        ...,
        [157, 127, 100],
        [161, 131, 105],
        [148, 119,  93]],

       ...,

       [[103,  67,  32],
        [123,  88,  51],
        [138, 102,  63],
        ...,
        [172, 129,  88],
        [168, 124,  84],
        [167, 123,  84]],

       [[108,  72,  39],
        [121,  85,  50],
        [131,  95,  58],
        ...,
        [163, 120,  78],
        [153, 110,  69],
        [150, 107,  66]],

       [[113,  77,  47],
        [122,  86,  53],
        [129,  93,  58],
        ...,
        [155, 112,  70],
        [145, 102,  60],
        [142,  98,  57]]], dtype=uint8)]"
Image_1323.jpg,304,302,151,145,966,642,455,447,151,daskShared_local/images/Image_1323.jpg,1323,"[array([[[ 36, 210, 214],
        [ 31, 206, 209],
        [ 25, 201, 204],
        ...,
        [115,  89,  56],
        [111,  92,  66],
        [ 95,  77,  57]],

       [[ 37, 214, 218],
        [ 33, 210, 214],
        [ 29, 205, 209],
        ...,
        [100,  76,  46],
        [111,  86,  62],
        [109,  80,  57]],

       [[ 36, 216, 224],
        [ 33, 212, 220],
        [ 32, 208, 217],
        ...,
        [ 90,  57,  34],
        [125,  86,  60],
        [144,  98,  71]],

       ...,

       [[ 25, 196, 215],
        [ 24, 195, 213],
        [ 23, 196, 211],
        ...,
        [ 49, 232, 241],
        [ 50, 230, 240],
        [ 51, 229, 239]],

       [[ 21, 193, 209],
        [ 19, 193, 207],
        [ 19, 196, 207],
        ...,
        [ 61, 236, 249],
        [ 58, 232, 246],
        [ 56, 229, 243]],

       [[ 22, 192, 207],
        [ 20, 192, 207],
        [ 20, 196, 207],
        ...,
        [ 67, 238, 252],
        [ 64, 235, 250],
        [ 62, 233, 247]]], dtype=uint8)]"
Image_1324.jpg,725,327,180,141,1600,1000,905,468,180,daskShared_local/images/Image_1324.jpg,1324,"[array([[[  0,  83, 169],
        [  0,  83, 169],
        [  0,  83, 169],
        ...,
        [  0,  83, 169],
        [  0,  83, 169],
        [  0,  83, 169]],

       [[  0,  83, 169],
        [  0,  83, 169],
        [  0,  83, 169],
        ...,
        [  0,  83, 169],
        [  0,  83, 169],
        [  0,  83, 169]],

       [[  0,  83, 169],
        [  0,  83, 169],
        [  0,  83, 169],
        ...,
        [  0,  83, 169],
        [  0,  83, 169],
        [  0,  83, 169]],

       ...,

       [[  0,  63, 135],
        [  0,  63, 135],
        [  0,  63, 135],
        ...,
        [184, 157, 136],
        [184, 158, 130],
        [195, 174, 137]],

       [[  0,  63, 135],
        [  0,  63, 135],
        [  0,  63, 135],
        ...,
        [163, 135, 112],
        [161, 134, 104],
        [175, 151, 113]],

       [[  0,  63, 135],
        [  0,  63, 135],
        [  0,  63, 135],
        ...,
        [180, 150, 128],
        [182, 152, 125],
        [182, 156, 119]]], dtype=uint8)]"
Image_1325.jpg,407,318,133,136,800,600,540,454,136,daskShared_local/images/Image_1325.jpg,1325,"[array([[[206, 205, 183],
        [200, 202, 179],
        [192, 198, 175],
        ...,
        [  2,  93, 105],
        [  2,  93, 104],
        [  2,  93, 105]],

       [[206, 205, 177],
        [201, 202, 174],
        [194, 199, 173],
        ...,
        [  3,  90, 103],
        [  3,  91, 103],
        [  3,  91, 103]],

       [[207, 198, 163],
        [202, 196, 161],
        [196, 196, 163],
        ...,
        [  3,  88, 101],
        [  3,  88, 101],
        [  2,  89, 101]],

       ...,

       [[ 39,  55,  54],
        [ 39,  55,  54],
        [ 38,  55,  53],
        ...,
        [ 28,  95,  73],
        [ 27, 100,  69],
        [ 27, 103,  66]],

       [[ 34,  52,  51],
        [ 34,  52,  51],
        [ 33,  52,  51],
        ...,
        [ 37, 108,  69],
        [ 37, 109,  69],
        [ 36, 108,  67]],

       [[ 32,  51,  50],
        [ 31,  50,  49],
        [ 31,  50,  49],
        ...,
        [ 45, 118,  67],
        [ 45, 117,  70],
        [ 44, 114,  70]]], dtype=uint8)]"
Image_1326.jpg,700,284,507,530,1920,1080,1207,814,530,daskShared_local/images/Image_1326.jpg,1326,"[array([[[ 40,  57,  53],
        [ 43,  58,  51],
        [ 46,  63,  52],
        ...,
        [ 45,  57,  55],
        [ 19,  38,  40],
        [ 19,  40,  44]],

       [[ 33,  54,  51],
        [ 42,  61,  52],
        [ 42,  61,  50],
        ...,
        [ 47,  57,  56],
        [ 25,  43,  45],
        [ 17,  38,  40]],

       [[ 26,  52,  51],
        [ 35,  56,  46],
        [ 38,  58,  47],
        ...,
        [ 46,  59,  58],
        [ 28,  48,  49],
        [ 22,  45,  45]],

       ...,

       [[ 29,  95, 145],
        [ 28,  94, 146],
        [ 29,  95, 145],
        ...,
        [ 25,  45,  40],
        [ 24,  45,  40],
        [ 25,  43,  43]],

       [[ 30,  96, 146],
        [ 29,  95, 146],
        [ 29,  95, 145],
        ...,
        [ 23,  44,  39],
        [ 22,  44,  39],
        [ 27,  45,  44]],

       [[ 29,  95, 145],
        [ 27,  93, 143],
        [ 28,  94, 143],
        ...,
        [ 24,  44,  41],
        [ 23,  44,  39],
        [ 25,  45,  41]]], dtype=uint8)]"
Image_1327.jpg,160,175,172,141,728,500,332,316,172,daskShared_local/images/Image_1327.jpg,1327,"[array([[[  1,  71, 221],
        [  1,  71, 221],
        [  2,  71, 220],
        ...,
        [  0,  81, 225],
        [  0,  81, 225],
        [  0,  81, 225]],

       [[  1,  69, 219],
        [  1,  69, 219],
        [  1,  69, 218],
        ...,
        [  0,  81, 224],
        [  0,  82, 224],
        [  0,  81, 224]],

       [[  1,  68, 218],
        [  0,  67, 217],
        [  1,  68, 217],
        ...,
        [  0,  81, 224],
        [  0,  82, 224],
        [  0,  81, 224]],

       ...,

       [[ 12, 134, 145],
        [ 10, 126, 143],
        [ 18, 134, 150],
        ...,
        [222, 203, 172],
        [193, 148, 121],
        [221, 187, 155]],

       [[ 14, 140, 147],
        [ 12, 128, 143],
        [ 20, 133, 150],
        ...,
        [215, 193, 164],
        [188, 150, 120],
        [222, 207, 177]],

       [[ 13, 135, 146],
        [ 14, 129, 143],
        [ 17, 130, 143],
        ...,
        [212, 177, 150],
        [209, 170, 135],
        [219, 202, 181]]], dtype=uint8)]"
Image_1328.jpg,802,325,153,139,1536,1024,955,464,153,daskShared_local/images/Image_1328.jpg,1328,"[array([[[ 39, 125, 215],
        [ 44, 122, 212],
        [ 48, 121, 208],
        ...,
        [ 47, 124, 214],
        [ 47, 124, 214],
        [ 46, 123, 213]],

       [[ 40, 125, 217],
        [ 44, 123, 212],
        [ 50, 121, 209],
        ...,
        [ 46, 123, 213],
        [ 46, 123, 213],
        [ 45, 122, 212]],

       [[ 41, 125, 215],
        [ 43, 124, 211],
        [ 47, 122, 210],
        ...,
        [ 46, 123, 213],
        [ 45, 123, 213],
        [ 44, 123, 212]],

       ...,

       [[ 18, 114, 201],
        [ 18, 114, 201],
        [ 17, 115, 202],
        ...,
        [  8, 112, 202],
        [ 11, 113, 202],
        [ 13, 113, 203]],

       [[ 17, 113, 199],
        [ 17, 113, 200],
        [ 18, 114, 201],
        ...,
        [  9, 113, 203],
        [ 11, 114, 203],
        [ 13, 114, 204]],

       [[ 17, 113, 199],
        [ 18, 113, 200],
        [ 19, 114, 201],
        ...,
        [  9, 114, 204],
        [ 11, 114, 203],
        [ 13, 114, 204]]], dtype=uint8)]"
Image_1329.jpg,1872,2536,424,440,2720,4080,2296,2976,440,daskShared_local/images/Image_1329.jpg,1329,"[array([[[  9, 132, 199],
        [  3, 126, 193],
        [  4, 126, 193],
        ...,
        [  2, 116, 190],
        [  3, 120, 194],
        [  3, 119, 193]],

       [[  2, 121, 187],
        [  1, 120, 186],
        [ 10, 134, 200],
        ...,
        [  3, 120, 194],
        [  4, 121, 195],
        [  1, 116, 190]],

       [[  5, 130, 196],
        [ 10, 135, 201],
        [  8, 133, 199],
        ...,
        [  7, 124, 198],
        [  2, 116, 190],
        [  8, 126, 200]],

       ...,

       [[  4, 116, 190],
        [  6, 118, 192],
        [  2, 113, 187],
        ...,
        [  3, 112, 187],
        [  4, 112, 187],
        [  5, 114, 189]],

       [[  6, 117, 191],
        [  3, 114, 188],
        [  8, 119, 193],
        ...,
        [  5, 114, 189],
        [  3, 110, 185],
        [  7, 116, 191]],

       [[  5, 116, 190],
        [  5, 116, 190],
        [  1, 109, 183],
        ...,
        [  5, 114, 189],
        [  2, 110, 185],
        [  4, 112, 187]]], dtype=uint8)]"
Image_133.JPG,541,401,458,321,1600,1467,999,722,458,daskShared_local/images/Image_133.JPG,133,"[array([[[ 36,  46,  57],
        [ 41,  58,  63],
        [ 52,  67,  70],
        ...,
        [ 57,  59,  67],
        [ 82,  82,  89],
        [ 81,  80,  85]],

       [[ 37,  47,  57],
        [ 33,  50,  62],
        [ 47,  66,  75],
        ...,
        [ 59,  60,  66],
        [ 84,  84,  93],
        [ 78,  78,  88]],

       [[ 40,  50,  60],
        [ 33,  51,  63],
        [ 43,  63,  72],
        ...,
        [ 58,  61,  70],
        [ 71,  73,  84],
        [ 72,  74,  83]],

       ...,

       [[214, 224, 176],
        [212, 219, 171],
        [211, 218, 171],
        ...,
        [236, 239, 231],
        [236, 239, 230],
        [239, 242, 234]],

       [[221, 226, 174],
        [223, 228, 179],
        [220, 228, 179],
        ...,
        [249, 252, 246],
        [251, 253, 249],
        [252, 254, 250]],

       [[228, 231, 175],
        [229, 236, 183],
        [230, 238, 187],
        ...,
        [232, 237, 232],
        [247, 252, 249],
        [251, 254, 254]]], dtype=uint8)]"
Image_1330.jpg,74,84,122,135,637,450,196,219,135,daskShared_local/images/Image_1330.jpg,1330,"[array([[[  2, 173, 253],
        [  2, 173, 253],
        [  2, 173, 253],
        ...,
        [  1, 170, 255],
        [  1, 169, 255],
        [  2, 168, 254]],

       [[  1, 172, 252],
        [  1, 172, 252],
        [  2, 173, 253],
        ...,
        [  1, 170, 255],
        [  1, 169, 254],
        [  2, 168, 255]],

       [[  1, 172, 252],
        [  1, 172, 252],
        [  1, 172, 253],
        ...,
        [  0, 169, 254],
        [  1, 168, 254],
        [  2, 167, 255]],

       ...,

       [[  0, 133, 238],
        [  0, 133, 239],
        [  0, 135, 240],
        ...,
        [ 14, 109,  98],
        [ 10, 102,  91],
        [  6,  96,  86]],

       [[  0, 133, 238],
        [  0, 134, 239],
        [  0, 136, 240],
        ...,
        [  9, 104,  96],
        [  5,  94,  87],
        [  1,  88,  81]],

       [[  0, 133, 238],
        [  0, 134, 239],
        [  0, 136, 240],
        ...,
        [  7, 101,  94],
        [  3,  90,  85],
        [  1,  84,  79]]], dtype=uint8)]"
Image_1331.jpg,281,126,105,117,775,518,386,243,117,daskShared_local/images/Image_1331.jpg,1331,"[array([[[ 86, 157, 175],
        [ 86, 157, 175],
        [ 88, 159, 177],
        ...,
        [ 97, 166, 182],
        [ 96, 165, 181],
        [ 96, 165, 181]],

       [[ 86, 157, 175],
        [ 86, 157, 175],
        [ 88, 159, 177],
        ...,
        [ 99, 168, 183],
        [ 97, 166, 181],
        [ 96, 165, 181]],

       [[ 85, 156, 174],
        [ 85, 156, 174],
        [ 87, 158, 176],
        ...,
        [105, 174, 189],
        [ 98, 167, 182],
        [ 96, 165, 180]],

       ...,

       [[159, 124,  98],
        [160, 125,  99],
        [164, 130, 103],
        ...,
        [ 63,  36,  27],
        [ 65,  43,  25],
        [ 65,  45,  24]],

       [[162, 126, 100],
        [165, 129, 103],
        [175, 139, 113],
        ...,
        [ 94,  64,  52],
        [ 88,  63,  45],
        [ 87,  63,  42]],

       [[163, 126, 100],
        [166, 130, 104],
        [178, 142, 116],
        ...,
        [103,  72,  60],
        [ 95,  69,  51],
        [ 93,  68,  48]]], dtype=uint8)]"
Image_1332.jpg,618,307,164,141,1440,960,782,448,164,daskShared_local/images/Image_1332.jpg,1332,"[array([[[  0, 144, 207],
        [  0, 144, 207],
        [  0, 145, 208],
        ...,
        [  1, 145, 215],
        [  1, 145, 215],
        [  1, 145, 215]],

       [[  0, 144, 207],
        [  0, 145, 208],
        [  0, 145, 208],
        ...,
        [  1, 145, 215],
        [  1, 145, 215],
        [  1, 145, 215]],

       [[  0, 144, 207],
        [  0, 145, 208],
        [  1, 146, 209],
        ...,
        [  1, 145, 215],
        [  1, 145, 215],
        [  1, 145, 215]],

       ...,

       [[ 55,  56,  39],
        [ 69,  70,  53],
        [ 79,  82,  66],
        ...,
        [  0,  79, 117],
        [  0,  79, 118],
        [  0,  80, 118]],

       [[ 31,  40,  27],
        [ 30,  38,  26],
        [ 47,  54,  42],
        ...,
        [  0,  79, 117],
        [  0,  80, 118],
        [  0,  81, 119]],

       [[ 41,  57,  47],
        [ 31,  45,  35],
        [ 34,  46,  37],
        ...,
        [  0,  78, 116],
        [  0,  80, 118],
        [  0,  82, 120]]], dtype=uint8)]"
Image_1333.jpg,458,146,129,114,1024,512,587,260,129,daskShared_local/images/Image_1333.jpg,1333,"[array([[[  1, 136, 192],
        [  1, 136, 192],
        [  0, 137, 192],
        ...,
        [  0, 167, 211],
        [  0, 166, 210],
        [  0, 166, 210]],

       [[  1, 136, 192],
        [  1, 136, 192],
        [  0, 137, 192],
        ...,
        [  0, 167, 211],
        [  0, 166, 210],
        [  0, 166, 210]],

       [[  1, 136, 192],
        [  1, 136, 192],
        [  0, 137, 192],
        ...,
        [  0, 166, 210],
        [  0, 165, 209],
        [  0, 165, 209]],

       ...,

       [[216, 196, 171],
        [218, 198, 172],
        [219, 199, 175],
        ...,
        [  0, 143, 196],
        [  0, 144, 197],
        [  0, 144, 197]],

       [[199, 181, 155],
        [205, 186, 161],
        [214, 194, 170],
        ...,
        [  0, 143, 196],
        [  0, 144, 197],
        [  0, 144, 197]],

       [[192, 174, 148],
        [199, 181, 156],
        [213, 193, 169],
        ...,
        [  0, 144, 197],
        [  0, 144, 197],
        [  1, 145, 198]]], dtype=uint8)]"
Image_1334.jpg,108,74,92,67,475,264,200,141,92,daskShared_local/images/Image_1334.jpg,1334,"[array([[[24, 44, 62],
        [24, 44, 62],
        [23, 44, 62],
        ...,
        [27, 54, 83],
        [29, 56, 84],
        [29, 56, 84]],

       [[24, 44, 62],
        [24, 44, 62],
        [23, 44, 62],
        ...,
        [26, 52, 82],
        [28, 55, 83],
        [28, 54, 82]],

       [[23, 43, 62],
        [23, 43, 62],
        [21, 42, 61],
        ...,
        [33, 61, 91],
        [35, 63, 92],
        [35, 63, 92]],

       ...,

       [[16, 25, 32],
        [15, 24, 32],
        [16, 25, 33],
        ...,
        [41, 58, 60],
        [41, 58, 60],
        [41, 58, 60]],

       [[16, 25, 33],
        [15, 24, 33],
        [16, 25, 33],
        ...,
        [37, 54, 58],
        [37, 53, 57],
        [37, 54, 57]],

       [[16, 25, 33],
        [15, 24, 33],
        [16, 25, 33],
        ...,
        [37, 55, 58],
        [38, 54, 58],
        [38, 54, 58]]], dtype=uint8)]"
Image_1335.jpg,580,166,183,181,1000,665,763,347,183,daskShared_local/images/Image_1335.jpg,1335,"[array([[[ 41, 133, 200],
        [ 45, 135, 201],
        [ 50, 136, 201],
        ...,
        [ 43, 135, 197],
        [ 51, 137, 198],
        [ 23, 130, 195]],

       [[ 38, 133, 201],
        [ 38, 132, 201],
        [ 51, 135, 201],
        ...,
        [ 27, 131, 196],
        [ 22, 131, 196],
        [ 16, 128, 196]],

       [[ 35, 133, 200],
        [ 40, 133, 202],
        [ 37, 133, 201],
        ...,
        [ 30, 131, 197],
        [ 20, 130, 197],
        [ 15, 128, 196]],

       ...,

       [[ 14,  74,  84],
        [ 21,  80,  89],
        [ 27,  85,  93],
        ...,
        [  1,  63,  75],
        [  1,  62,  74],
        [  3,  63,  75]],

       [[ 14,  76,  88],
        [ 16,  76,  87],
        [ 21,  76,  87],
        ...,
        [  5,  79,  92],
        [  6,  79,  91],
        [  5,  76,  88]],

       [[ 31, 100, 116],
        [ 28,  95, 111],
        [ 23,  83,  98],
        ...,
        [  2,  80,  92],
        [  4,  82,  94],
        [  3,  81,  94]]], dtype=uint8)]"
Image_1336.jpg,773,542,1260,1468,3072,2304,2033,2010,1468,daskShared_local/images/Image_1336.jpg,1336,"[array([[[ 82,  74,  63],
        [ 75,  67,  58],
        [ 73,  64,  60],
        ...,
        [ 97,  73,  85],
        [129, 106, 119],
        [164, 147, 151]],

       [[ 81,  74,  64],
        [ 77,  68,  63],
        [ 75,  66,  64],
        ...,
        [ 72,  48,  61],
        [ 91,  68,  84],
        [122, 104, 111]],

       [[ 81,  72,  66],
        [ 78,  68,  66],
        [ 77,  68,  67],
        ...,
        [ 67,  45,  52],
        [ 76,  54,  65],
        [ 94,  72,  84]],

       ...,

       [[  6, 113, 119],
        [  5, 112, 118],
        [  7, 114, 122],
        ...,
        [  7,  96, 108],
        [ 10,  94, 112],
        [ 19, 100, 120]],

       [[  6, 113, 121],
        [  6, 113, 121],
        [  8, 114, 123],
        ...,
        [  6,  94, 108],
        [ 13,  99, 117],
        [ 29, 109, 131]],

       [[  5, 112, 122],
        [  5, 112, 121],
        [  7, 113, 123],
        ...,
        [  9,  96, 113],
        [ 17, 107, 124],
        [ 29, 112, 132]]], dtype=uint8)]"
Image_1337.jpg,196,339,298,196,1024,768,494,535,298,daskShared_local/images/Image_1337.jpg,1337,"[array([[[ 52,  88, 107],
        [ 54,  88, 114],
        [ 64,  97, 128],
        ...,
        [ 46,  78,  99],
        [ 31,  63,  84],
        [ 48,  80, 101]],

       [[ 51,  88, 107],
        [ 48,  83, 108],
        [ 50,  85, 114],
        ...,
        [ 46,  75,  95],
        [ 84, 112, 133],
        [ 84, 114, 134]],

       [[ 70, 112, 130],
        [ 80, 118, 141],
        [ 65, 103, 128],
        ...,
        [119, 144, 163],
        [ 62,  87, 106],
        [ 65,  88, 108]],

       ...,

       [[110, 160, 165],
        [157, 212, 213],
        [143, 200, 191],
        ...,
        [ 21,  10,  26],
        [ 21,  11,  27],
        [ 23,  11,  27]],

       [[148, 205, 198],
        [161, 218, 207],
        [142, 198, 179],
        ...,
        [ 18,   7,  22],
        [ 22,  11,  27],
        [ 25,  13,  29]],

       [[136, 194, 182],
        [136, 192, 175],
        [110, 162, 141],
        ...,
        [ 21,  10,  24],
        [ 22,  14,  27],
        [ 26,  17,  30]]], dtype=uint8)]"
Image_1338.jpg,504,135,206,169,800,600,710,304,206,daskShared_local/images/Image_1338.jpg,1338,"[array([[[  8,  23,  54],
        [  5,  20,  51],
        [  2,  17,  48],
        ...,
        [  8,  11,  18],
        [ 10,  11,  16],
        [  7,   6,  12]],

       [[  2,  18,  54],
        [  3,  17,  52],
        [  4,  19,  52],
        ...,
        [  9,   9,  17],
        [ 10,   9,  15],
        [  6,   5,  11]],

       [[  0,  19,  53],
        [  0,  19,  51],
        [  0,  18,  46],
        ...,
        [  8,   9,  17],
        [  8,   8,  14],
        [  5,   5,  10]],

       ...,

       [[209, 177, 129],
        [196, 166, 112],
        [183, 158, 104],
        ...,
        [ 44,  46,  43],
        [ 36,  38,  36],
        [ 35,  37,  36]],

       [[215, 184, 140],
        [201, 169, 120],
        [171, 145,  93],
        ...,
        [ 34,  37,  30],
        [ 34,  36,  33],
        [ 37,  39,  38]],

       [[211, 183, 143],
        [200, 169, 122],
        [162, 134,  85],
        ...,
        [ 33,  36,  25],
        [ 31,  33,  28],
        [ 29,  31,  30]]], dtype=uint8)]"
Image_1339.jpg,106,103,411,295,800,533,517,398,411,daskShared_local/images/Image_1339.jpg,1339,"[array([[[  3,  11,  56],
        [  5,  10,  56],
        [  4,   9,  55],
        ...,
        [  7,  20,  71],
        [  8,  19,  69],
        [ 12,  22,  73]],

       [[ 16,  26,  76],
        [ 13,  21,  73],
        [  3,   8,  61],
        ...,
        [  9,  19,  68],
        [  8,  19,  67],
        [  5,  16,  66]],

       [[  8,  16,  64],
        [ 27,  37,  89],
        [ 22,  32,  87],
        ...,
        [ 13,  21,  71],
        [  8,  19,  68],
        [  3,  16,  65]],

       ...,

       [[  8,  16,  60],
        [  6,  14,  58],
        [  9,  14,  59],
        ...,
        [117,  93,  61],
        [ 90,  65,  34],
        [ 76,  52,  18]],

       [[  8,  15,  59],
        [  7,  15,  58],
        [  9,  14,  58],
        ...,
        [134, 110,  77],
        [126,  99,  62],
        [117,  88,  47]],

       [[  8,  15,  59],
        [  7,  14,  58],
        [  8,  15,  59],
        ...,
        [145, 126,  92],
        [167, 143, 111],
        [152, 124,  92]]], dtype=uint8)]"
Image_134.jpg,677,287,287,325,1600,900,964,612,325,daskShared_local/images/Image_134.jpg,134,"[array([[[  0, 116, 200],
        [  0, 116, 200],
        [  0, 116, 200],
        ...,
        [  0, 119, 202],
        [  0, 119, 202],
        [  0, 119, 202]],

       [[  0, 116, 199],
        [  0, 116, 199],
        [  0, 116, 199],
        ...,
        [  0, 118, 202],
        [  0, 119, 203],
        [  0, 119, 203]],

       [[  0, 116, 199],
        [  0, 116, 199],
        [  0, 116, 199],
        ...,
        [  0, 118, 202],
        [  0, 119, 203],
        [  0, 119, 203]],

       ...,

       [[191, 187, 147],
        [196, 192, 149],
        [216, 212, 175],
        ...,
        [ 67,  76,  64],
        [106, 107,  96],
        [150, 145, 121]],

       [[186, 180, 145],
        [193, 189, 152],
        [198, 194, 157],
        ...,
        [ 92, 102,  75],
        [ 75,  80,  57],
        [113, 116,  87]],

       [[172, 168, 141],
        [173, 168, 144],
        [178, 173, 150],
        ...,
        [ 87,  95,  75],
        [ 68,  73,  54],
        [130, 133, 106]]], dtype=uint8)]"
Image_1340.jpg,106,371,416,313,1715,1286,522,684,416,daskShared_local/images/Image_1340.jpg,1340,"[array([[[142, 154, 142],
        [138, 154, 142],
        [139, 157, 145],
        ...,
        [ 77,  92,  79],
        [ 48,  52,  56],
        [ 46,  44,  49]],

       [[142, 154, 146],
        [142, 155, 147],
        [140, 158, 149],
        ...,
        [ 53,  60,  70],
        [ 50,  47,  57],
        [ 56,  51,  55]],

       [[144, 155, 150],
        [144, 156, 153],
        [142, 158, 155],
        ...,
        [ 53,  51,  63],
        [ 55,  54,  60],
        [ 60,  58,  59]],

       ...,

       [[199, 204, 199],
        [200, 204, 197],
        [197, 203, 196],
        ...,
        [211, 220, 222],
        [211, 217, 220],
        [212, 216, 220]],

       [[196, 202, 201],
        [198, 200, 200],
        [194, 198, 198],
        ...,
        [210, 218, 225],
        [210, 219, 221],
        [210, 219, 221]],

       [[195, 202, 202],
        [193, 200, 201],
        [182, 192, 193],
        ...,
        [207, 217, 226],
        [210, 219, 225],
        [212, 219, 223]]], dtype=uint8)]"
Image_1341.jpg,314,278,154,115,1280,720,468,393,154,daskShared_local/images/Image_1341.jpg,1341,"[array([[[  0,  60, 133],
        [  0,  60, 133],
        [  0,  60, 133],
        ...,
        [  0,  62, 139],
        [  0,  62, 139],
        [  0,  62, 139]],

       [[  0,  60, 133],
        [  0,  60, 133],
        [  0,  60, 133],
        ...,
        [  0,  62, 139],
        [  0,  62, 139],
        [  0,  62, 139]],

       [[  0,  60, 133],
        [  0,  60, 133],
        [  0,  60, 133],
        ...,
        [  0,  62, 139],
        [  0,  62, 139],
        [  0,  62, 139]],

       ...,

       [[ 32, 106, 130],
        [ 32, 106, 130],
        [ 32, 106, 130],
        ...,
        [ 25,  95, 128],
        [ 24,  97, 125],
        [ 24,  97, 122]],

       [[ 33, 108, 131],
        [ 33, 108, 131],
        [ 33, 108, 131],
        ...,
        [ 25,  93, 127],
        [ 25,  95, 124],
        [ 26,  98, 123]],

       [[ 34, 109, 132],
        [ 34, 109, 132],
        [ 34, 109, 132],
        ...,
        [ 25,  92, 127],
        [ 24,  94, 124],
        [ 26,  96, 122]]], dtype=uint8)]"
Image_1342.jpg,345,20,620,529,1190,595,965,549,620,daskShared_local/images/Image_1342.jpg,1342,"[array([[[207, 225, 235],
        [210, 228, 238],
        [213, 232, 242],
        ...,
        [203, 215, 205],
        [202, 215, 205],
        [202, 214, 204]],

       [[216, 233, 244],
        [217, 237, 246],
        [217, 236, 245],
        ...,
        [204, 216, 206],
        [202, 215, 206],
        [202, 216, 206]],

       [[217, 235, 246],
        [219, 238, 246],
        [217, 235, 243],
        ...,
        [203, 214, 206],
        [203, 214, 205],
        [201, 216, 206]],

       ...,

       [[136,  50,  74],
        [104,  35,  52],
        [108,  33,  57],
        ...,
        [153,  94,  89],
        [164, 120, 111],
        [167, 137, 130]],

       [[183,  58, 102],
        [172,  44,  83],
        [160,  44,  79],
        ...,
        [151,  94,  85],
        [160, 118, 111],
        [162, 131, 127]],

       [[164,  42,  84],
        [182,  66, 102],
        [169,  45,  83],
        ...,
        [150,  94,  84],
        [157, 115, 107],
        [155, 120, 114]]], dtype=uint8)]"
Image_1343.jpg,1607,511,923,652,4100,2660,2530,1163,923,daskShared_local/images/Image_1343.jpg,1343,"[array([[[178, 166, 149],
        [179, 167, 157],
        [181, 172, 163],
        ...,
        [138, 128, 120],
        [136, 126, 116],
        [136, 127, 114]],

       [[179, 167, 151],
        [182, 170, 158],
        [183, 173, 163],
        ...,
        [134, 124, 113],
        [134, 125, 113],
        [134, 126, 112]],

       [[179, 167, 152],
        [179, 166, 151],
        [179, 166, 152],
        ...,
        [135, 127, 114],
        [133, 126, 112],
        [133, 125, 109]],

       ...,

       [[169, 154, 134],
        [139, 125, 103],
        [120, 107,  89],
        ...,
        [136, 114,  82],
        [132, 112,  78],
        [129, 108,  66]],

       [[175, 159, 141],
        [176, 159, 142],
        [177, 163, 154],
        ...,
        [141, 123,  84],
        [132, 116,  78],
        [125, 105,  66]],

       [[168, 152, 130],
        [178, 160, 145],
        [183, 165, 154],
        ...,
        [138, 121,  89],
        [132, 116,  88],
        [128, 110,  74]]], dtype=uint8)]"
Image_1344.jpg,341,120,189,203,770,422,530,323,203,daskShared_local/images/Image_1344.jpg,1344,"[array([[[105, 108,  99],
        [101, 111, 102],
        [103, 108,  86],
        ...,
        [ 46, 127, 219],
        [ 44, 123, 215],
        [ 26, 106, 195]],

       [[120, 118,  94],
        [117, 117,  92],
        [109,  99,  70],
        ...,
        [ 33, 112, 205],
        [ 27, 106, 198],
        [ 27, 107, 196]],

       [[203, 186, 133],
        [191, 174, 118],
        [178, 144,  96],
        ...,
        [ 25, 104, 198],
        [ 21, 100, 193],
        [ 25, 104, 196]],

       ...,

       [[ 51,  71,  16],
        [ 64,  81,  32],
        [ 67,  83,  35],
        ...,
        [  0,  17,  41],
        [  0,  18,  41],
        [  1,  19,  41]],

       [[ 43,  63,  14],
        [ 55,  72,  30],
        [ 59,  73,  36],
        ...,
        [  0,  20,  44],
        [  1,  21,  45],
        [  2,  20,  42]],

       [[ 40,  57,  21],
        [ 44,  60,  31],
        [ 37,  49,  27],
        ...,
        [  5,  23,  47],
        [  5,  25,  49],
        [  2,  20,  42]]], dtype=uint8)]"
Image_1345.jpg,438,196,202,198,900,600,640,394,202,daskShared_local/images/Image_1345.jpg,1345,"[array([[[  4, 133, 237],
        [  4, 132, 239],
        [  4, 132, 239],
        ...,
        [  1,  90, 208],
        [  2,  91, 207],
        [  2,  91, 207]],

       [[  3, 132, 236],
        [  3, 131, 238],
        [  3, 131, 238],
        ...,
        [  0,  89, 207],
        [  2,  91, 209],
        [  3,  92, 210]],

       [[  1, 132, 238],
        [  1, 132, 238],
        [  1, 132, 238],
        ...,
        [  0,  89, 207],
        [  2,  91, 209],
        [  3,  92, 210]],

       ...,

       [[176, 157,  89],
        [162, 138,  68],
        [120,  92,  19],
        ...,
        [ 28,  70, 103],
        [ 24,  68, 122],
        [  1,  49, 114]],

       [[104,  90,  15],
        [116,  97,  20],
        [119,  94,  14],
        ...,
        [ 26,  69, 110],
        [ 12,  60, 121],
        [  3,  52, 128]],

       [[162, 152,  83],
        [124, 107,  37],
        [161, 139,  66],
        ...,
        [ 18,  61, 109],
        [  1,  49, 120],
        [  9,  61, 145]]], dtype=uint8)]"
Image_1346.jpg,100,107,141,130,500,375,241,237,141,daskShared_local/images/Image_1346.jpg,1346,"[array([[[135, 204, 213],
        [133, 203, 211],
        [128, 198, 206],
        ...,
        [ 42,  92, 117],
        [ 42,  92, 117],
        [ 42,  93, 117]],

       [[ 99, 174, 184],
        [100, 176, 186],
        [102, 178, 188],
        ...,
        [ 43,  93, 118],
        [ 43,  94, 118],
        [ 44,  96, 119]],

       [[ 58, 136, 152],
        [ 61, 139, 155],
        [ 66, 144, 160],
        ...,
        [ 40,  89, 118],
        [ 43,  93, 119],
        [ 45,  96, 120]],

       ...,

       [[ 23, 115, 138],
        [ 23, 115, 138],
        [ 25, 117, 140],
        ...,
        [197, 181, 168],
        [198, 186, 174],
        [199, 191, 180]],

       [[ 22, 114, 137],
        [ 22, 114, 137],
        [ 23, 115, 138],
        ...,
        [200, 185, 173],
        [203, 191, 181],
        [203, 196, 187]],

       [[ 21, 113, 136],
        [ 22, 114, 137],
        [ 22, 114, 137],
        ...,
        [201, 187, 176],
        [205, 194, 185],
        [205, 199, 191]]], dtype=uint8)]"
Image_1347.jpg,333,267,247,231,750,740,580,498,247,daskShared_local/images/Image_1347.jpg,1347,"[array([[[108, 231, 247],
        [112, 234, 250],
        [126, 236, 253],
        ...,
        [ 11, 197, 220],
        [ 10, 195, 218],
        [ 11, 193, 217]],

       [[100, 226, 247],
        [105, 229, 250],
        [114, 227, 252],
        ...,
        [ 11, 197, 219],
        [ 10, 195, 218],
        [ 11, 193, 216]],

       [[ 86, 221, 244],
        [ 90, 221, 245],
        [ 95, 215, 244],
        ...,
        [ 10, 197, 218],
        [ 10, 195, 216],
        [ 11, 193, 215]],

       ...,

       [[111, 187, 182],
        [110, 185, 181],
        [119, 184, 172],
        ...,
        [110, 164, 160],
        [109, 162, 158],
        [112, 166, 161]],

       [[107, 184, 168],
        [109, 184, 171],
        [116, 185, 169],
        ...,
        [114, 170, 168],
        [110, 166, 164],
        [111, 166, 164]],

       [[106, 180, 151],
        [113, 184, 158],
        [119, 187, 166],
        ...,
        [125, 181, 181],
        [117, 173, 174],
        [112, 168, 169]]], dtype=uint8)]"
Image_1348.jpg,629,443,215,194,1024,672,844,637,215,daskShared_local/images/Image_1348.jpg,1348,"[array([[[125, 125, 132],
        [125, 124, 130],
        [121, 118, 125],
        ...,
        [128, 130, 128],
        [156, 159, 154],
        [165, 166, 160]],

       [[113, 113, 121],
        [113, 112, 120],
        [112, 109, 116],
        ...,
        [ 73,  80,  74],
        [ 97, 104,  94],
        [121, 125, 113]],

       [[101, 101, 109],
        [101, 100, 108],
        [103, 100, 107],
        ...,
        [ 43,  54,  46],
        [ 44,  55,  42],
        [ 54,  64,  47]],

       ...,

       [[ 41,  90, 151],
        [ 41,  90, 151],
        [ 40,  90, 149],
        ...,
        [ 17, 122, 231],
        [ 19, 124, 233],
        [ 20, 123, 233]],

       [[ 36,  89, 151],
        [ 37,  90, 152],
        [ 37,  91, 152],
        ...,
        [ 18, 123, 232],
        [ 20, 125, 234],
        [ 20, 122, 232]],

       [[ 29,  84, 148],
        [ 30,  85, 149],
        [ 32,  88, 149],
        ...,
        [ 20, 123, 231],
        [ 22, 124, 232],
        [ 19, 121, 229]]], dtype=uint8)]"
Image_1349.jpg,306,106,235,293,1000,667,541,399,293,daskShared_local/images/Image_1349.jpg,1349,"[array([[[ 66,  94, 126],
        [102, 118, 139],
        [150, 144, 147],
        ...,
        [115, 102,  86],
        [108,  95,  79],
        [111,  98,  82]],

       [[159, 159, 164],
        [198, 184, 177],
        [206, 189, 177],
        ...,
        [120, 107,  90],
        [121, 109,  92],
        [128, 115,  99]],

       [[212, 186, 165],
        [219, 186, 161],
        [233, 208, 187],
        ...,
        [136, 123, 104],
        [163, 152, 133],
        [199, 186, 170]],

       ...,

       [[ 24, 106, 162],
        [ 27, 109, 165],
        [ 23, 105, 161],
        ...,
        [ 48,  35,  11],
        [ 50,  34,  16],
        [ 59,  35,  15]],

       [[ 26, 108, 164],
        [ 28, 110, 166],
        [ 24, 106, 162],
        ...,
        [145, 112,  72],
        [129,  96,  62],
        [ 92,  65,  39]],

       [[ 25, 107, 163],
        [ 25, 107, 163],
        [ 25, 107, 163],
        ...,
        [141, 108,  74],
        [ 75,  45,  16],
        [ 64,  41,  17]]], dtype=uint8)]"
Image_135.jpg,75,73,93,85,300,260,168,158,93,daskShared_local/images/Image_135.jpg,135,"[array([[[  3, 229, 254],
        [  3, 229, 254],
        [  3, 229, 254],
        ...,
        [  6, 197, 235],
        [  6, 195, 234],
        [  6, 196, 234]],

       [[  3, 228, 254],
        [  3, 228, 254],
        [  3, 228, 254],
        ...,
        [  6, 197, 236],
        [  6, 196, 235],
        [  6, 196, 235]],

       [[  1, 229, 254],
        [  1, 229, 253],
        [  1, 229, 254],
        ...,
        [  3, 193, 231],
        [  3, 192, 229],
        [  3, 192, 230]],

       ...,

       [[  1, 185, 240],
        [  1, 185, 241],
        [  1, 186, 240],
        ...,
        [ 13,  83,  61],
        [ 32, 102,  69],
        [ 30,  99,  68]],

       [[  0, 185, 239],
        [  0, 185, 239],
        [  0, 186, 238],
        ...,
        [ 19,  82,  59],
        [ 45, 106,  65],
        [ 42, 103,  64]],

       [[  1, 185, 239],
        [  1, 185, 239],
        [  1, 186, 238],
        ...,
        [ 19,  82,  60],
        [ 43, 106,  66],
        [ 40, 103,  65]]], dtype=uint8)]"
Image_1350.jpg,388,3,89,69,530,180,477,72,89,daskShared_local/images/Image_1350.jpg,1350,"[array([[[  5,  48,  92],
        [  5,  48,  93],
        [  5,  48,  90],
        ...,
        [  1,  12,  56],
        [  2,  17,  57],
        [  2,  16,  57]],

       [[  6,  49,  94],
        [  6,  49,  95],
        [  5,  48,  91],
        ...,
        [  1,  13,  58],
        [  2,  18,  58],
        [  2,  17,  58]],

       [[  5,  46,  90],
        [  4,  46,  90],
        [  6,  48,  89],
        ...,
        [  1,  11,  55],
        [  2,  15,  56],
        [  1,  14,  55]],

       ...,

       [[117, 123, 132],
        [126, 134, 140],
        [ 83,  86, 104],
        ...,
        [ 81,  75,  81],
        [ 70,  68,  71],
        [ 73,  69,  73]],

       [[177, 178, 151],
        [190, 191, 158],
        [134, 134, 129],
        ...,
        [ 95,  88,  91],
        [ 75,  72,  75],
        [ 79,  75,  79]],

       [[152, 155, 143],
        [163, 167, 150],
        [113, 114, 119],
        ...,
        [ 89,  83,  87],
        [ 73,  70,  74],
        [ 77,  73,  77]]], dtype=uint8)]"
Image_1351.jpg,744,254,373,322,1200,906,1117,576,373,daskShared_local/images/Image_1351.jpg,1351,"[array([[[184, 173, 178],
        [166, 157, 166],
        [133, 128, 140],
        ...,
        [ 16,  48,  69],
        [ 15,  47,  68],
        [ 14,  46,  67]],

       [[180, 168, 173],
        [175, 166, 174],
        [162, 155, 167],
        ...,
        [ 16,  47,  69],
        [ 13,  44,  65],
        [ 12,  44,  65]],

       [[167, 155, 160],
        [171, 161, 170],
        [158, 151, 162],
        ...,
        [ 14,  44,  68],
        [ 12,  42,  66],
        [ 13,  43,  67]],

       ...,

       [[ 61,  84,  97],
        [ 58,  77,  91],
        [ 69,  85, 100],
        ...,
        [ 26,  55,  76],
        [ 42,  65,  85],
        [ 46,  69,  87]],

       [[ 84, 105, 117],
        [133, 150, 163],
        [114, 126, 141],
        ...,
        [ 21,  51,  69],
        [ 35,  57,  77],
        [ 42,  62,  81]],

       [[153, 175, 186],
        [175, 193, 206],
        [126, 139, 154],
        ...,
        [ 19,  49,  67],
        [ 28,  49,  68],
        [ 35,  54,  71]]], dtype=uint8)]"
Image_1352.jpg,285,129,152,122,800,505,437,251,152,daskShared_local/images/Image_1352.jpg,1352,"[array([[[ 60,  74,  67],
        [ 63,  78,  72],
        [ 78,  92,  88],
        ...,
        [ 28,  45,  54],
        [ 24,  42,  50],
        [ 19,  39,  46]],

       [[ 57,  71,  66],
        [ 57,  73,  67],
        [ 68,  83,  78],
        ...,
        [ 20,  38,  48],
        [ 17,  37,  45],
        [ 13,  35,  43]],

       [[ 52,  68,  62],
        [ 51,  68,  62],
        [ 56,  74,  68],
        ...,
        [ 11,  32,  43],
        [ 10,  31,  41],
        [  8,  30,  40]],

       ...,

       [[ 87,  92,  57],
        [ 90,  93,  57],
        [ 91,  93,  57],
        ...,
        [232, 209, 177],
        [221, 197, 165],
        [213, 190, 157]],

       [[ 95,  98,  63],
        [ 98, 100,  64],
        [102, 104,  67],
        ...,
        [216, 194, 162],
        [211, 188, 156],
        [215, 192, 159]],

       [[103, 104,  70],
        [106, 108,  72],
        [110, 112,  75],
        ...,
        [201, 180, 149],
        [201, 180, 147],
        [213, 190, 158]]], dtype=uint8)]"
Image_1353.jpg,426,208,127,180,900,600,553,388,180,daskShared_local/images/Image_1353.jpg,1353,"[array([[[  4, 108, 163],
        [  4, 108, 163],
        [  4, 108, 163],
        ...,
        [  7, 121, 171],
        [  5, 119, 169],
        [  4, 118, 168]],

       [[  4, 108, 163],
        [  4, 108, 163],
        [  4, 108, 163],
        ...,
        [  7, 121, 171],
        [  5, 119, 169],
        [  4, 118, 168]],

       [[  4, 108, 163],
        [  4, 108, 163],
        [  4, 108, 163],
        ...,
        [  6, 120, 170],
        [  5, 119, 169],
        [  5, 119, 169]],

       ...,

       [[179, 176, 107],
        [158, 154,  87],
        [110, 106,  43],
        ...,
        [  6,  94, 142],
        [  6,  94, 142],
        [  7,  95, 143]],

       [[144, 141,  63],
        [132, 128,  52],
        [121, 117,  44],
        ...,
        [  5,  93, 141],
        [  6,  94, 142],
        [  6,  94, 142]],

       [[ 90,  86,   4],
        [101,  96,  13],
        [156, 151,  67],
        ...,
        [  5,  93, 141],
        [  6,  94, 142],
        [  6,  94, 142]]], dtype=uint8)]"
Image_1354.jpg,739,156,264,194,1050,700,1003,350,264,daskShared_local/images/Image_1354.jpg,1354,"[array([[[  1, 105,  96],
        [  8, 152, 135],
        [ 18, 175, 161],
        ...,
        [ 15,  34,  38],
        [ 13,  34,  44],
        [ 20,  33,  45]],

       [[  7, 147, 132],
        [  8, 170, 148],
        [  5, 174, 153],
        ...,
        [ 30,  36,  50],
        [ 21,  41,  52],
        [ 26,  41,  54]],

       [[  8, 170, 153],
        [  3, 169, 147],
        [  2, 171, 148],
        ...,
        [ 23,  32,  41],
        [ 27,  46,  49],
        [ 29,  44,  49]],

       ...,

       [[ 42,  51,  56],
        [ 39,  49,  53],
        [ 35,  46,  50],
        ...,
        [ 11, 123, 103],
        [ 71, 149, 143],
        [152, 210, 192]],

       [[ 40,  49,  54],
        [ 35,  45,  50],
        [ 31,  42,  46],
        ...,
        [ 77, 153, 127],
        [ 63, 137, 111],
        [100, 161, 134]],

       [[ 42,  53,  57],
        [ 38,  49,  53],
        [ 33,  44,  48],
        ...,
        [113, 184, 162],
        [106, 180, 154],
        [101, 162, 136]]], dtype=uint8)]"
Image_1355.jpg,345,101,319,286,1024,670,664,387,319,daskShared_local/images/Image_1355.jpg,1355,"[array([[[  7,  88, 119],
        [ 14,  97, 130],
        [ 22, 107, 139],
        ...,
        [  5,  17,  31],
        [  8,  20,  34],
        [  9,  21,  33]],

       [[  3,  76, 115],
        [  4,  78, 118],
        [  2,  77, 119],
        ...,
        [  9,  21,  35],
        [ 10,  22,  36],
        [  7,  19,  32]],

       [[  2,  65, 110],
        [  1,  64, 111],
        [  1,  65, 114],
        ...,
        [  8,  20,  34],
        [  5,  17,  31],
        [ 14,  26,  38]],

       ...,

       [[ 11,  58,  18],
        [ 53, 122,  71],
        [ 41, 111,  61],
        ...,
        [ 11,  23,  25],
        [ 13,  25,  28],
        [ 11,  24,  26]],

       [[ 38,  93,  41],
        [ 69, 153,  89],
        [ 67, 149,  97],
        ...,
        [ 16,  27,  29],
        [ 17,  29,  31],
        [ 13,  24,  26]],

       [[ 49,  98,  50],
        [ 72, 145,  86],
        [ 61, 133,  85],
        ...,
        [ 12,  26,  27],
        [ 12,  26,  27],
        [  9,  23,  25]]], dtype=uint8)]"
Image_1356.jpg,263,332,153,113,900,599,416,445,153,daskShared_local/images/Image_1356.jpg,1356,"[array([[[ 65, 132, 210],
        [ 66, 133, 211],
        [ 66, 133, 211],
        ...,
        [ 80, 152, 198],
        [ 87, 158, 201],
        [ 98, 168, 211]],

       [[ 65, 132, 210],
        [ 66, 133, 211],
        [ 66, 133, 211],
        ...,
        [ 85, 152, 193],
        [ 97, 163, 201],
        [122, 186, 224]],

       [[ 65, 132, 210],
        [ 66, 133, 211],
        [ 66, 133, 211],
        ...,
        [111, 169, 201],
        [131, 187, 217],
        [147, 201, 231]],

       ...,

       [[ 45,  82, 162],
        [ 46,  83, 163],
        [ 46,  83, 163],
        ...,
        [ 45,  88, 166],
        [ 45,  88, 166],
        [ 45,  88, 166]],

       [[ 45,  82, 161],
        [ 45,  83, 162],
        [ 45,  83, 162],
        ...,
        [ 44,  88, 166],
        [ 44,  88, 166],
        [ 44,  88, 166]],

       [[ 44,  83, 160],
        [ 44,  83, 160],
        [ 44,  83, 160],
        ...,
        [ 43,  89, 166],
        [ 43,  89, 166],
        [ 43,  89, 166]]], dtype=uint8)]"
Image_1357.jpg,278,163,263,232,1000,541,541,395,263,daskShared_local/images/Image_1357.jpg,1357,"[array([[[  0, 131, 170],
        [  2, 134, 171],
        [ 10, 134, 170],
        ...,
        [ 15,  95, 121],
        [ 24,  83, 104],
        [ 31,  72,  90]],

       [[  1, 124, 159],
        [  1, 129, 163],
        [ 10, 134, 167],
        ...,
        [ 10,  95, 122],
        [ 22,  86, 107],
        [ 30,  75,  94]],

       [[  4, 120, 152],
        [  2, 126, 158],
        [  9, 135, 167],
        ...,
        [  4,  95, 122],
        [ 18,  88, 111],
        [ 29,  79,  99]],

       ...,

       [[  0,  80, 100],
        [  1,  73,  92],
        [  0,  57,  74],
        ...,
        [122, 142, 166],
        [ 98, 127, 152],
        [ 82, 112, 138]],

       [[  2,  91, 109],
        [  0,  81,  97],
        [  0,  69,  85],
        ...,
        [168, 188, 209],
        [137, 166, 186],
        [ 97, 129, 149]],

       [[  1,  96, 113],
        [  2,  84,  98],
        [  3,  71,  87],
        ...,
        [132, 158, 187],
        [ 86, 117, 143],
        [111, 145, 167]]], dtype=uint8)]"
Image_1358.jpg,397,179,154,130,770,578,551,309,154,daskShared_local/images/Image_1358.jpg,1358,"[array([[[ 93,  96, 101],
        [ 90,  93,  99],
        [ 83,  86,  94],
        ...,
        [102, 104,  95],
        [102, 103,  95],
        [100, 102,  94]],

       [[ 83,  87,  92],
        [ 80,  84,  90],
        [ 73,  76,  84],
        ...,
        [ 97,  99,  89],
        [101, 102,  94],
        [101, 103,  95]],

       [[ 73,  78,  82],
        [ 69,  73,  78],
        [ 61,  64,  70],
        ...,
        [ 94,  96,  86],
        [100, 102,  94],
        [102, 105,  97]],

       ...,

       [[159, 168, 167],
        [150, 159, 158],
        [121, 130, 128],
        ...,
        [ 51,  44,  57],
        [ 50,  41,  53],
        [ 43,  33,  42]],

       [[148, 156, 155],
        [155, 163, 162],
        [139, 146, 145],
        ...,
        [ 82,  79,  90],
        [ 83,  78,  88],
        [ 55,  49,  57]],

       [[121, 125, 126],
        [148, 153, 154],
        [151, 155, 156],
        ...,
        [135, 137, 144],
        [137, 139, 145],
        [ 94,  94, 100]]], dtype=uint8)]"
Image_1359.jpg,294,366,181,153,1024,683,475,519,181,daskShared_local/images/Image_1359.jpg,1359,"[array([[[179, 194, 191],
        [170, 187, 189],
        [167, 194, 191],
        ...,
        [ 93, 102,  91],
        [ 91,  99,  88],
        [ 94, 100,  88]],

       [[166, 181, 178],
        [160, 177, 177],
        [149, 175, 175],
        ...,
        [ 78,  84,  74],
        [ 90,  94,  84],
        [ 98, 101,  89]],

       [[161, 177, 174],
        [153, 171, 171],
        [141, 166, 170],
        ...,
        [ 71,  72,  62],
        [ 84,  82,  73],
        [ 89,  87,  77]],

       ...,

       [[  0, 104, 131],
        [  0, 104, 131],
        [  0, 106, 132],
        ...,
        [  0, 114, 140],
        [  0, 114, 140],
        [  0, 114, 140]],

       [[  0, 104, 131],
        [  0, 104, 131],
        [  0, 106, 132],
        ...,
        [  0, 113, 139],
        [  0, 113, 139],
        [  0, 113, 139]],

       [[  0, 104, 131],
        [  0, 104, 131],
        [  0, 106, 132],
        ...,
        [  0, 113, 139],
        [  0, 113, 139],
        [  0, 113, 139]]], dtype=uint8)]"
Image_136.jpg,324,274,99,69,800,600,423,343,99,daskShared_local/images/Image_136.jpg,136,"[array([[[  0, 158, 255],
        [  0, 158, 255],
        [  0, 158, 255],
        ...,
        [  1, 164, 255],
        [  1, 164, 255],
        [  1, 164, 255]],

       [[  0, 158, 255],
        [  0, 158, 255],
        [  0, 158, 255],
        ...,
        [  1, 164, 255],
        [  1, 164, 255],
        [  1, 164, 255]],

       [[  0, 158, 255],
        [  0, 158, 255],
        [  0, 158, 255],
        ...,
        [  1, 164, 255],
        [  1, 164, 255],
        [  1, 164, 255]],

       ...,

       [[128, 177, 131],
        [128, 177, 131],
        [116, 167, 111],
        ...,
        [ 28,  36,  27],
        [ 31,  39,  29],
        [ 31,  39,  29]],

       [[144, 196, 160],
        [144, 196, 160],
        [130, 182, 137],
        ...,
        [ 31,  38,  29],
        [ 34,  41,  32],
        [ 34,  41,  32]],

       [[144, 196, 160],
        [144, 196, 160],
        [130, 182, 137],
        ...,
        [ 31,  38,  30],
        [ 34,  41,  33],
        [ 34,  41,  32]]], dtype=uint8)]"
Image_1360.jpg,179,203,451,313,1599,1065,630,516,451,daskShared_local/images/Image_1360.jpg,1360,"[array([[[  4,   1,   2],
        [  4,   1,   2],
        [  4,   1,   2],
        ...,
        [  4,   0,   1],
        [  4,   0,   1],
        [  5,   1,   2]],

       [[  3,   1,   2],
        [  3,   1,   2],
        [  3,   1,   2],
        ...,
        [  4,   0,   1],
        [  4,   0,   1],
        [  4,   0,   1]],

       [[  3,   1,   2],
        [  3,   1,   2],
        [  3,   1,   2],
        ...,
        [  4,   0,   1],
        [  4,   0,   1],
        [  4,   0,   1]],

       ...,

       [[  3,   1,   2],
        [  3,   1,   2],
        [  3,   1,   2],
        ...,
        [  3,   7,   7],
        [  0,   4,  20],
        [  2,   2,  31]],

       [[  3,   1,   2],
        [  3,   1,   2],
        [  3,   1,   2],
        ...,
        [ 29,  58,  31],
        [ 22,  44,  24],
        [ 19,  28,  18]],

       [[  3,   1,   2],
        [  3,   1,   2],
        [  3,   1,   2],
        ...,
        [ 38,  61,  78],
        [ 98, 122, 121],
        [ 78,  98,  72]]], dtype=uint8)]"
Image_1361.JPG,301,433,1521,1487,2560,1920,1822,1920,1521,daskShared_local/images/Image_1361.JPG,1361,"[array([[[ 87,  82,  29],
        [ 93,  79,  30],
        [ 87,  72,  32],
        ...,
        [170, 153, 130],
        [134, 122,  93],
        [134, 123,  87]],

       [[ 84,  77,  30],
        [ 89,  77,  34],
        [ 92,  74,  34],
        ...,
        [158, 145, 110],
        [143, 128,  97],
        [140, 128, 103]],

       [[ 91,  75,  30],
        [ 91,  73,  33],
        [ 91,  74,  28],
        ...,
        [146, 133,  98],
        [140, 128,  89],
        [143, 130,  92]],

       ...,

       [[ 73,  84,  27],
        [ 77,  87,  35],
        [ 99, 104,  67],
        ...,
        [ 88, 101,  26],
        [ 89,  99,  28],
        [ 85, 102,  30]],

       [[ 71,  84,  24],
        [ 77,  88,  38],
        [106, 110,  77],
        ...,
        [ 89, 100,  27],
        [ 88,  98,  30],
        [ 89,  99,  33]],

       [[ 77,  83,  25],
        [ 78,  87,  34],
        [ 93, 105,  70],
        ...,
        [ 90,  98,  31],
        [ 88,  98,  32],
        [ 89,  94,  36]]], dtype=uint8)]"
Image_1362.jpg,292,420,191,181,1024,768,483,601,191,daskShared_local/images/Image_1362.jpg,1362,"[array([[[ 98,  78,  69],
        [ 69,  51,  43],
        [ 62,  50,  44],
        ...,
        [ 72,  50,  30],
        [ 57,  37,  26],
        [ 55,  38,  31]],

       [[108,  94,  81],
        [106,  99,  85],
        [ 86,  78,  58],
        ...,
        [ 71,  49,  26],
        [ 60,  42,  29],
        [ 51,  36,  33]],

       [[108,  89,  73],
        [142, 127, 111],
        [113, 100,  84],
        ...,
        [ 65,  44,  23],
        [ 57,  39,  26],
        [ 54,  37,  29]],

       ...,

       [[224, 207, 175],
        [236, 215, 184],
        [223, 203, 170],
        ...,
        [199, 165, 121],
        [215, 183, 140],
        [199, 168, 128]],

       [[238, 221, 195],
        [221, 203, 173],
        [231, 210, 180],
        ...,
        [203, 171, 128],
        [205, 177, 135],
        [189, 161, 121]],

       [[244, 224, 197],
        [230, 211, 181],
        [238, 217, 186],
        ...,
        [205, 176, 134],
        [192, 167, 127],
        [194, 171, 130]]], dtype=uint8)]"
Image_1363.jpg,552,193,293,280,986,653,845,473,293,daskShared_local/images/Image_1363.jpg,1363,"[array([[[ 72,  82,  69],
        [ 75,  85,  74],
        [ 77,  86,  75],
        ...,
        [ 59, 118,  96],
        [ 60, 119,  97],
        [ 60, 119,  97]],

       [[ 74,  82,  69],
        [ 77,  85,  74],
        [ 79,  87,  77],
        ...,
        [ 60, 118,  96],
        [ 61, 119,  97],
        [ 61, 119,  97]],

       [[ 70,  78,  66],
        [ 74,  82,  71],
        [ 77,  85,  74],
        ...,
        [ 60, 118,  96],
        [ 61, 119,  97],
        [ 61, 119,  97]],

       ...,

       [[ 82, 104,  52],
        [ 79, 103,  47],
        [ 77, 102,  45],
        ...,
        [ 57,  90,  61],
        [ 55,  88,  60],
        [ 53,  86,  59]],

       [[ 83, 106,  54],
        [ 80, 104,  50],
        [ 76, 104,  46],
        ...,
        [ 52,  82,  53],
        [ 51,  81,  53],
        [ 51,  80,  54]],

       [[ 82, 105,  55],
        [ 79, 104,  49],
        [ 75, 103,  45],
        ...,
        [ 51,  80,  50],
        [ 51,  80,  52],
        [ 51,  80,  52]]], dtype=uint8)]"
Image_1364.jpg,648,229,358,300,2121,1063,1006,529,358,daskShared_local/images/Image_1364.jpg,1364,"[array([[[176, 182, 176],
        [175, 181, 177],
        [171, 181, 180],
        ...,
        [194, 212, 219],
        [192, 213, 220],
        [183, 205, 214]],

       [[165, 182, 181],
        [164, 177, 176],
        [167, 180, 180],
        ...,
        [188, 211, 220],
        [186, 210, 220],
        [180, 205, 214]],

       [[122, 150, 159],
        [153, 175, 181],
        [156, 174, 174],
        ...,
        [165, 192, 203],
        [168, 195, 206],
        [166, 194, 204]],

       ...,

       [[ 56, 107, 126],
        [ 55, 106, 125],
        [ 54, 105, 124],
        ...,
        [147, 139, 120],
        [147, 139, 120],
        [157, 149, 130]],

       [[ 55, 106, 125],
        [ 52, 103, 122],
        [ 52, 103, 122],
        ...,
        [153, 146, 127],
        [156, 149, 130],
        [164, 158, 141]],

       [[ 49, 100, 119],
        [ 50, 101, 120],
        [ 52, 103, 122],
        ...,
        [157, 150, 132],
        [170, 164, 147],
        [164, 161, 146]]], dtype=uint8)]"
Image_1365.jpg,1843,405,349,276,3840,2160,2192,681,349,daskShared_local/images/Image_1365.jpg,1365,"[array([[[ 74, 156, 183],
        [ 68, 151, 176],
        [ 66, 151, 176],
        ...,
        [ 63, 141, 179],
        [ 60, 134, 170],
        [ 55, 129, 161]],

       [[ 71, 159, 186],
        [ 67, 153, 180],
        [ 71, 157, 182],
        ...,
        [ 41, 119, 154],
        [ 45, 123, 153],
        [ 47, 125, 151]],

       [[ 70, 159, 186],
        [ 65, 152, 180],
        [ 72, 158, 186],
        ...,
        [ 33, 116, 148],
        [ 35, 119, 145],
        [ 43, 125, 150]],

       ...,

       [[ 17,  85, 104],
        [ 20,  88, 107],
        [ 16,  84, 103],
        ...,
        [128, 127,  80],
        [128, 127,  79],
        [128, 127,  79]],

       [[ 24,  92, 111],
        [ 25,  93, 112],
        [ 24,  92, 111],
        ...,
        [118, 115,  70],
        [127, 125,  80],
        [106, 103,  58]],

       [[ 25,  93, 112],
        [ 22,  90, 109],
        [ 19,  87, 106],
        ...,
        [131, 126,  85],
        [122, 117,  76],
        [115, 110,  69]]], dtype=uint8)]"
Image_1366.jpg,62,141,116,108,525,340,178,249,116,daskShared_local/images/Image_1366.jpg,1366,"[array([[[ 18,  69,  89],
        [ 19,  70,  91],
        [ 23,  75,  97],
        ...,
        [185, 205, 156],
        [171, 190, 143],
        [167, 185, 140]],

       [[ 19,  70,  89],
        [ 20,  71,  91],
        [ 23,  75,  96],
        ...,
        [185, 205, 156],
        [175, 194, 147],
        [171, 190, 144]],

       [[ 23,  72,  92],
        [ 23,  72,  93],
        [ 21,  73,  94],
        ...,
        [186, 206, 155],
        [188, 206, 159],
        [188, 206, 160]],

       ...,

       [[ 29,  29,  19],
        [ 26,  26,  16],
        [ 16,  16,   6],
        ...,
        [ 15,  29,  14],
        [ 31,  47,  31],
        [ 36,  52,  36]],

       [[ 19,  21,  13],
        [ 19,  21,  13],
        [ 19,  20,  13],
        ...,
        [ 22,  35,  20],
        [ 48,  61,  47],
        [ 56,  69,  55]],

       [[ 16,  19,  11],
        [ 17,  19,  12],
        [ 20,  21,  15],
        ...,
        [ 24,  36,  22],
        [ 53,  66,  51],
        [ 61,  74,  60]]], dtype=uint8)]"
Image_1367.jpg,555,170,106,97,1000,700,661,267,106,daskShared_local/images/Image_1367.jpg,1367,"[array([[[  3, 159, 229],
        [  3, 159, 229],
        [  2, 159, 229],
        ...,
        [  0, 158, 232],
        [  0, 158, 232],
        [  0, 157, 232]],

       [[  3, 159, 229],
        [  3, 159, 229],
        [  2, 159, 229],
        ...,
        [  0, 158, 232],
        [  0, 158, 232],
        [  0, 158, 232]],

       [[  3, 157, 231],
        [  3, 157, 231],
        [  3, 157, 231],
        ...,
        [  1, 159, 233],
        [  1, 158, 234],
        [  1, 158, 234]],

       ...,

       [[124, 163, 173],
        [121, 160, 170],
        [ 97, 140, 148],
        ...,
        [  1, 149, 220],
        [  0, 150, 220],
        [  0, 150, 220]],

       [[109, 151, 160],
        [104, 147, 155],
        [ 67, 114, 122],
        ...,
        [  0, 150, 222],
        [  0, 151, 222],
        [  0, 151, 221]],

       [[107, 150, 158],
        [102, 145, 153],
        [ 63, 110, 119],
        ...,
        [  0, 151, 223],
        [  0, 151, 222],
        [  0, 151, 222]]], dtype=uint8)]"
Image_1368.jpg,389,37,1078,989,1920,1080,1467,1026,1078,daskShared_local/images/Image_1368.jpg,1368,"[array([[[  1, 125, 156],
        [  0, 125, 157],
        [  0, 124, 156],
        ...,
        [ 46, 115,  95],
        [ 45, 125, 105],
        [ 15, 106, 103]],

       [[  1, 125, 156],
        [  0, 125, 157],
        [  0, 125, 156],
        ...,
        [ 24, 108, 101],
        [ 24, 122, 114],
        [  6, 105, 108]],

       [[  0, 125, 156],
        [  0, 125, 157],
        [  0, 124, 156],
        ...,
        [ 49, 111,  92],
        [ 50, 121, 100],
        [ 20, 101,  98]],

       ...,

       [[ 99,  95,  57],
        [ 98,  92,  56],
        [101,  92,  53],
        ...,
        [ 14,  20,  22],
        [ 15,  20,  20],
        [ 17,  21,  19]],

       [[ 83,  81,  45],
        [ 90,  84,  48],
        [121, 111,  69],
        ...,
        [ 19,  22,  21],
        [ 23,  25,  19],
        [ 28,  28,  19]],

       [[ 83,  78,  44],
        [112, 105,  68],
        [122, 112,  70],
        ...,
        [ 33,  32,  22],
        [ 38,  36,  23],
        [ 40,  37,  24]]], dtype=uint8)]"
Image_1369.jpg,292,87,174,167,732,420,466,254,174,daskShared_local/images/Image_1369.jpg,1369,"[array([[[  1, 162, 214],
        [  1, 162, 214],
        [  1, 162, 214],
        ...,
        [ 77, 198, 236],
        [ 52, 196, 233],
        [ 42, 189, 225]],

       [[  1, 162, 214],
        [  1, 162, 214],
        [  1, 162, 214],
        ...,
        [ 61, 196, 229],
        [ 64, 200, 235],
        [ 61, 196, 233]],

       [[  1, 162, 214],
        [  1, 162, 214],
        [  1, 162, 214],
        ...,
        [ 47, 194, 224],
        [ 60, 198, 229],
        [ 64, 195, 230]],

       ...,

       [[205, 207, 200],
        [202, 208, 198],
        [200, 202, 191],
        ...,
        [  7,   1,   6],
        [  9,   1,  10],
        [  2,   1,   8]],

       [[181, 184, 153],
        [197, 199, 177],
        [210, 210, 197],
        ...,
        [  2,   2,   3],
        [  3,   2,   9],
        [  1,   4,   2]],

       [[166, 170, 121],
        [179, 182, 141],
        [193, 194, 162],
        ...,
        [  6,   0,   0],
        [  3,   1,   1],
        [  4,   6,   0]]], dtype=uint8)]"
Image_137.jpg,648,235,339,272,1000,1000,987,507,339,daskShared_local/images/Image_137.jpg,137,"[array([[[  1, 142, 171],
        [  1, 142, 170],
        [  0, 139, 166],
        ...,
        [  0, 131, 159],
        [  0, 127, 156],
        [  0, 128, 157]],

       [[  0, 141, 171],
        [  1, 142, 172],
        [  1, 142, 170],
        ...,
        [  1, 132, 160],
        [  0, 131, 159],
        [  1, 132, 160]],

       [[  1, 141, 173],
        [  1, 142, 172],
        [  2, 143, 173],
        ...,
        [  1, 132, 160],
        [  1, 132, 160],
        [  0, 131, 159]],

       ...,

       [[ 49,  33,  16],
        [ 44,  29,  12],
        [ 41,  29,  13],
        ...,
        [ 89,  77,  36],
        [ 90,  77,  45],
        [ 73,  60,  30]],

       [[ 65,  53,  28],
        [ 59,  47,  25],
        [ 40,  31,  12],
        ...,
        [ 78,  68,  30],
        [ 77,  64,  30],
        [ 85,  72,  38]],

       [[ 81,  73,  44],
        [ 82,  74,  49],
        [ 60,  53,  33],
        ...,
        [ 72,  63,  29],
        [ 78,  68,  33],
        [ 79,  69,  34]]], dtype=uint8)]"
Image_1370.jpg,437,374,214,209,1024,683,651,583,214,daskShared_local/images/Image_1370.jpg,1370,"[array([[[ 96,  77,  72],
        [ 91,  72,  65],
        [ 90,  74,  66],
        ...,
        [ 61,  49,  47],
        [ 67,  56,  54],
        [ 71,  57,  56]],

       [[ 89,  69,  61],
        [100,  81,  74],
        [126, 110, 102],
        ...,
        [ 73,  61,  60],
        [ 80,  69,  67],
        [ 74,  63,  61]],

       [[ 92,  72,  62],
        [165, 146, 139],
        [214, 198, 190],
        ...,
        [ 70,  59,  58],
        [ 78,  68,  66],
        [ 70,  59,  57]],

       ...,

       [[204, 178, 155],
        [250, 241, 216],
        [217, 208, 179],
        ...,
        [242, 225, 183],
        [251, 224, 178],
        [240, 201, 157]],

       [[197, 175, 133],
        [224, 194, 158],
        [198, 169, 135],
        ...,
        [243, 227, 183],
        [250, 211, 168],
        [238, 178, 135]],

       [[210, 186, 139],
        [235, 207, 163],
        [232, 209, 166],
        ...,
        [238, 226, 175],
        [253, 232, 188],
        [221, 169, 127]]], dtype=uint8)]"
Image_1371.jpg,526,95,317,293,1024,770,843,388,317,daskShared_local/images/Image_1371.jpg,1371,"[array([[[  3, 115, 189],
        [  3, 117, 190],
        [  1, 114, 188],
        ...,
        [ 46,  50,  55],
        [ 48,  55,  61],
        [ 33,  42,  49]],

       [[  4, 116, 190],
        [  5, 117, 191],
        [  2, 114, 188],
        ...,
        [ 41,  45,  49],
        [ 55,  62,  68],
        [ 36,  45,  51]],

       [[  4, 114, 189],
        [  5, 117, 191],
        [  3, 115, 189],
        ...,
        [ 41,  46,  51],
        [ 45,  52,  58],
        [ 41,  51,  58]],

       ...,

       [[181, 147,  99],
        [163, 134,  89],
        [164, 136, 103],
        ...,
        [ 46,  46,  44],
        [ 49,  51,  48],
        [ 53,  59,  53]],

       [[155, 123,  76],
        [111,  82,  38],
        [150, 123,  90],
        ...,
        [ 40,  43,  39],
        [ 34,  40,  35],
        [ 42,  52,  44]],

       [[173, 141,  94],
        [108,  79,  34],
        [125,  97,  65],
        ...,
        [ 34,  37,  34],
        [ 30,  36,  32],
        [ 42,  53,  45]]], dtype=uint8)]"
Image_1372.jpg,2278,253,576,526,3033,1757,2854,779,576,daskShared_local/images/Image_1372.jpg,1372,"[array([[[  0,  53, 217],
        [  0,  53, 217],
        [  0,  53, 217],
        ...,
        [  0,  53, 217],
        [  0,  53, 217],
        [  0,  53, 217]],

       [[  0,  53, 217],
        [  0,  53, 217],
        [  0,  53, 217],
        ...,
        [  0,  53, 217],
        [  0,  53, 217],
        [  0,  53, 217]],

       [[  0,  53, 217],
        [  0,  53, 217],
        [  0,  53, 217],
        ...,
        [  0,  53, 217],
        [  0,  53, 217],
        [  0,  53, 217]],

       ...,

       [[ 86,  96,  61],
        [ 90,  99,  66],
        [ 86,  95,  64],
        ...,
        [  0,  53, 217],
        [  0,  53, 217],
        [  0,  53, 217]],

       [[ 76,  86,  55],
        [ 73,  83,  54],
        [ 72,  82,  55],
        ...,
        [  0,  53, 217],
        [  0,  53, 217],
        [  0,  53, 217]],

       [[ 63,  74,  46],
        [ 61,  71,  46],
        [ 62,  71,  48],
        ...,
        [  0,  53, 217],
        [  0,  53, 217],
        [  0,  53, 217]]], dtype=uint8)]"
Image_1373.jpg,523,366,174,174,1024,678,697,540,174,daskShared_local/images/Image_1373.jpg,1373,"[array([[[117,  87,  85],
        [165, 137, 131],
        [171, 146, 135],
        ...,
        [185, 162, 136],
        [175, 155, 130],
        [164, 147, 117]],

       [[153, 138, 131],
        [175, 165, 157],
        [179, 171, 160],
        ...,
        [175, 144, 113],
        [161, 131, 115],
        [144, 119, 116]],

       [[149, 134, 133],
        [146, 135, 135],
        [142, 132, 130],
        ...,
        [195, 164, 112],
        [181, 151, 107],
        [162, 135, 105]],

       ...,

       [[242, 222, 179],
        [243, 224, 180],
        [242, 224, 179],
        ...,
        [237, 210, 162],
        [241, 215, 162],
        [238, 216, 161]],

       [[244, 222, 181],
        [249, 228, 187],
        [243, 225, 184],
        ...,
        [238, 218, 173],
        [250, 232, 183],
        [248, 232, 181]],

       [[242, 224, 184],
        [244, 225, 185],
        [242, 226, 189],
        ...,
        [238, 213, 166],
        [247, 227, 180],
        [250, 235, 188]]], dtype=uint8)]"
Image_1374.jpg,466,114,113,90,685,360,579,204,113,daskShared_local/images/Image_1374.jpg,1374,"[array([[[  0, 134, 158],
        [  0, 136, 159],
        [  0, 141, 163],
        ...,
        [  0, 102, 147],
        [  0, 102, 147],
        [  0, 102, 147]],

       [[  0, 129, 157],
        [  0, 130, 158],
        [  0, 135, 161],
        ...,
        [  0, 102, 146],
        [  0, 102, 146],
        [  0, 102, 146]],

       [[  0, 109, 153],
        [  0, 109, 153],
        [  0, 109, 153],
        ...,
        [  0, 101, 145],
        [  0, 101, 145],
        [  0, 101, 145]],

       ...,

       [[  0,  84, 120],
        [  0,  84, 120],
        [  0,  84, 120],
        ...,
        [  0,  83, 119],
        [  0,  83, 119],
        [  0,  83, 119]],

       [[  0,  84, 120],
        [  0,  84, 120],
        [  0,  84, 120],
        ...,
        [  0,  83, 119],
        [  0,  83, 119],
        [  0,  83, 119]],

       [[  0,  84, 120],
        [  0,  84, 120],
        [  0,  84, 120],
        ...,
        [  0,  83, 119],
        [  0,  83, 119],
        [  0,  83, 119]]], dtype=uint8)]"
Image_1375.jpg,333,262,126,131,1000,667,459,393,131,daskShared_local/images/Image_1375.jpg,1375,"[array([[[ 29, 209, 226],
        [ 29, 209, 226],
        [ 25, 208, 228],
        ...,
        [ 54, 214, 238],
        [ 47, 213, 237],
        [ 42, 212, 237]],

       [[ 20, 209, 226],
        [ 20, 209, 226],
        [ 17, 208, 228],
        ...,
        [ 40, 214, 237],
        [ 35, 213, 237],
        [ 33, 212, 237]],

       [[ 12, 208, 226],
        [ 10, 208, 227],
        [  6, 209, 228],
        ...,
        [ 22, 212, 235],
        [ 23, 212, 235],
        [ 26, 212, 235]],

       ...,

       [[151,  96,   1],
        [148,  94,   1],
        [139,  86,   1],
        ...,
        [247, 241, 241],
        [243, 231, 229],
        [240, 224, 223]],

       [[164, 107,   2],
        [154,  99,   2],
        [136,  84,   1],
        ...,
        [252, 245, 243],
        [249, 237, 233],
        [246, 230, 226]],

       [[170, 112,   3],
        [158, 103,   2],
        [138,  86,   1],
        ...,
        [250, 245, 243],
        [249, 239, 235],
        [246, 233, 228]]], dtype=uint8)]"
Image_1376.jpg,588,43,163,174,930,500,751,217,174,daskShared_local/images/Image_1376.jpg,1376,"[array([[[ 15, 153, 216],
        [ 13, 151, 213],
        [ 13, 151, 213],
        ...,
        [ 12, 148, 210],
        [ 12, 148, 210],
        [ 13, 149, 211]],

       [[ 13, 151, 213],
        [ 12, 150, 212],
        [ 12, 150, 212],
        ...,
        [ 13, 149, 211],
        [ 12, 148, 210],
        [ 11, 147, 209]],

       [[ 13, 151, 214],
        [ 12, 150, 212],
        [ 11, 149, 211],
        ...,
        [ 11, 147, 209],
        [  9, 145, 207],
        [  7, 143, 205]],

       ...,

       [[226, 226, 226],
        [230, 230, 230],
        [231, 231, 231],
        ...,
        [  5, 133, 196],
        [  5, 133, 195],
        [  5, 133, 194]],

       [[220, 219, 219],
        [229, 228, 227],
        [228, 228, 226],
        ...,
        [  5, 133, 196],
        [  5, 132, 195],
        [  5, 132, 193]],

       [[229, 225, 224],
        [240, 237, 230],
        [238, 238, 230],
        ...,
        [  8, 133, 197],
        [  8, 133, 196],
        [  8, 132, 194]]], dtype=uint8)]"
Image_1377.jpg,1276,631,347,266,2106,1578,1623,897,347,daskShared_local/images/Image_1377.jpg,1377,"[array([[[ 29, 146, 147],
        [ 28, 147, 148],
        [ 24, 145, 146],
        ...,
        [ 17, 142, 140],
        [ 19, 143, 141],
        [ 20, 141, 140]],

       [[ 30, 146, 147],
        [ 27, 146, 147],
        [ 25, 146, 145],
        ...,
        [ 25, 148, 150],
        [ 21, 144, 146],
        [ 20, 141, 139]],

       [[ 24, 147, 145],
        [ 24, 148, 145],
        [ 21, 144, 142],
        ...,
        [ 13, 144, 146],
        [ 12, 143, 145],
        [ 14, 143, 148]],

       ...,

       [[ 41, 156, 153],
        [ 43, 157, 154],
        [ 40, 159, 154],
        ...,
        [ 29, 159, 153],
        [ 31, 161, 156],
        [ 33, 163, 158]],

       [[ 41, 158, 157],
        [ 36, 152, 150],
        [ 40, 159, 155],
        ...,
        [ 28, 158, 153],
        [ 27, 157, 153],
        [ 30, 161, 156]],

       [[ 36, 157, 157],
        [ 37, 157, 158],
        [ 37, 159, 157],
        ...,
        [ 23, 158, 154],
        [ 24, 161, 156],
        [ 25, 162, 158]]], dtype=uint8)]"
Image_1378.jpg,948,248,233,181,1600,1280,1181,429,233,daskShared_local/images/Image_1378.jpg,1378,"[array([[[ 34, 122,  93],
        [ 23, 104,  75],
        [ 28, 101,  70],
        ...,
        [ 24, 187, 130],
        [ 33, 193, 138],
        [ 39, 194, 143]],

       [[ 26, 112,  87],
        [ 19,  99,  73],
        [ 23,  96,  71],
        ...,
        [ 26, 189, 125],
        [ 35, 194, 134],
        [ 41, 196, 142]],

       [[  6,  93,  58],
        [  7,  93,  54],
        [  7,  91,  52],
        ...,
        [ 37, 185, 117],
        [ 39, 187, 123],
        [ 41, 185, 128]],

       ...,

       [[181, 174, 185],
        [139, 125, 143],
        [ 87,  58,  91],
        ...,
        [ 28, 177, 155],
        [ 18, 161, 151],
        [  7, 140, 142]],

       [[205, 216, 205],
        [136, 140, 153],
        [ 67,  55, 100],
        ...,
        [ 29, 176, 150],
        [ 25, 168, 153],
        [ 18, 153, 150]],

       [[210, 230, 180],
        [161, 179, 172],
        [ 86,  89, 132],
        ...,
        [ 33, 176, 145],
        [ 28, 170, 149],
        [ 25, 162, 152]]], dtype=uint8)]"
Image_1379.jpg,379,179,464,395,1280,854,843,574,464,daskShared_local/images/Image_1379.jpg,1379,"[array([[[109, 141, 166],
        [109, 141, 166],
        [109, 139, 165],
        ...,
        [ 18, 209, 239],
        [ 21, 211, 239],
        [ 20, 211, 240]],

       [[109, 141, 166],
        [106, 138, 163],
        [108, 138, 164],
        ...,
        [ 15, 209, 241],
        [ 18, 211, 241],
        [ 18, 210, 241]],

       [[105, 137, 162],
        [105, 137, 162],
        [102, 133, 159],
        ...,
        [ 13, 207, 240],
        [ 14, 209, 241],
        [ 15, 210, 242]],

       ...,

       [[ 24, 162, 200],
        [ 24, 157, 196],
        [ 31, 161, 198],
        ...,
        [  9, 183, 232],
        [  5, 184, 233],
        [  5, 188, 236]],

       [[ 15, 158, 196],
        [ 16, 152, 192],
        [ 16, 150, 192],
        ...,
        [ 10, 185, 235],
        [  6, 186, 235],
        [  6, 188, 238]],

       [[ 14, 159, 199],
        [ 17, 155, 195],
        [ 15, 150, 193],
        ...,
        [  8, 186, 235],
        [  8, 189, 237],
        [  7, 188, 236]]], dtype=uint8)]"
Image_138.jpg,623,178,500,462,2000,1000,1123,640,500,daskShared_local/images/Image_138.jpg,138,"[array([[[  1, 160, 208],
        [  2, 160, 208],
        [  1, 159, 207],
        ...,
        [  1, 152, 207],
        [  1, 152, 207],
        [  1, 152, 207]],

       [[  2, 160, 208],
        [  2, 160, 208],
        [  1, 159, 207],
        ...,
        [  2, 153, 208],
        [  1, 152, 207],
        [  1, 152, 207]],

       [[  2, 160, 208],
        [  2, 160, 208],
        [  1, 159, 207],
        ...,
        [  1, 152, 207],
        [  2, 153, 208],
        [  1, 152, 207]],

       ...,

       [[  1,  96, 134],
        [  1,  99, 136],
        [  1, 102, 138],
        ...,
        [  2,  88,  65],
        [  2,  84,  61],
        [  0,  64,  43]],

       [[  1,  97, 135],
        [  1,  97, 134],
        [  1,  96, 134],
        ...,
        [  1,  92,  64],
        [  1,  93,  66],
        [  2,  76,  54]],

       [[  1,  96, 134],
        [  1,  95, 133],
        [  1,  95, 133],
        ...,
        [  1,  93,  71],
        [  2,  92,  68],
        [  2,  89,  68]]], dtype=uint8)]"
Image_1380.jpg,62,117,188,181,600,350,250,298,188,daskShared_local/images/Image_1380.jpg,1380,"[array([[[ 25,  52,  35],
        [ 24,  53,  35],
        [ 24,  51,  34],
        ...,
        [ 31,  16,  26],
        [ 21,  11,  20],
        [ 35,  26,  34]],

       [[ 23,  52,  32],
        [ 23,  52,  31],
        [ 24,  51,  35],
        ...,
        [ 58,  48,  54],
        [ 57,  54,  55],
        [ 63,  62,  61]],

       [[ 24,  52,  30],
        [ 23,  52,  30],
        [ 24,  51,  35],
        ...,
        [ 69,  68,  70],
        [ 76,  77,  73],
        [ 79,  80,  74]],

       ...,

       [[144, 133, 111],
        [145, 134, 113],
        [151, 144, 121],
        ...,
        [115,  85,  62],
        [121,  95,  74],
        [133, 117,  89]],

       [[149, 138, 120],
        [139, 131, 113],
        [150, 139, 121],
        ...,
        [130, 104,  80],
        [137, 116,  97],
        [133, 108,  86]],

       [[137, 126, 108],
        [159, 151, 132],
        [167, 156, 135],
        ...,
        [147, 127, 101],
        [140, 124, 102],
        [134, 109,  87]]], dtype=uint8)]"
Image_1381.jpg,123,87,170,140,500,333,293,227,170,daskShared_local/images/Image_1381.jpg,1381,"[array([[[ 28,  45,  63],
        [ 28,  45,  63],
        [ 27,  44,  62],
        ...,
        [ 27,  45,  67],
        [ 28,  46,  68],
        [ 30,  48,  70]],

       [[ 28,  45,  63],
        [ 28,  45,  63],
        [ 27,  44,  62],
        ...,
        [ 25,  43,  65],
        [ 27,  45,  67],
        [ 28,  46,  68]],

       [[ 27,  44,  62],
        [ 27,  44,  62],
        [ 27,  44,  62],
        ...,
        [ 24,  42,  64],
        [ 25,  43,  65],
        [ 27,  45,  67]],

       ...,

       [[ 25,  43,  57],
        [ 25,  43,  57],
        [ 25,  43,  57],
        ...,
        [122, 141, 130],
        [123, 142, 130],
        [124, 142, 131]],

       [[ 25,  43,  57],
        [ 25,  43,  57],
        [ 24,  42,  56],
        ...,
        [117, 139, 126],
        [116, 138, 125],
        [117, 139, 126]],

       [[ 25,  43,  57],
        [ 25,  43,  57],
        [ 24,  42,  56],
        ...,
        [118, 140, 127],
        [115, 137, 124],
        [113, 135, 122]]], dtype=uint8)]"
Image_1382.jpg,394,184,100,59,800,600,494,243,100,daskShared_local/images/Image_1382.jpg,1382,"[array([[[ 69, 115, 128],
        [ 69, 115, 128],
        [ 68, 114, 129],
        ...,
        [ 64, 104, 164],
        [ 63, 108, 157],
        [ 63, 108, 156]],

       [[ 69, 115, 128],
        [ 69, 115, 128],
        [ 68, 114, 129],
        ...,
        [ 64, 104, 164],
        [ 63, 108, 157],
        [ 63, 108, 157]],

       [[ 72, 116, 130],
        [ 72, 116, 130],
        [ 71, 115, 130],
        ...,
        [ 63, 110, 174],
        [ 61, 112, 168],
        [ 61, 112, 168]],

       ...,

       [[105, 115, 148],
        [105, 115, 148],
        [105, 116, 155],
        ...,
        [ 16, 131, 250],
        [ 17, 132, 249],
        [ 17, 132, 249]],

       [[113, 122, 159],
        [113, 122, 160],
        [110, 120, 165],
        ...,
        [ 16, 131, 250],
        [ 19, 132, 249],
        [ 19, 132, 249]],

       [[113, 122, 160],
        [113, 122, 160],
        [111, 121, 166],
        ...,
        [ 16, 131, 250],
        [ 19, 132, 249],
        [ 19, 132, 249]]], dtype=uint8)]"
Image_1383.jpg,887,508,226,221,1920,1200,1113,729,226,daskShared_local/images/Image_1383.jpg,1383,"[array([[[  8, 113, 117],
        [  3, 108, 112],
        [  2, 107, 111],
        ...,
        [  3, 122, 119],
        [  2, 119, 116],
        [  5, 121, 118]],

       [[  6, 111, 114],
        [  2, 107, 111],
        [  2, 108, 111],
        ...,
        [  6, 125, 121],
        [  3, 122, 118],
        [  6, 122, 119]],

       [[  2, 108, 110],
        [  4, 110, 113],
        [  2, 110, 112],
        ...,
        [  5, 125, 120],
        [  3, 122, 118],
        [  4, 121, 118]],

       ...,

       [[ 86,  73,  39],
        [104,  93,  57],
        [126, 117,  78],
        ...,
        [ 34,  30,  30],
        [ 34,  34,  34],
        [ 33,  34,  34]],

       [[111, 100,  65],
        [ 95,  85,  49],
        [100,  93,  55],
        ...,
        [ 33,  32,  34],
        [ 43,  43,  45],
        [ 49,  51,  50]],

       [[131, 120,  88],
        [112, 104,  68],
        [ 94,  88,  50],
        ...,
        [ 34,  35,  37],
        [ 36,  38,  38],
        [ 37,  39,  38]]], dtype=uint8)]"
Image_1384.jpg,158,7,118,102,498,272,276,109,118,daskShared_local/images/Image_1384.jpg,1384,"[array([[[  1,  24,  43],
        [  2,  24,  43],
        [  2,  25,  43],
        ...,
        [  0,  30,  51],
        [  1,  32,  53],
        [  2,  32,  53]],

       [[  2,  24,  43],
        [  2,  24,  43],
        [  2,  25,  43],
        ...,
        [  0,  29,  50],
        [  1,  31,  52],
        [  2,  31,  52]],

       [[  2,  25,  41],
        [  2,  25,  41],
        [  3,  26,  42],
        ...,
        [  0,  27,  48],
        [  1,  29,  50],
        [  2,  29,  50]],

       ...,

       [[122, 132, 122],
        [122, 132, 123],
        [122, 133, 127],
        ...,
        [152, 145, 129],
        [164, 158, 143],
        [168, 162, 147]],

       [[129, 143, 136],
        [130, 143, 137],
        [131, 145, 139],
        ...,
        [181, 174, 158],
        [188, 182, 168],
        [191, 185, 171]],

       [[132, 146, 140],
        [132, 146, 141],
        [134, 148, 143],
        ...,
        [189, 182, 166],
        [196, 190, 176],
        [198, 192, 179]]], dtype=uint8)]"
Image_1385.JPG,532,400,477,325,1600,1467,1009,725,477,daskShared_local/images/Image_1385.JPG,1385,"[array([[[ 40,  50,  52],
        [ 37,  48,  50],
        [ 40,  51,  53],
        ...,
        [ 93,  98,  84],
        [ 89,  92,  77],
        [ 84,  87,  70]],

       [[ 39,  49,  51],
        [ 39,  49,  51],
        [ 38,  49,  52],
        ...,
        [ 91,  95,  86],
        [ 88,  92,  81],
        [ 84,  88,  77]],

       [[ 40,  50,  52],
        [ 38,  49,  51],
        [ 37,  48,  52],
        ...,
        [ 84,  88,  82],
        [ 83,  89,  81],
        [ 83,  90,  81]],

       ...,

       [[229, 232, 192],
        [231, 231, 186],
        [228, 233, 186],
        ...,
        [238, 243, 223],
        [241, 247, 224],
        [241, 245, 224]],

       [[226, 234, 187],
        [224, 230, 177],
        [222, 229, 177],
        ...,
        [243, 247, 223],
        [242, 245, 224],
        [238, 241, 223]],

       [[223, 230, 180],
        [219, 227, 171],
        [217, 224, 169],
        ...,
        [238, 242, 216],
        [237, 240, 220],
        [239, 241, 223]]], dtype=uint8)]"
Image_1386.jpg,677,276,287,340,1600,900,964,616,340,daskShared_local/images/Image_1386.jpg,1386,"[array([[[  1, 117, 202],
        [  1, 117, 202],
        [  1, 117, 202],
        ...,
        [  0, 121, 202],
        [  0, 121, 202],
        [  0, 120, 201]],

       [[  1, 117, 202],
        [  1, 117, 202],
        [  1, 117, 202],
        ...,
        [  0, 121, 202],
        [  0, 121, 202],
        [  0, 120, 201]],

       [[  0, 116, 199],
        [  0, 116, 199],
        [  0, 116, 199],
        ...,
        [  0, 121, 202],
        [  0, 121, 202],
        [  0, 121, 202]],

       ...,

       [[175, 170, 135],
        [168, 165, 129],
        [169, 166, 131],
        ...,
        [ 93,  98,  61],
        [ 94, 100,  65],
        [123, 132, 101]],

       [[222, 219, 174],
        [221, 221, 173],
        [221, 222, 174],
        ...,
        [100, 103,  63],
        [112, 119,  77],
        [169, 177, 138]],

       [[194, 195, 136],
        [196, 200, 137],
        [202, 207, 140],
        ...,
        [108, 111,  73],
        [ 98, 102,  64],
        [124, 130,  93]]], dtype=uint8)]"
Image_1387.jpg,74,72,89,90,300,260,163,162,90,daskShared_local/images/Image_1387.jpg,1387,"[array([[[  2, 228, 253],
        [  2, 228, 253],
        [  2, 228, 253],
        ...,
        [109, 224, 228],
        [138, 231, 238],
        [132, 230, 236]],

       [[  2, 228, 253],
        [  2, 228, 253],
        [  2, 228, 253],
        ...,
        [ 95, 220, 225],
        [128, 229, 237],
        [121, 227, 235]],

       [[  2, 228, 252],
        [  2, 228, 252],
        [  2, 228, 252],
        ...,
        [166, 236, 240],
        [179, 242, 244],
        [176, 241, 243]],

       ...,

       [[  1, 186, 239],
        [  1, 186, 239],
        [  1, 185, 240],
        ...,
        [  5,  27,  28],
        [  2,  31,  29],
        [  3,  30,  29]],

       [[  0, 186, 238],
        [  0, 186, 238],
        [  0, 185, 239],
        ...,
        [  2,  22,  23],
        [  1,  33,  28],
        [  1,  31,  27]],

       [[  0, 186, 238],
        [  0, 186, 238],
        [  0, 185, 239],
        ...,
        [  3,  23,  24],
        [  1,  33,  28],
        [  1,  31,  27]]], dtype=uint8)]"
Image_1388.jpg,327,264,91,82,800,600,418,346,91,daskShared_local/images/Image_1388.jpg,1388,"[array([[[  1, 159, 254],
        [  1, 159, 255],
        [  0, 159, 254],
        ...,
        [  0, 162, 253],
        [  0, 162, 253],
        [  0, 162, 253]],

       [[  1, 159, 254],
        [  1, 159, 255],
        [  0, 159, 254],
        ...,
        [  0, 162, 253],
        [  0, 162, 253],
        [  0, 162, 253]],

       [[  1, 159, 254],
        [  1, 159, 255],
        [  0, 159, 254],
        ...,
        [  1, 162, 253],
        [  1, 162, 253],
        [  1, 162, 253]],

       ...,

       [[ 95, 159, 141],
        [ 96, 159, 145],
        [ 94, 156, 123],
        ...,
        [ 47,  54,  41],
        [ 47,  53,  39],
        [ 47,  53,  39]],

       [[133, 171, 140],
        [137, 173, 145],
        [117, 163, 118],
        ...,
        [ 45,  51,  40],
        [ 43,  49,  37],
        [ 44,  50,  38]],

       [[127, 169, 140],
        [130, 171, 145],
        [113, 162, 119],
        ...,
        [ 46,  52,  40],
        [ 44,  50,  37],
        [ 44,  50,  38]]], dtype=uint8)]"
Image_1389.jpg,302,233,301,285,1000,664,603,518,301,daskShared_local/images/Image_1389.jpg,1389,"[array([[[199, 202, 207],
        [199, 203, 206],
        [199, 203, 206],
        ...,
        [179, 158, 151],
        [181, 160, 152],
        [177, 156, 148]],

       [[199, 202, 207],
        [199, 203, 206],
        [199, 203, 206],
        ...,
        [191, 164, 154],
        [189, 161, 151],
        [191, 162, 152]],

       [[200, 203, 208],
        [198, 202, 206],
        [198, 202, 205],
        ...,
        [198, 166, 151],
        [205, 170, 157],
        [211, 177, 161]],

       ...,

       [[144, 130, 121],
        [135, 127, 118],
        [133, 126, 118],
        ...,
        [164, 155, 140],
        [162, 154, 141],
        [163, 155, 141]],

       [[143, 135, 127],
        [149, 142, 133],
        [150, 144, 136],
        ...,
        [164, 156, 143],
        [163, 155, 143],
        [163, 157, 145]],

       [[143, 141, 136],
        [148, 145, 138],
        [145, 141, 135],
        ...,
        [162, 156, 144],
        [163, 158, 146],
        [163, 158, 147]]], dtype=uint8)]"
Image_139.jpg,374,426,164,130,1200,800,538,556,164,daskShared_local/images/Image_139.jpg,139,"[array([[[117, 126,  73],
        [117, 126,  73],
        [117, 126,  73],
        ...,
        [171, 157, 130],
        [147, 133, 106],
        [133, 119,  93]],

       [[116, 125,  72],
        [116, 125,  72],
        [116, 125,  72],
        ...,
        [145, 131, 106],
        [129, 114,  90],
        [120, 105,  81]],

       [[117, 126,  73],
        [117, 126,  73],
        [116, 125,  72],
        ...,
        [122, 106,  83],
        [124, 108,  86],
        [126, 110,  88]],

       ...,

       [[ 43, 111,  88],
        [ 43, 111,  88],
        [ 44, 112,  89],
        ...,
        [ 52, 109,  92],
        [ 51, 108,  91],
        [ 51, 108,  91]],

       [[ 43, 111,  88],
        [ 43, 111,  88],
        [ 43, 112,  88],
        ...,
        [ 51, 108,  92],
        [ 49, 107,  90],
        [ 49, 107,  90]],

       [[ 42, 112,  88],
        [ 42, 112,  88],
        [ 42, 112,  88],
        ...,
        [ 50, 108,  93],
        [ 48, 106,  91],
        [ 48, 106,  91]]], dtype=uint8)]"
Image_1390.jpg,316,159,176,186,1200,735,492,345,186,daskShared_local/images/Image_1390.jpg,1390,"[array([[[116, 192, 206],
        [117, 194, 208],
        [113, 190, 204],
        ...,
        [ 17,  95,  99],
        [ 15,  95, 100],
        [  2,  51,  90]],

       [[106, 191, 208],
        [105, 190, 206],
        [102, 187, 203],
        ...,
        [ 20,  75,  88],
        [ 13,  67,  81],
        [  1,  49,  83]],

       [[106, 189, 207],
        [101, 184, 202],
        [ 96, 180, 198],
        ...,
        [ 10,  58,  70],
        [  6,  55,  67],
        [  1,  54,  81]],

       ...,

       [[142, 166, 179],
        [144, 168, 180],
        [141, 165, 176],
        ...,
        [ 59,  36,  42],
        [ 69,  45,  49],
        [ 65,  31,  20]],

       [[140, 167, 176],
        [137, 164, 173],
        [135, 162, 169],
        ...,
        [ 55,  29,  34],
        [ 58,  29,  33],
        [ 51,  14,   1]],

       [[133, 162, 166],
        [134, 164, 166],
        [132, 161, 162],
        ...,
        [ 51,  24,  27],
        [ 69,  39,  40],
        [ 53,  18,   4]]], dtype=uint8)]"
Image_1391.jpg,326,207,851,657,1500,1125,1177,864,851,daskShared_local/images/Image_1391.jpg,1391,"[array([[[ 95, 171, 168],
        [ 94, 171, 168],
        [ 95, 171, 170],
        ...,
        [114, 141, 151],
        [113, 137, 146],
        [113, 137, 142]],

       [[ 95, 169, 168],
        [ 96, 169, 167],
        [ 95, 170, 170],
        ...,
        [112, 140, 150],
        [111, 136, 146],
        [112, 134, 145]],

       [[ 95, 169, 170],
        [ 97, 169, 170],
        [ 96, 170, 169],
        ...,
        [112, 136, 148],
        [112, 134, 145],
        [111, 135, 143]],

       ...,

       [[ 84, 170, 218],
        [ 83, 170, 217],
        [ 83, 168, 214],
        ...,
        [ 78, 127, 132],
        [ 78, 127, 132],
        [ 76, 127, 131]],

       [[ 84, 172, 218],
        [ 83, 170, 217],
        [ 84, 169, 216],
        ...,
        [ 79, 127, 132],
        [ 80, 127, 132],
        [ 78, 127, 128]],

       [[ 82, 174, 220],
        [ 83, 172, 219],
        [ 86, 171, 218],
        ...,
        [ 79, 128, 131],
        [ 77, 126, 133],
        [ 76, 127, 133]]], dtype=uint8)]"
Image_1392.jpg,196,414,46,63,1024,683,242,477,63,daskShared_local/images/Image_1392.jpg,1392,"[array([[[169, 162,  49],
        [177, 172,  56],
        [170, 164,  50],
        ...,
        [  0, 192, 203],
        [  0, 192, 203],
        [  0, 192, 203]],

       [[163, 157,  48],
        [169, 166,  53],
        [164, 158,  48],
        ...,
        [  0, 192, 203],
        [  0, 192, 203],
        [  0, 192, 203]],

       [[168, 161,  49],
        [176, 171,  55],
        [169, 163,  50],
        ...,
        [  0, 192, 203],
        [  0, 192, 203],
        [  0, 192, 203]],

       ...,

       [[107, 178, 134],
        [105, 175, 131],
        [107, 177, 134],
        ...,
        [151, 163,  61],
        [145, 157,  53],
        [152, 164,  62]],

       [[102, 176, 136],
        [100, 174, 133],
        [101, 176, 136],
        ...,
        [159, 172,  70],
        [153, 166,  61],
        [160, 173,  72]],

       [[108, 178, 134],
        [106, 176, 130],
        [108, 178, 133],
        ...,
        [150, 161,  60],
        [144, 155,  52],
        [151, 162,  61]]], dtype=uint8)]"
Image_1393.jpg,388,107,176,180,800,600,564,287,180,daskShared_local/images/Image_1393.jpg,1393,"[array([[[250, 252, 212],
        [251, 253, 214],
        [250, 253, 217],
        ...,
        [ 46, 125, 102],
        [ 54, 133, 113],
        [ 66, 145, 124]],

       [[232, 239, 197],
        [240, 247, 207],
        [233, 241, 205],
        ...,
        [ 54, 137, 120],
        [ 60, 143, 128],
        [ 77, 160, 145]],

       [[205, 216, 178],
        [212, 224, 188],
        [208, 221, 188],
        ...,
        [ 68, 155, 140],
        [ 75, 164, 148],
        [ 83, 172, 156]],

       ...,

       [[229, 128,  25],
        [229, 130,  29],
        [224, 128,  28],
        ...,
        [ 65,  74,  63],
        [ 44,  44,  43],
        [ 32,  27,  33]],

       [[227, 125,  25],
        [225, 126,  27],
        [218, 123,  25],
        ...,
        [ 50,  58,  50],
        [ 46,  45,  47],
        [ 37,  31,  38]],

       [[225, 123,  23],
        [222, 123,  26],
        [214, 119,  23],
        ...,
        [ 50,  59,  53],
        [ 60,  59,  62],
        [ 36,  30,  37]]], dtype=uint8)]"
Image_1394.jpg,399,941,828,671,4601,3200,1227,1612,828,daskShared_local/images/Image_1394.jpg,1394,"[array([[[ 37, 162, 237],
        [ 35, 161, 238],
        [ 36, 165, 239],
        ...,
        [ 42, 160, 224],
        [ 43, 157, 220],
        [ 43, 157, 226]],

       [[ 30, 168, 247],
        [ 31, 169, 248],
        [ 27, 165, 243],
        ...,
        [ 46, 159, 234],
        [ 46, 151, 223],
        [ 43, 148, 220]],

       [[ 25, 160, 238],
        [ 32, 168, 249],
        [ 29, 164, 243],
        ...,
        [ 53, 158, 234],
        [ 52, 161, 233],
        [ 52, 164, 234]],

       ...,

       [[ 23, 160, 227],
        [ 20, 154, 216],
        [ 29, 163, 220],
        ...,
        [ 54, 152, 211],
        [ 56, 153, 213],
        [ 49, 143, 199]],

       [[ 26, 165, 228],
        [ 27, 164, 228],
        [ 26, 160, 220],
        ...,
        [ 51, 154, 210],
        [ 53, 155, 211],
        [ 51, 153, 216]],

       [[ 26, 157, 218],
        [ 25, 157, 218],
        [ 37, 165, 226],
        ...,
        [ 44, 151, 211],
        [ 44, 151, 213],
        [ 49, 158, 223]]], dtype=uint8)]"
Image_1395.jpg,1385,1104,503,412,2522,3332,1888,1516,503,daskShared_local/images/Image_1395.jpg,1395,"[array([[[200, 201, 198],
        [204, 203, 197],
        [204, 202, 194],
        ...,
        [  3, 145, 180],
        [  3, 146, 178],
        [  2, 144, 177]],

       [[182, 190, 195],
        [199, 200, 195],
        [215, 211, 202],
        ...,
        [  0, 133, 175],
        [  1, 135, 176],
        [  7, 142, 183]],

       [[191, 196, 199],
        [207, 203, 195],
        [217, 207, 194],
        ...,
        [  0, 129, 184],
        [  0, 129, 183],
        [  1, 132, 186]],

       ...,

       [[ 45,  74,  70],
        [ 55,  91,  88],
        [ 37,  76,  73],
        ...,
        [  1, 127, 201],
        [  1, 127, 201],
        [  2, 129, 202]],

       [[ 29,  58,  56],
        [ 33,  65,  66],
        [ 24,  59,  59],
        ...,
        [  3, 130, 203],
        [  0, 128, 201],
        [  0, 128, 201]],

       [[ 26,  54,  54],
        [ 18,  47,  50],
        [ 18,  49,  51],
        ...,
        [  1, 128, 201],
        [  1, 129, 202],
        [  0, 127, 200]]], dtype=uint8)]"
Image_1396.jpg,374,422,171,130,1200,800,545,552,171,daskShared_local/images/Image_1396.jpg,1396,"[array([[[129, 139,  79],
        [128, 138,  78],
        [128, 138,  78],
        ...,
        [186, 180, 149],
        [168, 161, 132],
        [154, 148, 116]],

       [[125, 135,  75],
        [124, 134,  74],
        [124, 134,  74],
        ...,
        [175, 168, 139],
        [175, 168, 139],
        [151, 144, 116]],

       [[122, 131,  73],
        [121, 131,  73],
        [121, 130,  72],
        ...,
        [167, 158, 130],
        [177, 168, 141],
        [168, 158, 134]],

       ...,

       [[ 43, 111,  88],
        [ 43, 111,  88],
        [ 44, 112,  89],
        ...,
        [ 51, 108,  91],
        [ 50, 107,  91],
        [ 47, 106,  91]],

       [[ 43, 111,  88],
        [ 43, 111,  88],
        [ 43, 112,  89],
        ...,
        [ 50, 107,  90],
        [ 49, 106,  90],
        [ 48, 105,  89]],

       [[ 42, 112,  88],
        [ 42, 112,  88],
        [ 42, 112,  88],
        ...,
        [ 48, 106,  91],
        [ 49, 105,  90],
        [ 51, 102,  87]]], dtype=uint8)]"
Image_1397.jpg,413,361,289,241,1536,1024,702,602,289,daskShared_local/images/Image_1397.jpg,1397,"[array([[[ 13, 128, 245],
        [ 14, 129, 246],
        [ 10, 127, 243],
        ...,
        [ 15, 148, 248],
        [ 14, 150, 244],
        [ 12, 148, 242]],

       [[ 12, 127, 244],
        [ 12, 127, 244],
        [ 10, 127, 245],
        ...,
        [ 15, 149, 239],
        [ 19, 152, 234],
        [ 18, 150, 238]],

       [[ 10, 125, 242],
        [ 11, 126, 243],
        [ 11, 126, 245],
        ...,
        [ 14, 143, 247],
        [ 12, 141, 238],
        [ 13, 140, 236]],

       ...,

       [[ 12,  64, 212],
        [ 12,  64, 212],
        [  6,  63, 205],
        ...,
        [ 24,  36,  27],
        [ 31,  28,  24],
        [ 33,  30,  26]],

       [[  9,  61, 209],
        [ 10,  62, 210],
        [  6,  63, 203],
        ...,
        [ 19,  37,  28],
        [ 30,  31,  28],
        [ 39,  32,  29]],

       [[ 10,  62, 210],
        [ 10,  62, 210],
        [  8,  61, 212],
        ...,
        [  5,  38,  28],
        [ 14,  37,  32],
        [ 38,  39,  38]]], dtype=uint8)]"
Image_1398.jpg,671,656,418,275,2793,2090,1089,931,418,daskShared_local/images/Image_1398.jpg,1398,"[array([[[  3,  70, 195],
        [  5,  69, 195],
        [  5,  69, 195],
        ...,
        [  3,  67, 190],
        [  3,  67, 190],
        [  3,  67, 190]],

       [[  3,  70, 195],
        [  5,  69, 195],
        [  5,  69, 195],
        ...,
        [  3,  67, 190],
        [  3,  67, 190],
        [  3,  67, 190]],

       [[  3,  70, 195],
        [  5,  69, 195],
        [  5,  69, 195],
        ...,
        [  3,  67, 190],
        [  3,  67, 190],
        [  3,  67, 190]],

       ...,

       [[  3,  50, 154],
        [  3,  50, 154],
        [  3,  50, 154],
        ...,
        [111, 116,  76],
        [141, 142, 102],
        [172, 169, 126]],

       [[  3,  50, 154],
        [  3,  50, 154],
        [  3,  50, 154],
        ...,
        [127, 132,  94],
        [164, 161, 123],
        [159, 156, 114]],

       [[  3,  50, 154],
        [  3,  50, 154],
        [  3,  50, 154],
        ...,
        [135, 140, 104],
        [179, 173, 135],
        [135, 130,  90]]], dtype=uint8)]"
Image_1399.jpg,462,114,292,326,1600,1019,754,440,326,daskShared_local/images/Image_1399.jpg,1399,"[array([[[ 30, 107, 213],
        [ 30, 107, 213],
        [ 30, 107, 213],
        ...,
        [ 28, 116, 213],
        [ 28, 116, 213],
        [ 28, 116, 213]],

       [[ 30, 107, 213],
        [ 30, 107, 213],
        [ 30, 107, 213],
        ...,
        [ 28, 116, 213],
        [ 28, 116, 213],
        [ 28, 116, 213]],

       [[ 30, 107, 213],
        [ 30, 107, 213],
        [ 30, 107, 213],
        ...,
        [ 28, 116, 213],
        [ 28, 116, 213],
        [ 28, 116, 213]],

       ...,

       [[219, 232, 231],
        [238, 247, 247],
        [209, 213, 192],
        ...,
        [183, 207, 193],
        [180, 177, 175],
        [149, 150, 147]],

       [[216, 227, 219],
        [229, 236, 229],
        [215, 218, 201],
        ...,
        [191, 198, 186],
        [163, 143, 141],
        [145, 130, 127]],

       [[215, 222, 210],
        [234, 237, 225],
        [243, 245, 232],
        ...,
        [194, 180, 172],
        [170, 128, 130],
        [142, 106, 106]]], dtype=uint8)]"
Image_14.jpg,420,140,227,211,1024,686,647,351,227,daskShared_local/images/Image_14.jpg,14,"[array([[[ 37, 189, 239],
        [ 37, 189, 239],
        [ 37, 189, 239],
        ...,
        [  0, 159, 219],
        [  0, 159, 219],
        [  0, 159, 219]],

       [[ 37, 189, 239],
        [ 36, 188, 238],
        [ 36, 188, 238],
        ...,
        [  0, 159, 220],
        [  0, 159, 219],
        [  0, 158, 218]],

       [[ 38, 190, 240],
        [ 37, 189, 239],
        [ 37, 189, 239],
        ...,
        [  1, 159, 220],
        [  0, 158, 219],
        [  0, 158, 219]],

       ...,

       [[227, 212, 199],
        [220, 202, 186],
        [220, 205, 192],
        ...,
        [  5, 118, 186],
        [  4, 117, 185],
        [  2, 115, 183]],

       [[222, 212, 202],
        [221, 207, 194],
        [219, 207, 199],
        ...,
        [  4, 117, 185],
        [  3, 116, 184],
        [  2, 115, 183]],

       [[226, 220, 214],
        [232, 222, 213],
        [225, 215, 211],
        ...,
        [  2, 115, 183],
        [  2, 115, 183],
        [  2, 115, 183]]], dtype=uint8)]"
Image_140.jpg,1383,434,510,401,2500,1667,1893,835,510,daskShared_local/images/Image_140.jpg,140,"[array([[[ 49, 148, 172],
        [ 39, 147, 169],
        [ 38, 146, 171],
        ...,
        [182, 192, 201],
        [180, 188, 192],
        [184, 192, 196]],

       [[ 56, 149, 173],
        [ 52, 148, 171],
        [ 51, 145, 169],
        ...,
        [199, 205, 214],
        [195, 195, 196],
        [192, 191, 193]],

       [[ 77, 159, 177],
        [ 76, 153, 171],
        [ 84, 154, 174],
        ...,
        [176, 194, 205],
        [187, 195, 199],
        [192, 197, 201]],

       ...,

       [[187, 181, 145],
        [188, 182, 146],
        [167, 159, 121],
        ...,
        [  1, 140, 175],
        [  3, 142, 175],
        [  2, 140, 174]],

       [[188, 186, 150],
        [188, 182, 148],
        [179, 164, 128],
        ...,
        [  1, 140, 175],
        [  3, 140, 176],
        [  2, 139, 176]],

       [[174, 171, 137],
        [169, 160, 127],
        [161, 142, 107],
        ...,
        [  0, 137, 173],
        [  0, 136, 174],
        [  0, 135, 173]]], dtype=uint8)]"
Image_1400.jpg,294,160,215,202,1000,664,509,362,215,daskShared_local/images/Image_1400.jpg,1400,"[array([[[  1,  80, 146],
        [  1,  80, 146],
        [  0,  81, 147],
        ...,
        [  0,  98, 169],
        [  0,  98, 169],
        [  0,  98, 169]],

       [[  1,  80, 146],
        [  1,  80, 147],
        [  0,  81, 147],
        ...,
        [  0,  98, 169],
        [  0,  99, 167],
        [  0, 101, 171]],

       [[  1,  80, 149],
        [  1,  80, 147],
        [  0,  79, 147],
        ...,
        [  0,  98, 168],
        [  0,  98, 169],
        [  0,  98, 169]],

       ...,

       [[ 39,  39,  34],
        [ 41,  50,  49],
        [ 51,  58,  48],
        ...,
        [216, 211, 191],
        [226, 218, 202],
        [232, 226, 202]],

       [[ 42,  41,  30],
        [ 38,  49,  55],
        [ 54,  73,  61],
        ...,
        [213, 208, 192],
        [225, 223, 212],
        [218, 214, 196]],

       [[ 56,  64,  50],
        [ 48,  62,  62],
        [ 54,  72,  65],
        ...,
        [213, 210, 202],
        [211, 208, 200],
        [196, 190, 176]]], dtype=uint8)]"
Image_1401.jpg,356,111,198,205,1280,720,554,316,205,daskShared_local/images/Image_1401.jpg,1401,"[array([[[ 20, 116, 203],
        [ 25, 121, 208],
        [ 25, 121, 208],
        ...,
        [ 20, 133, 209],
        [ 15, 128, 204],
        [ 13, 126, 202]],

       [[ 21, 115, 203],
        [ 27, 121, 209],
        [ 32, 126, 214],
        ...,
        [ 20, 131, 213],
        [ 23, 134, 216],
        [ 22, 133, 215]],

       [[ 11, 105, 193],
        [ 18, 112, 200],
        [ 24, 118, 206],
        ...,
        [ 20, 131, 213],
        [ 22, 133, 215],
        [ 23, 134, 216]],

       ...,

       [[ 12,  82, 170],
        [ 12,  82, 170],
        [ 11,  81, 169],
        ...,
        [243, 235, 215],
        [244, 235, 206],
        [174, 164, 128]],

       [[ 11,  81, 169],
        [ 11,  81, 169],
        [ 10,  80, 168],
        ...,
        [155, 148, 130],
        [179, 172, 144],
        [106,  97,  64]],

       [[ 10,  80, 168],
        [ 10,  80, 168],
        [  9,  79, 167],
        ...,
        [ 52,  47,  28],
        [ 98,  92,  66],
        [ 88,  83,  53]]], dtype=uint8)]"
Image_1402.jpg,660,114,194,184,1156,650,854,298,194,daskShared_local/images/Image_1402.jpg,1402,"[array([[[ 24, 152, 181],
        [ 30, 154, 182],
        [ 29, 149, 174],
        ...,
        [  3, 141, 160],
        [ 13, 146, 165],
        [ 22, 141, 161]],

       [[  8, 143, 172],
        [ 10, 145, 171],
        [ 16, 148, 173],
        ...,
        [ 27, 158, 176],
        [ 15, 146, 164],
        [ 15, 137, 152]],

       [[  2, 142, 169],
        [  1, 142, 169],
        [  7, 147, 170],
        ...,
        [ 45, 172, 189],
        [ 39, 169, 183],
        [ 24, 146, 159]],

       ...,

       [[ 28,  22,   0],
        [ 29,  23,   0],
        [103,  98,  69],
        ...,
        [  2, 130, 175],
        [  2, 130, 175],
        [  0, 131, 177]],

       [[ 43,  37,  11],
        [ 22,  17,   1],
        [ 66,  61,  33],
        ...,
        [  5, 133, 180],
        [  3, 131, 178],
        [  0, 129, 178]],

       [[ 77,  71,  45],
        [ 52,  47,  19],
        [ 61,  56,  27],
        ...,
        [  3, 131, 180],
        [  2, 130, 179],
        [  0, 128, 178]]], dtype=uint8)]"
Image_1403.jpg,716,438,435,355,2119,1414,1151,793,435,daskShared_local/images/Image_1403.jpg,1403,"[array([[[109, 161, 190],
        [ 94, 145, 175],
        [ 93, 143, 176],
        ...,
        [ 83, 148, 176],
        [ 85, 150, 178],
        [ 97, 162, 190]],

       [[ 96, 151, 182],
        [ 90, 144, 175],
        [101, 152, 183],
        ...,
        [ 79, 144, 174],
        [ 84, 149, 179],
        [ 90, 155, 185]],

       [[ 93, 148, 179],
        [ 87, 141, 172],
        [ 92, 143, 172],
        ...,
        [ 78, 143, 173],
        [ 81, 146, 176],
        [ 84, 149, 179]],

       ...,

       [[ 80, 175, 197],
        [ 81, 176, 198],
        [ 82, 176, 201],
        ...,
        [  4, 102, 118],
        [ 24, 108, 123],
        [ 77, 147, 160]],

       [[ 80, 175, 197],
        [ 81, 176, 198],
        [ 81, 175, 200],
        ...,
        [ 13, 114, 122],
        [ 59, 151, 161],
        [102, 185, 196]],

       [[ 80, 174, 198],
        [ 81, 175, 199],
        [ 80, 174, 199],
        ...,
        [ 69, 166, 171],
        [ 89, 188, 195],
        [ 99, 192, 202]]], dtype=uint8)]"
Image_1404.jpg,1710,502,1374,1592,4631,3087,3084,2094,1592,daskShared_local/images/Image_1404.jpg,1404,"[array([[[ 20,  96, 242],
        [ 20,  96, 242],
        [ 20,  96, 242],
        ...,
        [  1,  62, 203],
        [  1,  62, 202],
        [  0,  61, 201]],

       [[ 20,  95, 242],
        [ 19,  95, 241],
        [ 20,  95, 241],
        ...,
        [  0,  61, 201],
        [  0,  61, 201],
        [  0,  61, 201]],

       [[ 20,  94, 241],
        [ 20,  94, 241],
        [ 20,  94, 241],
        ...,
        [  0,  61, 201],
        [  0,  61, 200],
        [  0,  61, 199]],

       ...,

       [[150, 155, 124],
        [140, 145, 111],
        [131, 136,  98],
        ...,
        [ 32,  32,  16],
        [ 34,  33,  17],
        [ 35,  33,  18]],

       [[121, 131, 126],
        [145, 150, 123],
        [149, 154, 122],
        ...,
        [ 32,  33,  17],
        [ 32,  33,  17],
        [ 33,  34,  19]],

       [[ 69,  84, 103],
        [107, 117, 112],
        [138, 139, 116],
        ...,
        [ 29,  32,  17],
        [ 30,  33,  17],
        [ 31,  34,  18]]], dtype=uint8)]"
Image_1405.jpg,506,240,332,217,1200,900,838,457,332,daskShared_local/images/Image_1405.jpg,1405,"[array([[[ 67, 178, 198],
        [ 62, 178, 196],
        [ 54, 173, 188],
        ...,
        [ 97, 192, 211],
        [ 89, 186, 206],
        [ 95, 190, 206]],

       [[ 57, 182, 195],
        [ 54, 180, 195],
        [ 13, 167, 174],
        ...,
        [ 99, 192, 205],
        [ 87, 187, 211],
        [ 81, 188, 204]],

       [[ 64, 180, 200],
        [ 63, 176, 196],
        [ 41, 171, 194],
        ...,
        [ 77, 185, 203],
        [ 86, 189, 200],
        [ 96, 192, 209]],

       ...,

       [[ 92, 140, 122],
        [104, 134, 123],
        [111, 151, 139],
        ...,
        [129, 199, 213],
        [140, 203, 213],
        [168, 216, 227]],

       [[ 78, 139, 119],
        [ 88, 150, 133],
        [111, 164, 151],
        ...,
        [152, 208, 222],
        [167, 216, 228],
        [155, 211, 222]],

       [[ 85, 152, 138],
        [ 99, 149, 140],
        [135, 165, 154],
        ...,
        [152, 210, 225],
        [160, 211, 225],
        [157, 212, 225]]], dtype=uint8)]"
Image_1406.jpg,712,177,175,160,1000,600,887,337,175,daskShared_local/images/Image_1406.jpg,1406,"[array([[[  9, 157, 205],
        [ 11, 159, 207],
        [ 12, 160, 208],
        ...,
        [  5, 152, 206],
        [  5, 152, 206],
        [  5, 152, 206]],

       [[ 14, 160, 207],
        [ 14, 161, 208],
        [ 14, 161, 208],
        ...,
        [  3, 153, 206],
        [  3, 153, 206],
        [  4, 154, 207]],

       [[ 18, 164, 209],
        [ 17, 163, 208],
        [ 16, 161, 207],
        ...,
        [  3, 153, 206],
        [  4, 154, 207],
        [  4, 154, 207]],

       ...,

       [[175, 158,  27],
        [185, 165,  54],
        [196, 175,  80],
        ...,
        [200, 213, 123],
        [226, 233, 183],
        [224, 226, 210]],

       [[174, 153,  40],
        [170, 146,  55],
        [183, 159,  82],
        ...,
        [232, 239, 190],
        [247, 248, 231],
        [235, 234, 238]],

       [[178, 153,  65],
        [187, 158,  97],
        [193, 165, 114],
        ...,
        [242, 242, 227],
        [243, 241, 242],
        [239, 238, 245]]], dtype=uint8)]"
Image_1407.jpg,600,208,312,272,924,924,912,480,312,daskShared_local/images/Image_1407.jpg,1407,"[array([[[  2, 143, 170],
        [  2, 143, 170],
        [  2, 143, 170],
        ...,
        [  2, 131, 162],
        [  2, 131, 162],
        [  2, 131, 162]],

       [[  2, 143, 170],
        [  2, 143, 170],
        [  2, 143, 170],
        ...,
        [  2, 131, 162],
        [  2, 131, 162],
        [  2, 131, 162]],

       [[  1, 144, 169],
        [  1, 146, 173],
        [  3, 146, 176],
        ...,
        [  1, 131, 161],
        [  1, 131, 161],
        [  1, 131, 161]],

       ...,

       [[ 45,  36,  13],
        [ 38,  29,   8],
        [ 36,  27,   8],
        ...,
        [ 88,  76,  31],
        [ 87,  74,  33],
        [ 84,  70,  32]],

       [[ 58,  52,  28],
        [ 48,  41,  22],
        [ 37,  30,  13],
        ...,
        [ 83,  71,  30],
        [ 84,  72,  30],
        [ 83,  71,  29]],

       [[ 79,  73,  50],
        [ 68,  61,  41],
        [ 44,  37,  20],
        ...,
        [ 78,  67,  30],
        [ 78,  68,  29],
        [ 79,  70,  30]]], dtype=uint8)]"
Image_1408.jpg,729,325,188,145,1600,1000,917,470,188,daskShared_local/images/Image_1408.jpg,1408,"[array([[[  0,  83, 169],
        [  0,  83, 169],
        [  0,  83, 169],
        ...,
        [  0,  84, 165],
        [  0,  84, 165],
        [  0,  84, 165]],

       [[  0,  83, 169],
        [  0,  83, 169],
        [  0,  83, 169],
        ...,
        [  0,  84, 165],
        [  0,  84, 165],
        [  0,  84, 165]],

       [[  0,  83, 169],
        [  0,  83, 169],
        [  0,  83, 169],
        ...,
        [  0,  84, 165],
        [  0,  84, 165],
        [  0,  84, 165]],

       ...,

       [[  1,  65, 137],
        [  1,  65, 137],
        [  1,  65, 137],
        ...,
        [210, 227, 215],
        [201, 220, 207],
        [172, 186, 169]],

       [[  1,  65, 137],
        [  1,  65, 137],
        [  1,  65, 137],
        ...,
        [206, 220, 206],
        [202, 215, 200],
        [209, 220, 203]],

       [[  1,  65, 137],
        [  1,  65, 137],
        [  1,  65, 137],
        ...,
        [194, 202, 189],
        [192, 200, 185],
        [214, 221, 205]]], dtype=uint8)]"
Image_1409.jpg,641,269,314,345,1600,1000,955,614,345,daskShared_local/images/Image_1409.jpg,1409,"[array([[[  0,  72, 166],
        [  0,  72, 166],
        [  1,  71, 166],
        ...,
        [  0,  69, 162],
        [  0,  69, 162],
        [  0,  69, 162]],

       [[  0,  72, 166],
        [  0,  72, 166],
        [  1,  71, 166],
        ...,
        [  0,  69, 162],
        [  0,  69, 162],
        [  0,  69, 162]],

       [[  1,  71, 165],
        [  2,  73, 165],
        [  2,  73, 163],
        ...,
        [  0,  69, 162],
        [  1,  70, 163],
        [  1,  70, 163]],

       ...,

       [[114, 123,  65],
        [111, 119,  81],
        [ 33,  41,  25],
        ...,
        [121, 113,  66],
        [129, 116,  68],
        [128, 110,  63]],

       [[ 88,  95,  47],
        [ 86,  93,  63],
        [ 30,  40,  25],
        ...,
        [105,  91,  52],
        [109,  94,  56],
        [107,  90,  55]],

       [[ 93,  96,  61],
        [ 90,  96,  73],
        [ 34,  46,  31],
        ...,
        [120, 103,  67],
        [134, 119,  83],
        [138, 125,  91]]], dtype=uint8)]"
Image_141.jpg,1044,1443,1104,843,4613,2968,2148,2286,1104,daskShared_local/images/Image_141.jpg,141,"[array([[[157, 181, 183],
        [161, 184, 187],
        [161, 185, 187],
        ...,
        [ 69,  59,  55],
        [ 62,  51,  49],
        [ 51,  42,  43]],

       [[147, 179, 180],
        [159, 183, 187],
        [161, 184, 188],
        ...,
        [ 60,  49,  46],
        [ 59,  48,  46],
        [ 53,  44,  42]],

       [[147, 180, 181],
        [159, 183, 187],
        [161, 183, 187],
        ...,
        [ 50,  40,  38],
        [ 55,  45,  43],
        [ 55,  45,  42]],

       ...,

       [[ 62,  69,  72],
        [ 60,  66,  69],
        [ 56,  60,  63],
        ...,
        [131, 132, 116],
        [128, 129, 114],
        [124, 119, 107]],

       [[ 63,  70,  72],
        [ 60,  66,  68],
        [ 62,  67,  70],
        ...,
        [ 99,  99,  88],
        [102, 102,  89],
        [112, 108,  94]],

       [[ 61,  68,  69],
        [ 65,  71,  74],
        [ 71,  77,  80],
        ...,
        [118, 135, 124],
        [143, 157, 143],
        [146, 152, 136]]], dtype=uint8)]"
Image_1410.jpg,688,246,469,546,1920,1080,1157,792,546,daskShared_local/images/Image_1410.jpg,1410,"[array([[[  1, 122, 203],
        [  1, 122, 203],
        [  0, 121, 202],
        ...,
        [  2, 118, 203],
        [  1, 117, 202],
        [  1, 117, 202]],

       [[  0, 121, 202],
        [  0, 121, 202],
        [  1, 120, 202],
        ...,
        [  1, 117, 202],
        [  1, 117, 202],
        [  1, 117, 200]],

       [[  0, 120, 201],
        [  0, 120, 201],
        [  1, 120, 202],
        ...,
        [  1, 117, 202],
        [  1, 117, 201],
        [  1, 117, 200]],

       ...,

       [[ 74,  75,  58],
        [100, 103,  82],
        [113, 116,  87],
        ...,
        [177, 172, 142],
        [173, 166, 137],
        [171, 162, 133]],

       [[ 91,  93,  69],
        [128, 133, 102],
        [141, 143, 111],
        ...,
        [207, 205, 177],
        [203, 198, 171],
        [197, 190, 163]],

       [[108, 112,  80],
        [144, 150, 111],
        [136, 141, 106],
        ...,
        [216, 220, 173],
        [215, 216, 165],
        [210, 208, 158]]], dtype=uint8)]"
Image_1411.jpg,401,288,231,249,1500,1000,632,537,249,daskShared_local/images/Image_1411.jpg,1411,"[array([[[  3, 129, 154],
        [  0, 129, 154],
        [  1, 132, 155],
        ...,
        [  1, 120, 137],
        [  2, 122, 138],
        [  7, 125, 147]],

       [[  2, 131, 156],
        [  1, 131, 154],
        [  1, 132, 155],
        ...,
        [  0, 117, 134],
        [  0, 114, 131],
        [  1, 115, 138]],

       [[  1, 131, 154],
        [  0, 129, 152],
        [  0, 128, 151],
        ...,
        [  0, 115, 134],
        [  0, 112, 130],
        [  1, 112, 134]],

       ...,

       [[179, 197, 171],
        [143, 165, 137],
        [116, 141, 111],
        ...,
        [161, 158, 105],
        [129, 126,  73],
        [ 85,  80,  25]],

       [[185, 200, 169],
        [150, 168, 135],
        [117, 139, 105],
        ...,
        [158, 155, 100],
        [135, 132,  78],
        [145, 142,  88]],

       [[184, 196, 161],
        [159, 175, 139],
        [127, 146, 110],
        ...,
        [139, 135,  79],
        [130, 128,  71],
        [153, 150,  95]]], dtype=uint8)]"
Image_1412.jpg,605,204,397,459,1600,1070,1002,663,459,daskShared_local/images/Image_1412.jpg,1412,"[array([[[ 24,  74, 145],
        [ 24,  74, 145],
        [ 24,  74, 145],
        ...,
        [ 30,  67, 137],
        [ 30,  67, 137],
        [ 30,  67, 137]],

       [[ 24,  74, 145],
        [ 24,  74, 145],
        [ 24,  74, 145],
        ...,
        [ 30,  67, 136],
        [ 30,  67, 136],
        [ 30,  67, 136]],

       [[ 22,  75, 145],
        [ 22,  75, 145],
        [ 22,  75, 145],
        ...,
        [ 30,  68, 133],
        [ 30,  68, 133],
        [ 30,  68, 133]],

       ...,

       [[217, 174, 134],
        [209, 164, 120],
        [164, 122,  85],
        ...,
        [253, 244, 238],
        [248, 241, 223],
        [247, 231, 195]],

       [[154, 122,  78],
        [189, 146, 111],
        [205, 165, 130],
        ...,
        [254, 242, 231],
        [253, 237, 231],
        [254, 240, 227]],

       [[138, 115,  64],
        [152, 118,  77],
        [152, 117,  84],
        ...,
        [237, 206, 190],
        [228, 200, 188],
        [241, 213, 200]]], dtype=uint8)]"
Image_1413.jpg,972,119,279,362,1686,1216,1251,481,362,daskShared_local/images/Image_1413.jpg,1413,"[array([[[124, 183, 215],
        [124, 183, 215],
        [123, 182, 214],
        ...,
        [165, 202, 228],
        [164, 201, 227],
        [164, 201, 227]],

       [[125, 184, 216],
        [124, 183, 215],
        [123, 182, 214],
        ...,
        [164, 201, 227],
        [165, 202, 228],
        [165, 202, 228]],

       [[125, 184, 216],
        [124, 183, 215],
        [123, 182, 214],
        ...,
        [164, 201, 227],
        [165, 202, 228],
        [165, 202, 228]],

       ...,

       [[211, 226, 208],
        [187, 207, 187],
        [180, 200, 186],
        ...,
        [ 80, 162, 199],
        [ 81, 163, 200],
        [ 79, 161, 198]],

       [[219, 237, 218],
        [204, 226, 207],
        [170, 193, 181],
        ...,
        [ 82, 164, 201],
        [ 80, 162, 199],
        [ 82, 164, 201]],

       [[224, 237, 219],
        [218, 235, 216],
        [187, 205, 188],
        ...,
        [ 81, 163, 200],
        [ 81, 163, 200],
        [ 84, 166, 203]]], dtype=uint8)]"
Image_1414.jpg,427,137,227,217,1024,686,654,354,227,daskShared_local/images/Image_1414.jpg,1414,"[array([[[ 35, 189, 239],
        [ 35, 189, 239],
        [ 33, 188, 238],
        ...,
        [  1, 159, 220],
        [  1, 159, 220],
        [  1, 159, 220]],

       [[ 33, 189, 240],
        [ 32, 188, 239],
        [ 31, 187, 238],
        ...,
        [  2, 158, 219],
        [  2, 158, 219],
        [  2, 158, 219]],

       [[ 31, 187, 238],
        [ 30, 186, 237],
        [ 28, 185, 236],
        ...,
        [  2, 158, 219],
        [  2, 158, 219],
        [  2, 158, 219]],

       ...,

       [[213, 202, 200],
        [230, 224, 224],
        [212, 208, 211],
        ...,
        [  2, 113, 182],
        [  2, 113, 182],
        [  2, 113, 182]],

       [[210, 200, 198],
        [229, 222, 221],
        [217, 213, 214],
        ...,
        [  1, 112, 181],
        [  2, 113, 182],
        [  3, 114, 183]],

       [[210, 201, 199],
        [219, 211, 209],
        [217, 213, 210],
        ...,
        [  1, 112, 181],
        [  3, 114, 183],
        [  4, 115, 184]]], dtype=uint8)]"
Image_1415.jpg,772,263,336,309,1200,906,1108,572,336,daskShared_local/images/Image_1415.jpg,1415,"[array([[[ 80,  68,  75],
        [ 84,  72,  77],
        [132, 120, 126],
        ...,
        [ 19,  51,  72],
        [ 17,  51,  71],
        [ 15,  50,  72]],

       [[ 79,  69,  77],
        [ 93,  82,  88],
        [131, 120, 128],
        ...,
        [ 20,  51,  72],
        [ 21,  52,  73],
        [ 19,  52,  74]],

       [[ 80,  71,  80],
        [ 87,  76,  84],
        [117, 107, 115],
        ...,
        [ 24,  51,  74],
        [ 20,  49,  70],
        [ 17,  49,  71]],

       ...,

       [[ 43,  71,  86],
        [ 43,  70,  85],
        [ 52,  76,  92],
        ...,
        [ 33,  77,  94],
        [ 27,  72,  93],
        [ 21,  66,  87]],

       [[ 49,  82,  97],
        [ 57,  86, 102],
        [ 47,  74,  88],
        ...,
        [ 29,  76,  92],
        [ 23,  70,  90],
        [ 20,  67,  87]],

       [[ 43,  78,  95],
        [ 49,  79,  96],
        [ 48,  75,  92],
        ...,
        [ 21,  67,  84],
        [ 18,  65,  85],
        [ 16,  62,  82]]], dtype=uint8)]"
Image_1416.jpg,374,18,142,120,550,380,516,138,142,daskShared_local/images/Image_1416.jpg,1416,"[array([[[ 76,  95, 153],
        [ 77,  96, 154],
        [ 77,  96, 153],
        ...,
        [ 69,  85, 144],
        [ 70,  86, 145],
        [ 70,  86, 145]],

       [[ 77,  96, 154],
        [ 77,  96, 154],
        [ 77,  96, 154],
        ...,
        [ 70,  85, 144],
        [ 70,  85, 144],
        [ 70,  85, 144]],

       [[ 77,  96, 155],
        [ 77,  96, 155],
        [ 77,  96, 155],
        ...,
        [ 71,  86, 145],
        [ 70,  85, 144],
        [ 69,  84, 143]],

       ...,

       [[176, 159, 127],
        [196, 178, 144],
        [213, 194, 161],
        ...,
        [ 65,  79, 140],
        [ 65,  79, 140],
        [ 65,  79, 140]],

       [[110,  94,  73],
        [142, 127,  95],
        [175, 160, 120],
        ...,
        [ 65,  79, 140],
        [ 65,  79, 140],
        [ 65,  79, 140]],

       [[ 65,  51,  38],
        [100,  89,  59],
        [140, 128,  86],
        ...,
        [ 65,  79, 140],
        [ 65,  79, 140],
        [ 65,  79, 140]]], dtype=uint8)]"
Image_1417.jpg,1063,108,2512,2650,4608,3072,3575,2758,2650,daskShared_local/images/Image_1417.jpg,1417,"[array([[[ 45,  45,  44],
        [ 49,  49,  47],
        [ 48,  48,  47],
        ...,
        [172, 165, 123],
        [172, 165, 123],
        [171, 164, 121]],

       [[ 46,  46,  45],
        [ 46,  46,  44],
        [ 43,  43,  41],
        ...,
        [171, 165, 122],
        [171, 165, 122],
        [171, 164, 120]],

       [[ 42,  42,  40],
        [ 40,  40,  38],
        [ 36,  36,  34],
        ...,
        [170, 164, 121],
        [170, 164, 120],
        [169, 163, 119]],

       ...,

       [[ 99,  82,  54],
        [ 98,  82,  52],
        [ 98,  82,  49],
        ...,
        [164, 133,  68],
        [160, 134,  88],
        [156, 136,  96]],

       [[ 95,  79,  49],
        [ 98,  79,  48],
        [ 97,  79,  45],
        ...,
        [149, 138, 100],
        [154, 138,  95],
        [155, 134,  87]],

       [[ 93,  76,  48],
        [ 96,  76,  47],
        [ 95,  77,  45],
        ...,
        [133, 119,  91],
        [142, 128,  93],
        [151, 136,  94]]], dtype=uint8)]"
Image_1418.jpg,471,158,247,273,981,650,718,431,273,daskShared_local/images/Image_1418.jpg,1418,"[array([[[244, 244, 244],
        [244, 244, 244],
        [244, 244, 244],
        ...,
        [243, 243, 243],
        [243, 243, 243],
        [243, 243, 243]],

       [[244, 244, 244],
        [244, 244, 244],
        [244, 244, 244],
        ...,
        [242, 242, 242],
        [242, 242, 242],
        [242, 242, 242]],

       [[244, 244, 244],
        [244, 244, 244],
        [244, 244, 244],
        ...,
        [242, 242, 242],
        [242, 242, 242],
        [242, 242, 242]],

       ...,

       [[ 26,  93, 172],
        [ 27,  94, 173],
        [ 28,  95, 174],
        ...,
        [ 21,  90, 168],
        [ 22,  89, 168],
        [ 24,  91, 170]],

       [[ 24,  91, 170],
        [ 26,  93, 172],
        [ 28,  95, 174],
        ...,
        [ 22,  91, 170],
        [ 22,  89, 168],
        [ 24,  91, 170]],

       [[ 25,  92, 171],
        [ 25,  92, 171],
        [ 27,  94, 173],
        ...,
        [ 25,  92, 173],
        [ 23,  90, 169],
        [ 24,  91, 170]]], dtype=uint8)]"
Image_1419.jpg,224,186,162,167,500,559,386,353,167,daskShared_local/images/Image_1419.jpg,1419,"[array([[[108, 183, 179],
        [103, 182, 179],
        [ 88, 180, 180],
        ...,
        [125, 215, 201],
        [128, 215, 199],
        [129, 216, 200]],

       [[ 98, 175, 171],
        [ 93, 173, 170],
        [ 82, 174, 174],
        ...,
        [129, 213, 200],
        [132, 214, 200],
        [134, 217, 201]],

       [[ 88, 173, 171],
        [ 84, 172, 170],
        [ 77, 172, 173],
        ...,
        [137, 212, 201],
        [141, 214, 202],
        [143, 216, 203]],

       ...,

       [[ 85,  88,  49],
        [ 88,  95,  51],
        [ 86,  91,  42],
        ...,
        [117, 132,  43],
        [122, 136,  42],
        [126, 141,  38]],

       [[ 42,  37,  19],
        [ 49,  47,  28],
        [ 58,  59,  28],
        ...,
        [109, 134,  50],
        [116, 140,  50],
        [122, 146,  46]],

       [[ 51,  34,   2],
        [ 46,  29,   3],
        [ 34,  24,  18],
        ...,
        [ 91, 137,  51],
        [ 99, 138,  47],
        [102, 136,  41]]], dtype=uint8)]"
Image_142.jpg,417,361,312,254,1536,1024,729,615,312,daskShared_local/images/Image_142.jpg,142,"[array([[[ 15, 137, 245],
        [ 11, 133, 243],
        [ 10, 132, 243],
        ...,
        [ 11, 156, 241],
        [  9, 154, 241],
        [ 15, 159, 247]],

       [[ 16, 136, 247],
        [ 17, 137, 250],
        [ 14, 134, 247],
        ...,
        [ 12, 156, 243],
        [ 12, 156, 245],
        [ 13, 154, 244]],

       [[ 16, 133, 247],
        [ 18, 137, 251],
        [ 16, 134, 250],
        ...,
        [ 10, 153, 250],
        [  9, 159, 250],
        [  6, 155, 245]],

       ...,

       [[  8,  59, 201],
        [  9,  60, 203],
        [ 10,  61, 204],
        ...,
        [ 17,  56,  55],
        [ 13,  65,  69],
        [ 22,  84,  85]],

       [[  8,  59, 200],
        [ 11,  62, 204],
        [ 11,  62, 205],
        ...,
        [ 27,  57,  54],
        [ 39,  82,  84],
        [ 22,  89, 106]],

       [[  9,  60, 201],
        [ 11,  62, 203],
        [ 11,  62, 204],
        ...,
        [ 25,  58,  50],
        [ 30,  69,  60],
        [ 17,  83,  92]]], dtype=uint8)]"
Image_1420.jpg,408,312,134,149,800,600,542,461,149,daskShared_local/images/Image_1420.jpg,1420,"[array([[[218, 212, 178],
        [216, 210, 177],
        [219, 212, 182],
        ...,
        [  2,  86,  98],
        [  2,  86,  97],
        [  3,  87,  98]],

       [[227, 217, 188],
        [225, 216, 187],
        [225, 217, 189],
        ...,
        [  1,  86,  98],
        [  2,  86,  97],
        [  2,  88,  98]],

       [[231, 219, 193],
        [227, 217, 191],
        [226, 217, 191],
        ...,
        [  0,  86,  97],
        [  1,  87,  97],
        [  1,  89,  99]],

       ...,

       [[ 22,  49,  48],
        [ 23,  49,  49],
        [ 24,  48,  48],
        ...,
        [ 40, 125,  80],
        [ 28, 106,  69],
        [ 17,  86,  55]],

       [[ 24,  52,  50],
        [ 23,  51,  50],
        [ 23,  49,  48],
        ...,
        [ 38, 126,  81],
        [ 26, 107,  69],
        [ 18,  91,  59]],

       [[ 27,  56,  54],
        [ 25,  54,  52],
        [ 23,  51,  49],
        ...,
        [ 32, 121,  75],
        [ 22, 104,  66],
        [ 20,  94,  63]]], dtype=uint8)]"
Image_1421.jpg,111,381,371,293,1715,1286,482,674,371,daskShared_local/images/Image_1421.jpg,1421,"[array([[[129, 139, 137],
        [131, 140, 140],
        [131, 141, 143],
        ...,
        [135, 165, 108],
        [134, 164,  91],
        [137, 166,  84]],

       [[130, 135, 137],
        [126, 135, 137],
        [128, 139, 141],
        ...,
        [124, 149, 147],
        [127, 152, 144],
        [132, 159, 144]],

       [[130, 137, 131],
        [130, 136, 134],
        [128, 138, 138],
        ...,
        [117, 135, 143],
        [121, 139, 147],
        [127, 145, 149]],

       ...,

       [[164, 190, 193],
        [161, 193, 196],
        [163, 199, 201],
        ...,
        [180, 187, 200],
        [182, 194, 207],
        [183, 200, 205]],

       [[159, 172, 199],
        [163, 173, 202],
        [154, 184, 200],
        ...,
        [176, 183, 196],
        [177, 186, 203],
        [177, 193, 212]],

       [[180, 161, 195],
        [170, 166, 201],
        [166, 168, 207],
        ...,
        [183, 179, 190],
        [181, 182, 199],
        [182, 186, 218]]], dtype=uint8)]"
Image_1422.jpg,502,80,161,200,1200,630,663,280,200,daskShared_local/images/Image_1422.jpg,1422,"[array([[[  4, 157, 224],
        [  4, 157, 224],
        [  4, 157, 224],
        ...,
        [  3, 155, 222],
        [  3, 155, 222],
        [  3, 155, 222]],

       [[  4, 157, 224],
        [  4, 157, 224],
        [  4, 157, 224],
        ...,
        [  3, 155, 222],
        [  3, 155, 222],
        [  3, 155, 222]],

       [[  4, 157, 224],
        [  4, 157, 224],
        [  4, 157, 224],
        ...,
        [  3, 155, 222],
        [  3, 155, 222],
        [  3, 155, 222]],

       ...,

       [[ 61,  45,  46],
        [ 48,  32,  35],
        [ 68,  53,  56],
        ...,
        [  8,  88, 125],
        [  7,  87, 124],
        [  4,  84, 121]],

       [[ 52,  36,  37],
        [ 33,  18,  21],
        [ 11,   1,   1],
        ...,
        [  7,  87, 124],
        [  6,  86, 123],
        [  3,  83, 120]],

       [[ 27,  13,  13],
        [ 34,  19,  22],
        [ 30,  15,  18],
        ...,
        [  5,  85, 122],
        [  4,  84, 121],
        [  2,  82, 119]]], dtype=uint8)]"
Image_1423.jpg,1208,983,469,465,2592,1944,1677,1448,469,daskShared_local/images/Image_1423.jpg,1423,"[array([[[128, 105,  87],
        [115,  93,  75],
        [110,  90,  73],
        ...,
        [ 42,  81, 124],
        [ 40,  78, 123],
        [ 39,  75, 119]],

       [[131, 106,  89],
        [112,  89,  71],
        [113,  92,  75],
        ...,
        [ 38,  77, 118],
        [ 42,  79, 121],
        [ 38,  73, 115]],

       [[118,  92,  75],
        [ 97,  73,  56],
        [117,  95,  78],
        ...,
        [ 36,  75, 116],
        [ 40,  77, 119],
        [ 38,  72, 114]],

       ...,

       [[ 38, 119, 168],
        [ 38, 119, 168],
        [ 38, 119, 168],
        ...,
        [ 38, 120, 168],
        [ 37, 119, 167],
        [ 37, 119, 167]],

       [[ 37, 121, 168],
        [ 40, 124, 171],
        [ 38, 121, 169],
        ...,
        [ 37, 119, 166],
        [ 37, 119, 166],
        [ 37, 119, 166]],

       [[ 38, 122, 169],
        [ 39, 123, 170],
        [ 38, 122, 169],
        ...,
        [ 36, 119, 163],
        [ 38, 121, 165],
        [ 39, 122, 166]]], dtype=uint8)]"
Image_1424.jpg,2395,885,666,602,3840,2160,3061,1487,666,daskShared_local/images/Image_1424.jpg,1424,"[array([[[112,  89,  75],
        [143, 120, 107],
        [171, 149, 135],
        ...,
        [  1, 132, 176],
        [  1, 132, 176],
        [  1, 132, 176]],

       [[ 91,  67,  54],
        [111,  87,  73],
        [154, 130, 114],
        ...,
        [  1, 132, 176],
        [  1, 132, 176],
        [  2, 133, 177]],

       [[126, 101,  88],
        [126, 101,  86],
        [138, 112,  95],
        ...,
        [  2, 133, 177],
        [  1, 132, 176],
        [  2, 133, 177]],

       ...,

       [[  2, 154, 174],
        [  1, 152, 172],
        [  0, 151, 172],
        ...,
        [  2, 121, 163],
        [  2, 121, 163],
        [  1, 120, 162]],

       [[  2, 154, 175],
        [  1, 152, 172],
        [  0, 151, 170],
        ...,
        [  2, 120, 163],
        [  2, 120, 164],
        [  1, 120, 163]],

       [[  2, 154, 175],
        [  2, 153, 173],
        [  1, 152, 171],
        ...,
        [  1, 119, 164],
        [  1, 120, 164],
        [  2, 121, 164]]], dtype=uint8)]"
Image_1425.png,239,25,87,91,589,295,326,116,91,daskShared_local/images/Image_1425.png,1425,"[array([[[ 21, 172, 198],
        [ 24, 173, 199],
        [ 10, 172, 195],
        ...,
        [  4, 176, 194],
        [  2, 174, 192],
        [  2, 175, 192]],

       [[ 24, 173, 198],
        [ 26, 173, 199],
        [ 11, 172, 194],
        ...,
        [  3, 176, 194],
        [  2, 174, 192],
        [  2, 175, 192]],

       [[ 10, 171, 197],
        [ 11, 171, 197],
        [  5, 172, 195],
        ...,
        [  9, 177, 194],
        [  5, 174, 192],
        [  6, 175, 192]],

       ...,

       [[ 50,  24,  30],
        [ 51,  25,  31],
        [ 41,  16,  25],
        ...,
        [ 71,  42,  38],
        [ 61,  38,  32],
        [ 63,  39,  33]],

       [[ 47,  23,  31],
        [ 48,  24,  32],
        [ 45,  21,  29],
        ...,
        [112,  69,  60],
        [109,  66,  56],
        [110,  67,  57]],

       [[ 48,  23,  31],
        [ 48,  24,  32],
        [ 44,  20,  28],
        ...,
        [105,  64,  56],
        [101,  61,  52],
        [101,  62,  53]]], dtype=uint8)]"
Image_1426.jpg,615,314,160,151,1440,960,775,465,160,daskShared_local/images/Image_1426.jpg,1426,"[array([[[  1, 145, 206],
        [  1, 144, 204],
        [  1, 144, 204],
        ...,
        [  2, 145, 215],
        [  3, 146, 216],
        [  3, 146, 216]],

       [[  0, 143, 204],
        [  1, 144, 204],
        [  1, 144, 204],
        ...,
        [  1, 144, 214],
        [  1, 144, 214],
        [  1, 144, 214]],

       [[  2, 142, 202],
        [  4, 143, 207],
        [  3, 143, 206],
        ...,
        [  1, 144, 212],
        [  0, 143, 212],
        [  0, 143, 212]],

       ...,

       [[ 19,   2,   0],
        [ 21,   4,   1],
        [ 23,   7,   1],
        ...,
        [  0,  73, 110],
        [  0,  74, 111],
        [  1,  75, 112]],

       [[ 49,  24,  16],
        [ 59,  31,  20],
        [ 68,  40,  25],
        ...,
        [  0,  74, 111],
        [  0,  74, 111],
        [  0,  74, 111]],

       [[ 93,  65,  51],
        [111,  81,  63],
        [129,  98,  75],
        ...,
        [  0,  73, 110],
        [  0,  74, 111],
        [  1,  75, 112]]], dtype=uint8)]"
Image_1427.jpg,961,231,218,208,1600,1280,1179,439,218,daskShared_local/images/Image_1427.jpg,1427,"[array([[[ 35, 104,  68],
        [ 40, 105,  70],
        [ 35, 113,  74],
        ...,
        [ 39, 184, 116],
        [ 35, 180, 113],
        [ 35, 179, 115]],

       [[ 40, 104,  72],
        [ 46, 107,  70],
        [ 38, 112,  72],
        ...,
        [ 37, 176, 114],
        [ 32, 172, 109],
        [ 31, 170, 110]],

       [[ 43, 106,  73],
        [ 52, 111,  69],
        [ 43, 115,  70],
        ...,
        [ 40, 174, 116],
        [ 37, 171, 114],
        [ 37, 169, 115]],

       ...,

       [[177, 149,  75],
        [142, 113,  48],
        [130,  99,  60],
        ...,
        [ 28, 145, 142],
        [ 26, 137, 136],
        [ 20, 124, 122]],

       [[138,  98,  52],
        [118,  78,  34],
        [117,  80,  44],
        ...,
        [ 28, 147, 148],
        [ 19, 132, 135],
        [ 13, 117, 121]],

       [[ 91,  43,  27],
        [ 96,  46,  29],
        [100,  57,  26],
        ...,
        [ 27, 148, 154],
        [ 16, 128, 138],
        [  9, 111, 123]]], dtype=uint8)]"
Image_1428.jpg,401,125,130,102,759,422,531,227,130,daskShared_local/images/Image_1428.jpg,1428,"[array([[[ 85, 166, 165],
        [ 77, 160, 158],
        [ 68, 152, 151],
        ...,
        [ 85, 176, 198],
        [ 97, 188, 211],
        [100, 191, 214]],

       [[ 75, 155, 158],
        [ 73, 155, 157],
        [ 76, 158, 160],
        ...,
        [ 75, 166, 185],
        [ 88, 181, 201],
        [ 93, 186, 206]],

       [[ 62, 140, 149],
        [ 71, 149, 158],
        [ 89, 168, 175],
        ...,
        [ 55, 148, 163],
        [ 69, 165, 180],
        [ 77, 174, 190]],

       ...,

       [[  2, 152, 187],
        [  2, 152, 187],
        [  2, 152, 187],
        ...,
        [  2, 135, 154],
        [  2, 134, 154],
        [  1, 134, 153]],

       [[  1, 153, 189],
        [  1, 153, 189],
        [  1, 153, 189],
        ...,
        [  2, 132, 151],
        [  1, 131, 150],
        [  1, 130, 149]],

       [[  1, 153, 189],
        [  1, 153, 189],
        [  1, 153, 189],
        ...,
        [  1, 131, 150],
        [  0, 128, 147],
        [  0, 127, 146]]], dtype=uint8)]"
Image_1429.jpg,283,154,263,246,1000,541,546,400,263,daskShared_local/images/Image_1429.jpg,1429,"[array([[[ 39, 139, 178],
        [ 55, 137, 175],
        [ 66, 139, 174],
        ...,
        [ 37,  82,  95],
        [ 38,  88, 102],
        [ 38,  92, 109]],

       [[ 40, 130, 170],
        [ 55, 126, 165],
        [ 65, 124, 163],
        ...,
        [ 38,  73,  86],
        [ 40,  79,  93],
        [ 41,  86, 100]],

       [[ 41, 126, 165],
        [ 55, 121, 160],
        [ 64, 116, 155],
        ...,
        [ 37,  69,  84],
        [ 40,  74,  89],
        [ 43,  80,  95]],

       ...,

       [[ 14,  70,  85],
        [  2,  44,  56],
        [  0,  31,  37],
        ...,
        [ 82, 103, 126],
        [ 68,  88, 108],
        [121, 138, 155]],

       [[ 11,  69,  89],
        [  1,  45,  60],
        [  0,  30,  39],
        ...,
        [ 88, 102, 122],
        [142, 157, 171],
        [169, 187, 200]],

       [[  1,  52,  68],
        [  2,  46,  61],
        [  1,  38,  50],
        ...,
        [150, 169, 195],
        [169, 186, 216],
        [148, 166, 198]]], dtype=uint8)]"
Image_143.jpg,1414,1122,417,370,2522,3332,1831,1492,417,daskShared_local/images/Image_143.jpg,143,"[array([[[238, 214, 188],
        [229, 204, 181],
        [208, 181, 164],
        ...,
        [  1, 143, 178],
        [  1, 144, 179],
        [  2, 145, 180]],

       [[158, 132, 118],
        [136, 109, 101],
        [129,  99,  96],
        ...,
        [  3, 152, 180],
        [  2, 151, 179],
        [  2, 151, 179]],

       [[153, 128, 124],
        [179, 155, 151],
        [198, 176, 172],
        ...,
        [  5, 161, 179],
        [  9, 161, 180],
        [  9, 152, 174]],

       ...,

       [[ 31,  49,  51],
        [ 40,  59,  60],
        [ 51,  72,  72],
        ...,
        [  1, 125, 199],
        [  1, 125, 199],
        [  1, 125, 199]],

       [[ 23,  42,  45],
        [ 38,  58,  60],
        [ 48,  71,  71],
        ...,
        [  1, 125, 199],
        [  0, 124, 198],
        [  0, 124, 198]],

       [[ 20,  38,  42],
        [ 30,  50,  53],
        [ 38,  61,  61],
        ...,
        [  0, 123, 197],
        [  0, 123, 197],
        [  0, 124, 198]]], dtype=uint8)]"
Image_1430.jpg,908,455,698,529,3008,2000,1606,984,698,daskShared_local/images/Image_1430.jpg,1430,"[array([[[148, 187, 194],
        [148, 187, 194],
        [148, 187, 194],
        ...,
        [135, 177, 189],
        [135, 177, 189],
        [135, 177, 189]],

       [[148, 187, 194],
        [148, 187, 194],
        [148, 187, 194],
        ...,
        [135, 177, 189],
        [135, 177, 189],
        [135, 177, 189]],

       [[148, 187, 194],
        [148, 187, 194],
        [148, 187, 194],
        ...,
        [135, 177, 189],
        [135, 177, 189],
        [135, 177, 189]],

       ...,

       [[111, 170, 176],
        [114, 168, 176],
        [115, 168, 176],
        ...,
        [ 60,  80,  83],
        [ 62,  82,  86],
        [ 59,  78,  82]],

       [[110, 169, 175],
        [114, 168, 176],
        [115, 168, 176],
        ...,
        [ 60,  80,  84],
        [ 47,  67,  71],
        [ 44,  63,  67]],

       [[109, 168, 174],
        [114, 168, 176],
        [115, 168, 176],
        ...,
        [ 64,  84,  87],
        [ 51,  71,  75],
        [ 45,  64,  68]]], dtype=uint8)]"
Image_1431.jpg,225,369,869,647,1512,1231,1094,1016,869,daskShared_local/images/Image_1431.jpg,1431,"[array([[[ 94, 116, 122],
        [ 92, 114, 119],
        [ 91, 113, 119],
        ...,
        [ 83, 117,  84],
        [ 80, 114,  82],
        [ 79, 109,  81]],

       [[ 97, 115, 123],
        [ 94, 113, 117],
        [ 91, 110, 114],
        ...,
        [ 86, 120,  86],
        [ 81, 115,  82],
        [ 78, 110,  79]],

       [[ 88, 104, 104],
        [ 84, 101,  95],
        [ 81,  97,  91],
        ...,
        [ 87, 121,  87],
        [ 83, 118,  83],
        [ 80, 113,  80]],

       ...,

       [[255, 241, 215],
        [255, 241, 215],
        [255, 241, 215],
        ...,
        [248, 228, 197],
        [237, 208, 166],
        [224, 193, 148]],

       [[254, 240, 214],
        [254, 240, 214],
        [254, 240, 214],
        ...,
        [249, 231, 203],
        [241, 216, 179],
        [237, 206, 161]],

       [[255, 241, 215],
        [255, 241, 215],
        [255, 241, 215],
        ...,
        [235, 212, 178],
        [237, 213, 174],
        [236, 209, 167]]], dtype=uint8)]"
Image_1432.jpg,359,336,337,238,1904,803,696,574,337,daskShared_local/images/Image_1432.jpg,1432,"[array([[[  0,  48, 104],
        [  0,  47, 103],
        [  0,  48, 104],
        ...,
        [ 55, 159, 143],
        [ 28, 141, 125],
        [ 30, 148, 135]],

       [[  0,  46, 102],
        [  0,  47, 103],
        [  0,  48, 104],
        ...,
        [ 69, 162, 155],
        [ 36, 150, 137],
        [ 32, 161, 145]],

       [[  0,  45, 101],
        [  0,  47, 103],
        [  0,  48, 104],
        ...,
        [ 81, 178, 168],
        [ 58, 170, 156],
        [ 56, 177, 163]],

       ...,

       [[ 14,  33,  77],
        [  8,  31,  81],
        [  5,  31,  85],
        ...,
        [  1,  63,  64],
        [  4,  65,  66],
        [  3,  62,  67]],

       [[  8,  42,  81],
        [  8,  42,  85],
        [  4,  40,  85],
        ...,
        [  2,  65,  65],
        [  1,  62,  63],
        [  0,  57,  62]],

       [[  1,  47,  86],
        [  1,  46,  87],
        [  0,  43,  87],
        ...,
        [  0,  57,  57],
        [  0,  58,  59],
        [  0,  55,  61]]], dtype=uint8)]"
Image_1433.jpg,419,155,810,663,1500,1000,1229,818,810,daskShared_local/images/Image_1433.jpg,1433,"[array([[[  2,  57,  65],
        [  3,  55,  66],
        [  3,  55,  66],
        ...,
        [179, 169, 176],
        [183, 173, 182],
        [173, 167, 178]],

       [[  1,  57,  66],
        [  3,  56,  66],
        [  3,  55,  66],
        ...,
        [177, 169, 179],
        [180, 172, 184],
        [161, 157, 173]],

       [[  1,  57,  66],
        [  3,  56,  66],
        [  3,  55,  66],
        ...,
        [171, 162, 180],
        [170, 162, 183],
        [136, 132, 157]],

       ...,

       [[195, 199, 202],
        [192, 194, 198],
        [178, 181, 189],
        ...,
        [ 38,  64,  42],
        [ 46,  72,  47],
        [ 54,  80,  53]],

       [[202, 205, 207],
        [204, 204, 206],
        [196, 196, 201],
        ...,
        [ 40,  66,  41],
        [ 50,  76,  48],
        [ 58,  84,  56]],

       [[198, 203, 207],
        [208, 207, 210],
        [203, 203, 206],
        ...,
        [ 42,  68,  42],
        [ 51,  77,  49],
        [ 58,  84,  55]]], dtype=uint8)]"
Image_1434.jpg,566,117,46,37,800,533,612,154,46,daskShared_local/images/Image_1434.jpg,1434,"[array([[[  1, 167, 205],
        [  1, 167, 205],
        [  1, 167, 205],
        ...,
        [  1, 163, 201],
        [  1, 163, 201],
        [  1, 163, 201]],

       [[  1, 167, 205],
        [  1, 167, 205],
        [  1, 167, 205],
        ...,
        [  1, 163, 201],
        [  1, 163, 201],
        [  1, 163, 201]],

       [[  1, 167, 205],
        [  1, 167, 205],
        [  1, 167, 205],
        ...,
        [  1, 163, 201],
        [  1, 163, 201],
        [  1, 163, 201]],

       ...,

       [[  2, 162, 198],
        [  2, 162, 198],
        [  2, 162, 198],
        ...,
        [  3, 153, 186],
        [  3, 153, 186],
        [  2, 153, 186]],

       [[  2, 162, 198],
        [  2, 162, 198],
        [  2, 162, 198],
        ...,
        [  3, 153, 186],
        [  3, 153, 186],
        [  2, 153, 186]],

       [[  2, 162, 198],
        [  2, 162, 198],
        [  2, 162, 198],
        ...,
        [  3, 153, 186],
        [  3, 153, 186],
        [  2, 153, 186]]], dtype=uint8)]"
Image_1435.jpg,209,112,127,101,598,325,336,213,127,daskShared_local/images/Image_1435.jpg,1435,"[array([[[ 57,  25,  17],
        [ 87,  40,  28],
        [144,  66,  47],
        ...,
        [ 97, 103,  94],
        [ 79,  87,  85],
        [ 71,  80,  81]],

       [[ 76,  41,  28],
        [ 99,  49,  35],
        [143,  64,  45],
        ...,
        [ 79,  85,  80],
        [ 57,  63,  66],
        [ 49,  55,  62]],

       [[112,  72,  50],
        [121,  69,  47],
        [140,  62,  41],
        ...,
        [ 48,  53,  56],
        [ 19,  22,  35],
        [  9,  11,  29]],

       ...,

       [[187, 236, 197],
        [186, 234, 193],
        [185, 228, 187],
        ...,
        [ 10,  94, 135],
        [  5,  99, 144],
        [  3, 101, 148]],

       [[227, 250, 227],
        [227, 248, 225],
        [226, 245, 222],
        ...,
        [ 19,  98, 123],
        [ 10,  97, 131],
        [  6,  97, 134]],

       [[242, 253, 236],
        [242, 252, 235],
        [242, 251, 235],
        ...,
        [ 24,  98, 116],
        [ 13,  95, 123],
        [  8,  93, 126]]], dtype=uint8)]"
Image_1436.jpg,447,228,170,177,900,586,617,405,177,daskShared_local/images/Image_1436.jpg,1436,"[array([[[  1, 171, 206],
        [  2, 172, 207],
        [  2, 172, 207],
        ...,
        [102, 202, 225],
        [102, 202, 225],
        [102, 202, 225]],

       [[  2, 172, 207],
        [  2, 172, 207],
        [  2, 172, 207],
        ...,
        [101, 203, 225],
        [101, 203, 225],
        [101, 203, 225]],

       [[  2, 172, 207],
        [  2, 172, 207],
        [  3, 173, 208],
        ...,
        [102, 204, 226],
        [102, 204, 226],
        [102, 204, 226]],

       ...,

       [[101, 129, 106],
        [100, 132, 107],
        [106, 143, 114],
        ...,
        [  0, 166, 210],
        [  0, 167, 211],
        [  0, 167, 211]],

       [[ 95, 127, 109],
        [ 88, 126, 104],
        [ 85, 126, 103],
        ...,
        [  0, 167, 211],
        [  0, 167, 211],
        [  1, 168, 212]],

       [[110, 147, 129],
        [ 91, 131, 113],
        [ 72, 115,  95],
        ...,
        [  0, 169, 212],
        [  0, 169, 212],
        [  1, 170, 213]]], dtype=uint8)]"
Image_1437.jpg,245,211,146,155,775,518,391,366,155,daskShared_local/images/Image_1437.jpg,1437,"[array([[[ 76,  81,  41],
        [ 68,  71,  32],
        [ 67,  69,  33],
        ...,
        [136, 112, 100],
        [145, 121, 108],
        [144, 122, 108]],

       [[ 64,  70,  32],
        [ 62,  66,  31],
        [ 64,  66,  34],
        ...,
        [123, 100,  85],
        [129, 106,  91],
        [154, 131, 116]],

       [[ 56,  62,  30],
        [ 60,  64,  33],
        [ 60,  63,  35],
        ...,
        [122,  98,  81],
        [115,  92,  76],
        [140, 117, 100]],

       ...,

       [[140,  97,  53],
        [133,  92,  47],
        [136,  97,  51],
        ...,
        [180, 135,  96],
        [180, 135,  96],
        [167, 122,  83]],

       [[137,  94,  52],
        [126,  84,  41],
        [123,  83,  39],
        ...,
        [171, 126,  88],
        [157, 112,  74],
        [135,  90,  52]],

       [[136,  93,  51],
        [124,  82,  40],
        [119,  78,  36],
        ...,
        [157, 111,  74],
        [138,  92,  55],
        [115,  69,  33]]], dtype=uint8)]"
Image_1438.jpg,379,159,124,109,900,600,503,268,124,daskShared_local/images/Image_1438.jpg,1438,"[array([[[  0, 121, 184],
        [  0, 121, 185],
        [  0, 121, 186],
        ...,
        [  0, 111, 195],
        [  0, 110, 193],
        [  0, 110, 192]],

       [[  0, 119, 184],
        [  0, 120, 184],
        [  0, 120, 186],
        ...,
        [  0, 112, 195],
        [  0, 111, 193],
        [  0, 111, 192]],

       [[  1, 116, 183],
        [  1, 117, 184],
        [  2, 118, 185],
        ...,
        [  1, 114, 194],
        [  0, 113, 193],
        [  0, 113, 193]],

       ...,

       [[ 53,  79,  99],
        [ 62,  73,  86],
        [ 84,  59,  55],
        ...,
        [102,  78, 104],
        [109,  85, 111],
        [113,  89, 115]],

       [[ 23, 105, 151],
        [ 29, 101, 142],
        [ 45,  90, 119],
        ...,
        [108,  83, 108],
        [113,  88, 114],
        [115,  90, 116]],

       [[ 11, 116, 172],
        [ 16, 113, 166],
        [ 29, 103, 147],
        ...,
        [111,  85, 110],
        [114,  89, 115],
        [115,  91, 117]]], dtype=uint8)]"
Image_1439.jpg,621,452,227,171,1024,672,848,623,227,daskShared_local/images/Image_1439.jpg,1439,"[array([[[116, 116, 118],
        [111, 111, 113],
        [113, 112, 117],
        ...,
        [ 83,  91,  99],
        [ 89,  96, 102],
        [ 96, 101, 105]],

       [[109, 108, 114],
        [111, 110, 115],
        [116, 113, 123],
        ...,
        [ 94, 102, 104],
        [ 92,  98,  97],
        [ 93,  99,  97]],

       [[114, 113, 119],
        [114, 113, 119],
        [119, 116, 125],
        ...,
        [100, 106, 102],
        [ 93,  98,  90],
        [ 97, 101,  93]],

       ...,

       [[ 28,  85, 151],
        [ 27,  84, 151],
        [ 28,  85, 152],
        ...,
        [ 15, 114, 223],
        [ 16, 115, 223],
        [ 18, 116, 225]],

       [[ 28,  89, 161],
        [ 28,  89, 161],
        [ 29,  89, 160],
        ...,
        [ 20, 118, 227],
        [ 17, 115, 224],
        [ 14, 110, 220]],

       [[ 29,  95, 169],
        [ 32,  95, 171],
        [ 32,  93, 167],
        ...,
        [ 26, 124, 233],
        [ 20, 117, 227],
        [ 10, 106, 216]]], dtype=uint8)]"
Image_144.jpg,295,171,239,212,1000,664,534,383,239,daskShared_local/images/Image_144.jpg,144,"[array([[[  0,  79, 146],
        [  1,  80, 147],
        [  0,  79, 147],
        ...,
        [  0, 100, 168],
        [  0, 101, 170],
        [  0, 101, 171]],

       [[  1,  80, 146],
        [  0,  78, 145],
        [  0,  78, 145],
        ...,
        [  0,  99, 159],
        [  0, 100, 166],
        [  0, 100, 170]],

       [[  0,  79, 146],
        [  0,  78, 145],
        [  0,  78, 145],
        ...,
        [  0,  99, 151],
        [  0, 100, 157],
        [  0, 102, 163]],

       ...,

       [[ 37,  35,  33],
        [ 42,  36,  27],
        [ 41,  28,  21],
        ...,
        [182, 174, 146],
        [181, 174, 145],
        [154, 130,  95]],

       [[ 45,  32,  32],
        [ 43,  32,  24],
        [ 41,  30,  21],
        ...,
        [174, 165, 132],
        [178, 168, 136],
        [182, 165, 130]],

       [[ 34,  22,  21],
        [ 35,  24,  22],
        [ 31,  26,  21],
        ...,
        [124, 107,  84],
        [147, 133,  98],
        [173, 158, 127]]], dtype=uint8)]"
Image_1440.JPG,267,463,1555,1457,2560,1920,1822,1920,1555,daskShared_local/images/Image_1440.JPG,1440,"[array([[[ 84,  60,  28],
        [ 78,  65,  29],
        [ 82,  67,  29],
        ...,
        [137, 120,  85],
        [123, 107,  67],
        [105,  93,  52]],

       [[ 75,  65,  26],
        [ 79,  69,  30],
        [ 83,  70,  32],
        ...,
        [155, 145, 112],
        [154, 139, 112],
        [138, 124, 102]],

       [[ 73,  64,  28],
        [ 81,  72,  26],
        [ 88,  74,  33],
        ...,
        [167, 160, 139],
        [183, 169, 149],
        [187, 170, 158]],

       ...,

       [[ 80,  92,  33],
        [ 79,  93,  34],
        [ 80,  89,  31],
        ...,
        [ 91,  98,  26],
        [ 88, 100,  30],
        [ 91, 101,  36]],

       [[ 94, 104,  49],
        [ 87,  99,  44],
        [ 81,  90,  30],
        ...,
        [ 89, 100,  32],
        [ 90,  99,  30],
        [ 94, 103,  26]],

       [[ 97, 105,  62],
        [ 90, 100,  43],
        [ 81,  90,  28],
        ...,
        [ 93, 100,  29],
        [ 91, 100,  27],
        [ 88, 102,  25]]], dtype=uint8)]"
Image_1441.jpg,290,368,200,147,1024,683,490,515,200,daskShared_local/images/Image_1441.jpg,1441,"[array([[[165, 171, 167],
        [138, 152, 153],
        [123, 138, 145],
        ...,
        [161, 149, 104],
        [163, 156, 110],
        [171, 165, 115]],

       [[191, 197, 183],
        [176, 189, 182],
        [149, 163, 163],
        ...,
        [150, 137,  92],
        [159, 152, 106],
        [167, 161, 111]],

       [[184, 195, 189],
        [197, 199, 191],
        [196, 194, 182],
        ...,
        [148, 135,  91],
        [151, 137,  90],
        [160, 147, 102]],

       ...,

       [[  0, 104, 129],
        [  0, 104, 129],
        [  0, 104, 129],
        ...,
        [  0, 111, 135],
        [  0, 110, 135],
        [  0, 110, 135]],

       [[  0, 104, 129],
        [  0, 104, 129],
        [  0, 104, 129],
        ...,
        [  0, 110, 133],
        [  0, 110, 133],
        [  0, 110, 133]],

       [[  1, 105, 130],
        [  1, 105, 130],
        [  1, 105, 130],
        ...,
        [  0, 110, 133],
        [  0, 109, 132],
        [  0, 109, 132]]], dtype=uint8)]"
Image_1442.jpg,105,75,95,66,475,264,200,141,95,daskShared_local/images/Image_1442.jpg,1442,"[array([[[23, 41, 58],
        [23, 41, 58],
        [23, 41, 57],
        ...,
        [20, 44, 70],
        [20, 43, 69],
        [20, 43, 69]],

       [[23, 41, 58],
        [23, 41, 58],
        [23, 41, 57],
        ...,
        [20, 44, 70],
        [20, 43, 68],
        [20, 43, 68]],

       [[24, 43, 60],
        [24, 43, 60],
        [24, 43, 59],
        ...,
        [22, 47, 75],
        [23, 48, 75],
        [23, 48, 75]],

       ...,

       [[13, 22, 31],
        [13, 22, 31],
        [12, 21, 30],
        ...,
        [36, 53, 59],
        [31, 45, 51],
        [31, 46, 52]],

       [[15, 24, 33],
        [15, 24, 33],
        [14, 23, 32],
        ...,
        [41, 59, 65],
        [37, 52, 58],
        [37, 53, 59]],

       [[15, 24, 33],
        [15, 24, 33],
        [14, 23, 32],
        ...,
        [41, 58, 65],
        [36, 52, 57],
        [37, 52, 58]]], dtype=uint8)]"
Image_1443.jpg,384,81,114,69,580,435,498,150,114,daskShared_local/images/Image_1443.jpg,1443,"[array([[[ 74, 123, 130],
        [ 73, 122, 129],
        [ 71, 120, 127],
        ...,
        [ 68, 118, 119],
        [ 66, 117, 118],
        [ 65, 117, 118]],

       [[ 74, 123, 130],
        [ 74, 123, 129],
        [ 71, 120, 126],
        ...,
        [ 68, 119, 120],
        [ 66, 117, 118],
        [ 65, 117, 118]],

       [[ 76, 125, 130],
        [ 75, 124, 129],
        [ 71, 120, 125],
        ...,
        [ 69, 120, 121],
        [ 65, 118, 118],
        [ 64, 118, 118]],

       ...,

       [[101, 141,  89],
        [108, 148,  96],
        [133, 173, 123],
        ...,
        [ 78, 116,  66],
        [ 89, 127,  80],
        [ 92, 129,  84]],

       [[102, 144,  90],
        [110, 151,  98],
        [139, 181, 131],
        ...,
        [ 81, 119,  69],
        [ 90, 128,  82],
        [ 93, 130,  86]],

       [[102, 144,  90],
        [110, 152,  99],
        [141, 183, 132],
        ...,
        [ 81, 119,  70],
        [ 91, 128,  83],
        [ 93, 130,  86]]], dtype=uint8)]"
Image_1444.jpg,329,31,126,90,623,200,455,121,126,daskShared_local/images/Image_1444.jpg,1444,"[array([[[  0, 163, 252],
        [  0, 163, 252],
        [  0, 163, 252],
        ...,
        [  2, 130, 255],
        [  2, 130, 255],
        [  2, 130, 255]],

       [[  0, 163, 252],
        [  0, 163, 252],
        [  0, 163, 252],
        ...,
        [  2, 130, 255],
        [  2, 130, 255],
        [  2, 130, 255]],

       [[  0, 163, 252],
        [  0, 163, 252],
        [  0, 163, 252],
        ...,
        [  2, 130, 255],
        [  2, 130, 255],
        [  2, 130, 255]],

       ...,

       [[ 30,  51,  39],
        [ 21,  40,  28],
        [  4,  20,   9],
        ...,
        [  1,  99, 255],
        [  2,  99, 255],
        [  2,  99, 255]],

       [[ 27,  48,  32],
        [ 18,  37,  22],
        [  2,  17,   4],
        ...,
        [  0,  98, 255],
        [  1,  98, 255],
        [  1,  98, 255]],

       [[ 26,  47,  29],
        [ 17,  36,  20],
        [  2,  17,   3],
        ...,
        [  0,  98, 255],
        [  1,  98, 255],
        [  1,  98, 255]]], dtype=uint8)]"
Image_1445.jpg,1309,638,166,157,2304,1536,1475,795,166,daskShared_local/images/Image_1445.jpg,1445,"[array([[[  2, 114, 152],
        [  2, 115, 153],
        [  1, 115, 153],
        ...,
        [  0, 114, 142],
        [  0, 114, 143],
        [  0, 114, 143]],

       [[  3, 113, 152],
        [  2, 114, 153],
        [  1, 113, 153],
        ...,
        [  2, 116, 143],
        [  4, 119, 147],
        [  4, 121, 148]],

       [[  4, 113, 153],
        [  3, 113, 152],
        [  2, 111, 152],
        ...,
        [  5, 120, 147],
        [  9, 126, 152],
        [ 10, 128, 154]],

       ...,

       [[ 86, 132, 148],
        [ 89, 134, 150],
        [ 90, 135, 150],
        ...,
        [ 37,  47,  49],
        [ 36,  45,  47],
        [ 35,  43,  45]],

       [[ 82, 127, 140],
        [ 84, 126, 140],
        [ 85, 127, 140],
        ...,
        [ 30,  40,  42],
        [ 30,  39,  42],
        [ 30,  39,  41]],

       [[ 91, 134, 142],
        [ 91, 131, 140],
        [ 90, 128, 137],
        ...,
        [ 31,  41,  43],
        [ 32,  42,  44],
        [ 34,  42,  45]]], dtype=uint8)]"
Image_1446.jpg,495,164,100,80,660,438,595,244,100,daskShared_local/images/Image_1446.jpg,1446,"[array([[[  6,  29,  68],
        [  6,  29,  68],
        [  9,  30,  71],
        ...,
        [  0,   9,  53],
        [  1,  13,  55],
        [  1,  13,  55]],

       [[  6,  29,  68],
        [  6,  29,  68],
        [  8,  30,  71],
        ...,
        [  0,   9,  53],
        [  2,  13,  55],
        [  2,  13,  55]],

       [[  2,  24,  62],
        [  2,  24,  62],
        [  3,  21,  62],
        ...,
        [  1,  12,  55],
        [  5,  18,  61],
        [  5,  18,  61]],

       ...,

       [[247, 231, 192],
        [246, 230, 191],
        [232, 197, 143],
        ...,
        [ 71,  59,  68],
        [ 72,  59,  70],
        [ 72,  58,  70]],

       [[233, 214, 175],
        [233, 213, 173],
        [196, 160, 110],
        ...,
        [ 61,  49,  59],
        [ 62,  48,  61],
        [ 62,  48,  62]],

       [[233, 214, 174],
        [232, 213, 173],
        [195, 159, 109],
        ...,
        [ 61,  49,  59],
        [ 62,  48,  61],
        [ 62,  48,  61]]], dtype=uint8)]"
Image_1447.jpg,447,273,167,175,850,567,614,448,175,daskShared_local/images/Image_1447.jpg,1447,"[array([[[ 56,  35,  35],
        [ 95,  60,  62],
        [150, 108, 105],
        ...,
        [168, 143, 119],
        [ 91,  90, 112],
        [ 60,  70, 118]],

       [[ 53,  34,  42],
        [105,  76,  71],
        [127,  94,  87],
        ...,
        [166, 140, 130],
        [ 88,  90, 126],
        [ 73,  85, 130]],

       [[ 71,  52,  51],
        [ 86,  61,  56],
        [ 81,  52,  46],
        ...,
        [142, 123, 130],
        [ 70,  76, 120],
        [ 69,  83, 123]],

       ...,

       [[ 10, 124, 236],
        [  8, 122, 234],
        [  7, 121, 233],
        ...,
        [ 10, 128, 234],
        [ 10, 128, 234],
        [  9, 127, 233]],

       [[  9, 123, 235],
        [  8, 122, 234],
        [  8, 122, 234],
        ...,
        [ 10, 128, 234],
        [ 10, 128, 234],
        [ 10, 128, 234]],

       [[  9, 123, 235],
        [  8, 122, 234],
        [  9, 123, 235],
        ...,
        [  9, 127, 233],
        [  8, 126, 232],
        [ 10, 128, 234]]], dtype=uint8)]"
Image_1448.jpg,634,97,384,481,2000,1000,1018,578,481,daskShared_local/images/Image_1448.jpg,1448,"[array([[[  0, 159, 209],
        [  0, 159, 209],
        [  1, 159, 211],
        ...,
        [152, 199, 241],
        [153, 200, 242],
        [153, 200, 242]],

       [[  1, 158, 211],
        [  0, 159, 211],
        [  1, 158, 211],
        ...,
        [152, 199, 241],
        [153, 200, 242],
        [153, 200, 242]],

       [[  1, 156, 210],
        [  0, 157, 210],
        [  0, 157, 210],
        ...,
        [152, 199, 241],
        [153, 200, 242],
        [153, 200, 242]],

       ...,

       [[  1, 144, 204],
        [  1, 144, 204],
        [  0, 144, 204],
        ...,
        [135, 113,  96],
        [ 84,  64,  53],
        [ 79,  59,  51]],

       [[  1, 143, 203],
        [  1, 143, 203],
        [  0, 144, 204],
        ...,
        [114,  95,  83],
        [ 71,  54,  50],
        [ 72,  55,  47]],

       [[  1, 143, 203],
        [  1, 143, 204],
        [  1, 144, 204],
        ...,
        [107,  88,  78],
        [ 66,  48,  44],
        [ 72,  57,  51]]], dtype=uint8)]"
Image_1449.jpg,962,373,210,200,2000,1000,1172,573,210,daskShared_local/images/Image_1449.jpg,1449,"[array([[[198, 172, 137],
        [194, 170, 132],
        [189, 165, 127],
        ...,
        [197, 179, 146],
        [195, 173, 140],
        [196, 171, 140]],

       [[198, 174, 138],
        [195, 173, 136],
        [189, 167, 129],
        ...,
        [201, 184, 148],
        [196, 176, 139],
        [192, 170, 130]],

       [[199, 179, 145],
        [197, 179, 144],
        [193, 175, 139],
        ...,
        [204, 186, 151],
        [201, 182, 142],
        [197, 176, 132]],

       ...,

       [[170, 162, 143],
        [146, 137, 120],
        [103,  94,  80],
        ...,
        [170, 146, 110],
        [184, 159, 126],
        [184, 156, 124]],

       [[173, 168, 140],
        [128, 124, 100],
        [ 73,  69,  55],
        ...,
        [201, 177, 145],
        [157, 134, 102],
        [163, 138, 105]],

       [[165, 161, 135],
        [135, 130, 110],
        [ 78,  74,  63],
        ...,
        [222, 197, 166],
        [171, 146, 115],
        [171, 143, 109]]], dtype=uint8)]"
Image_145.jpg,410,138,199,196,869,574,609,334,199,daskShared_local/images/Image_145.jpg,145,"[array([[[  0, 138, 203],
        [  0, 138, 205],
        [  0, 139, 208],
        ...,
        [ 72, 166, 240],
        [ 70, 166, 240],
        [ 69, 161, 238]],

       [[  0, 138, 203],
        [  0, 138, 205],
        [  0, 138, 207],
        ...,
        [ 75, 165, 241],
        [ 73, 165, 240],
        [ 68, 160, 237]],

       [[  0, 137, 205],
        [  0, 137, 205],
        [  0, 137, 207],
        ...,
        [ 73, 163, 239],
        [ 71, 163, 238],
        [ 69, 161, 238]],

       ...,

       [[  0,  63,  37],
        [  7,  62,  39],
        [  8,  74,  47],
        ...,
        [  0, 109, 180],
        [  0, 109, 180],
        [  1, 109, 181]],

       [[  0,  52,  29],
        [ 25,  59,  43],
        [ 26,  71,  51],
        ...,
        [  0, 109, 180],
        [  0, 109, 180],
        [  1, 108, 180]],

       [[ 12,  38,  25],
        [ 11,  18,  11],
        [  7,  29,  17],
        ...,
        [  0, 109, 180],
        [  0, 109, 180],
        [  1, 108, 180]]], dtype=uint8)]"
Image_1450.png,361,51,196,158,600,600,557,209,196,daskShared_local/images/Image_1450.png,1450,"[array([[[  0, 100, 248],
        [  1, 101, 249],
        [  0, 100, 248],
        ...,
        [  1, 119, 255],
        [  1, 119, 255],
        [  1, 119, 255]],

       [[  0, 100, 248],
        [  1, 101, 249],
        [  1, 101, 249],
        ...,
        [  1, 119, 255],
        [  1, 119, 255],
        [  1, 119, 255]],

       [[  1, 101, 249],
        [  1, 101, 249],
        [  1, 101, 249],
        ...,
        [  0, 118, 254],
        [  0, 118, 254],
        [  0, 118, 254]],

       ...,

       [[206, 198, 117],
        [199, 184,  99],
        [157, 122,  46],
        ...,
        [242, 249, 194],
        [244, 253, 174],
        [245, 253, 171]],

       [[187, 152,  25],
        [252, 233,  96],
        [230, 216, 144],
        ...,
        [238, 250, 174],
        [238, 249, 171],
        [244, 250, 190]],

       [[127,  79,   1],
        [231, 220, 140],
        [231, 245, 246],
        ...,
        [239, 249, 186],
        [240, 250, 190],
        [240, 246, 198]]], dtype=uint8)]"
Image_1451.jpg,466,118,114,87,685,360,580,205,114,daskShared_local/images/Image_1451.jpg,1451,"[array([[[  0, 109, 152],
        [  0, 109, 152],
        [  0, 108, 151],
        ...,
        [  0, 101, 145],
        [  0, 101, 145],
        [  0, 101, 145]],

       [[  0, 109, 152],
        [  0, 109, 152],
        [  0, 108, 151],
        ...,
        [  0, 101, 145],
        [  0, 101, 145],
        [  0, 101, 145]],

       [[  1, 110, 153],
        [  1, 109, 152],
        [  0, 108, 151],
        ...,
        [  0, 101, 145],
        [  0, 101, 145],
        [  0, 101, 145]],

       ...,

       [[  1,  85, 121],
        [  1,  85, 121],
        [  1,  85, 121],
        ...,
        [  0,  82, 116],
        [  0,  82, 116],
        [  0,  82, 116]],

       [[  1,  85, 121],
        [  1,  85, 121],
        [  1,  85, 121],
        ...,
        [  0,  82, 116],
        [  0,  82, 116],
        [  0,  82, 116]],

       [[  1,  85, 121],
        [  1,  85, 121],
        [  1,  85, 121],
        ...,
        [  0,  82, 116],
        [  0,  82, 116],
        [  0,  82, 116]]], dtype=uint8)]"
Image_1452.jpg,635,329,295,326,2361,1176,930,655,326,daskShared_local/images/Image_1452.jpg,1452,"[array([[[  7, 143, 191],
        [  7, 143, 191],
        [  5, 141, 190],
        ...,
        [ 45, 174, 216],
        [ 48, 175, 218],
        [ 45, 175, 217]],

       [[  8, 144, 192],
        [  7, 143, 191],
        [  7, 142, 192],
        ...,
        [ 45, 173, 216],
        [ 44, 171, 214],
        [ 43, 174, 216]],

       [[  8, 144, 192],
        [  8, 144, 192],
        [ 10, 142, 193],
        ...,
        [ 46, 172, 216],
        [ 46, 170, 214],
        [ 41, 174, 213]],

       ...,

       [[ 10, 173, 238],
        [ 10, 173, 238],
        [  9, 172, 237],
        ...,
        [  4,  76,  82],
        [  2,  71,  79],
        [  7,  78,  79]],

       [[ 10, 173, 238],
        [ 10, 173, 238],
        [  9, 172, 237],
        ...,
        [ 10,  78,  80],
        [ 11,  74,  79],
        [ 11,  81,  79]],

       [[  9, 172, 237],
        [  9, 172, 237],
        [  9, 172, 237],
        ...,
        [ 14,  77,  77],
        [ 16,  74,  76],
        [ 11,  80,  77]]], dtype=uint8)]"
Image_1453.jpg,404,5,73,63,530,180,477,68,73,daskShared_local/images/Image_1453.jpg,1453,"[array([[[ 11,  29,  66],
        [ 13,  30,  66],
        [ 10,  28,  66],
        ...,
        [  3,  26,  61],
        [  5,  32,  64],
        [  4,  27,  61]],

       [[  6,  25,  63],
        [  8,  26,  62],
        [  6,  24,  63],
        ...,
        [  3,  26,  60],
        [  5,  33,  65],
        [  3,  28,  62]],

       [[ 13,  31,  67],
        [ 15,  32,  68],
        [ 12,  30,  67],
        ...,
        [  3,  25,  61],
        [  5,  31,  63],
        [  4,  27,  61]],

       ...,

       [[202, 151,  80],
        [203, 147,  77],
        [201, 152,  82],
        ...,
        [ 44,  35,  55],
        [ 39,  30,  52],
        [ 43,  34,  54]],

       [[217, 172, 105],
        [218, 169, 104],
        [216, 173, 105],
        ...,
        [ 42,  35,  61],
        [ 29,  22,  51],
        [ 38,  31,  58]],

       [[206, 157,  87],
        [207, 154,  85],
        [205, 158,  88],
        ...,
        [ 44,  35,  57],
        [ 36,  28,  52],
        [ 41,  33,  55]]], dtype=uint8)]"
Image_1454.jpg,205,441,178,192,2015,1510,383,633,192,daskShared_local/images/Image_1454.jpg,1454,"[array([[[ 18,  15,  10],
        [ 22,  19,  14],
        [ 31,  28,  21],
        ...,
        [ 54,  53,  51],
        [ 39,  38,  36],
        [ 28,  24,  23]],

       [[ 22,  19,  14],
        [ 26,  23,  18],
        [ 42,  39,  34],
        ...,
        [ 53,  52,  50],
        [ 40,  39,  37],
        [ 28,  24,  23]],

       [[ 27,  25,  21],
        [ 28,  27,  23],
        [ 44,  42,  38],
        ...,
        [ 47,  46,  44],
        [ 40,  38,  36],
        [ 29,  25,  24]],

       ...,

       [[195, 181, 168],
        [201, 187, 173],
        [173, 160, 144],
        ...,
        [138, 148, 150],
        [140, 148, 151],
        [151, 159, 162]],

       [[194, 180, 167],
        [210, 197, 181],
        [202, 189, 173],
        ...,
        [148, 158, 159],
        [143, 151, 153],
        [148, 156, 158]],

       [[162, 149, 133],
        [182, 169, 153],
        [159, 146, 130],
        ...,
        [155, 165, 166],
        [141, 149, 151],
        [138, 146, 148]]], dtype=uint8)]"
Image_1455.png,377,182,325,288,900,600,702,470,325,daskShared_local/images/Image_1455.png,1455,"[array([[[101, 104, 100],
        [ 94,  93,  98],
        [ 99,  98, 105],
        ...,
        [ 18, 150, 183],
        [ 15, 153, 181],
        [ 20, 152, 182]],

       [[127, 117,  99],
        [119, 114, 104],
        [123, 118, 105],
        ...,
        [ 20, 150, 187],
        [ 19, 146, 182],
        [ 16, 150, 183]],

       [[113,  97,  81],
        [121, 101,  95],
        [119, 102,  89],
        ...,
        [ 20, 150, 182],
        [ 17, 151, 180],
        [ 24, 150, 179]],

       ...,

       [[ 28,  69,  64],
        [ 25,  71,  66],
        [ 25,  67,  62],
        ...,
        [ 87, 146, 144],
        [ 86, 150, 143],
        [ 98, 155, 153]],

       [[ 25,  70,  68],
        [ 26,  66,  69],
        [ 26,  65,  63],
        ...,
        [ 90, 152, 148],
        [ 97, 150, 149],
        [ 96, 155, 147]],

       [[ 23,  71,  62],
        [ 25,  70,  64],
        [ 27,  64,  64],
        ...,
        [ 90, 154, 149],
        [ 94, 155, 154],
        [ 91, 158, 153]]], dtype=uint8)]"
Image_1456.jpg,497,366,206,171,1024,678,703,537,206,daskShared_local/images/Image_1456.jpg,1456,"[array([[[131, 107,  93],
        [127, 101,  88],
        [120,  98,  83],
        ...,
        [193, 156, 121],
        [182, 147, 108],
        [157, 126,  97]],

       [[115,  88,  72],
        [136, 111,  98],
        [143, 126, 106],
        ...,
        [194, 161, 120],
        [174, 138,  89],
        [137, 100,  64]],

       [[115,  82,  73],
        [141, 118, 105],
        [160, 149, 129],
        ...,
        [163, 131, 115],
        [144, 117,  94],
        [201, 184, 158]],

       ...,

       [[239, 231, 202],
        [249, 243, 210],
        [240, 228, 187],
        ...,
        [241, 217, 161],
        [230, 214, 158],
        [230, 209, 158]],

       [[223, 213, 179],
        [241, 228, 192],
        [239, 220, 176],
        ...,
        [239, 215, 161],
        [222, 205, 158],
        [226, 208, 162]],

       [[241, 226, 189],
        [232, 216, 177],
        [239, 220, 174],
        ...,
        [236, 209, 151],
        [240, 218, 160],
        [243, 221, 164]]], dtype=uint8)]"
Image_1457.jpg,126,37,610,591,1000,750,736,628,610,daskShared_local/images/Image_1457.jpg,1457,"[array([[[ 10,  86,  88],
        [ 10,  93,  93],
        [ 10, 108, 118],
        ...,
        [  5,   9,   8],
        [  4,   8,   7],
        [  2,   6,   5]],

       [[  4, 106, 110],
        [  4,  92,  95],
        [  7,  94, 106],
        ...,
        [  4,   8,   7],
        [  4,   8,   7],
        [  4,   8,   7]],

       [[ 15, 135, 144],
        [ 15, 119, 129],
        [  8, 102, 115],
        ...,
        [  4,   8,   7],
        [  4,   8,   7],
        [  4,   8,   7]],

       ...,

       [[170, 140,  90],
        [175, 141,  88],
        [172, 140,  88],
        ...,
        [ 20,  32,  21],
        [ 21,  33,  24],
        [ 21,  33,  24]],

       [[180, 151, 103],
        [175, 143, 104],
        [161, 134,  94],
        ...,
        [ 20,  31,  22],
        [ 20,  31,  24],
        [ 19,  30,  25]],

       [[158, 136,  92],
        [146, 122,  86],
        [132, 112,  74],
        ...,
        [ 19,  30,  23],
        [ 18,  29,  23],
        [ 15,  26,  22]]], dtype=uint8)]"
Image_1458.jpg,180,96,405,294,1024,670,585,390,405,daskShared_local/images/Image_1458.jpg,1458,"[array([[[ 15,  26,  44],
        [ 13,  25,  41],
        [ 21,  33,  47],
        ...,
        [  9,  50,  75],
        [ 16,  53,  76],
        [ 15,  49,  75]],

       [[ 18,  29,  48],
        [ 18,  30,  48],
        [ 19,  31,  47],
        ...,
        [ 10,  52,  76],
        [ 19,  51,  73],
        [ 22,  51,  78]],

       [[ 16,  27,  48],
        [ 24,  37,  56],
        [ 31,  44,  61],
        ...,
        [ 19,  56,  81],
        [ 23,  47,  71],
        [ 30,  54,  82]],

       ...,

       [[ 46, 120, 136],
        [ 36, 120, 125],
        [ 54, 130, 132],
        ...,
        [ 73,  77,  78],
        [ 17,  29,  40],
        [ 30,  35,  38]],

       [[ 73, 145, 160],
        [ 99, 187, 189],
        [103, 182, 182],
        ...,
        [ 95,  88,  90],
        [ 14,  27,  43],
        [ 53,  60,  63]],

       [[120, 191, 206],
        [ 88, 175, 180],
        [ 81, 158, 160],
        ...,
        [147, 138, 139],
        [ 17,  34,  54],
        [ 48,  63,  67]]], dtype=uint8)]"
Image_1459.jpg,36,79,261,179,800,600,297,258,261,daskShared_local/images/Image_1459.jpg,1459,"[array([[[  9, 154, 209],
        [  9, 155, 208],
        [ 11, 157, 209],
        ...,
        [ 22, 179, 230],
        [ 18, 177, 230],
        [ 16, 175, 230]],

       [[ 10, 155, 210],
        [ 17, 159, 214],
        [ 17, 161, 213],
        ...,
        [ 19, 178, 227],
        [ 17, 177, 227],
        [ 14, 175, 227]],

       [[ 11, 157, 212],
        [ 16, 160, 214],
        [ 14, 158, 210],
        ...,
        [ 14, 174, 222],
        [ 15, 175, 223],
        [ 19, 179, 228]],

       ...,

       [[ 63, 117, 101],
        [ 65, 117, 103],
        [ 63, 113, 101],
        ...,
        [ 70,  22,  18],
        [ 72,  22,  19],
        [ 69,  20,  19]],

       [[ 59, 111,  95],
        [ 63, 113, 101],
        [ 63, 113, 102],
        ...,
        [ 59,   9,   6],
        [ 61,   7,   9],
        [ 62,   8,  13]],

       [[ 64, 115,  99],
        [ 64, 114, 102],
        [ 64, 115, 105],
        ...,
        [ 70,  23,  21],
        [ 70,  16,  20],
        [ 67,  12,  18]]], dtype=uint8)]"
Image_146.jpg,3225,764,914,921,5616,2633,4139,1685,921,daskShared_local/images/Image_146.jpg,146,"[array([[[  0, 196, 243],
        [  0, 196, 244],
        [  0, 196, 244],
        ...,
        [  0, 208, 255],
        [  0, 208, 255],
        [  0, 207, 255]],

       [[  0, 196, 244],
        [  0, 195, 243],
        [  0, 196, 244],
        ...,
        [  0, 208, 255],
        [  1, 207, 255],
        [  1, 207, 255]],

       [[  0, 196, 244],
        [  0, 196, 244],
        [  0, 195, 243],
        ...,
        [  0, 208, 255],
        [  0, 207, 255],
        [  0, 206, 255]],

       ...,

       [[176, 196, 191],
        [182, 204, 193],
        [170, 209, 197],
        ...,
        [219, 173, 143],
        [215, 165, 138],
        [228, 186, 166]],

       [[158, 184, 193],
        [150, 186, 189],
        [119, 201, 202],
        ...,
        [202, 147, 122],
        [204, 151, 127],
        [217, 170, 148]],

       [[133, 178, 191],
        [107, 195, 199],
        [ 61, 180, 186],
        ...,
        [180, 118,  97],
        [196, 138, 124],
        [212, 164, 147]]], dtype=uint8)]"
Image_1460.jpg,209,36,214,170,900,521,423,206,214,daskShared_local/images/Image_1460.jpg,1460,"[array([[[ 16,  58, 170],
        [ 16,  58, 170],
        [ 16,  58, 170],
        ...,
        [ 34,  69, 185],
        [ 34,  69, 185],
        [ 34,  69, 185]],

       [[ 16,  58, 170],
        [ 16,  58, 170],
        [ 16,  58, 170],
        ...,
        [ 34,  69, 185],
        [ 34,  69, 185],
        [ 34,  69, 185]],

       [[ 16,  58, 170],
        [ 16,  58, 170],
        [ 16,  58, 170],
        ...,
        [ 32,  69, 184],
        [ 32,  69, 184],
        [ 32,  69, 184]],

       ...,

       [[  2,  52, 139],
        [  2,  52, 139],
        [  2,  52, 139],
        ...,
        [218, 234, 231],
        [201, 217, 216],
        [188, 204, 203]],

       [[  1,  53, 139],
        [  1,  53, 139],
        [  1,  53, 139],
        ...,
        [215, 231, 228],
        [196, 212, 211],
        [179, 195, 194]],

       [[  2,  54, 140],
        [  2,  54, 140],
        [  2,  54, 140],
        ...,
        [209, 225, 222],
        [192, 208, 207],
        [174, 190, 189]]], dtype=uint8)]"
Image_1461.jpg,166,356,258,169,1200,900,424,525,258,daskShared_local/images/Image_1461.jpg,1461,"[array([[[143, 215, 194],
        [145, 213, 196],
        [146, 207, 190],
        ...,
        [ 25, 163, 156],
        [ 27, 162, 155],
        [ 25, 158, 150]],

       [[155, 217, 192],
        [152, 219, 194],
        [157, 220, 190],
        ...,
        [ 27, 157, 152],
        [ 28, 155, 151],
        [ 23, 147, 142]],

       [[137, 194, 172],
        [133, 201, 174],
        [141, 206, 172],
        ...,
        [ 24, 144, 143],
        [ 25, 141, 141],
        [ 24, 138, 139]],

       ...,

       [[ 48,  72,  74],
        [ 47,  70,  73],
        [ 55,  84,  84],
        ...,
        [ 47,  45,  31],
        [ 52,  51,  31],
        [ 50,  49,  27]],

       [[ 44,  69,  70],
        [ 46,  73,  75],
        [ 50,  88,  87],
        ...,
        [ 60,  49,  23],
        [ 67,  54,  29],
        [ 80,  64,  42]],

       [[ 33,  59,  65],
        [ 38,  67,  72],
        [ 37,  82,  80],
        ...,
        [ 93,  78,  37],
        [119, 109,  73],
        [152, 148, 114]]], dtype=uint8)]"
Image_1462.jpg,280,165,172,168,800,533,452,333,172,daskShared_local/images/Image_1462.jpg,1462,"[array([[[229, 207, 170],
        [232, 210, 174],
        [236, 214, 178],
        ...,
        [ 75,  73, 101],
        [ 88,  85, 112],
        [ 90,  88, 112]],

       [[235, 213, 181],
        [236, 215, 182],
        [237, 216, 183],
        ...,
        [ 59,  57,  83],
        [ 79,  77, 101],
        [ 99,  97, 120]],

       [[240, 219, 196],
        [237, 216, 193],
        [234, 213, 190],
        ...,
        [ 57,  55,  79],
        [ 57,  55,  77],
        [ 66,  64,  85]],

       ...,

       [[155, 127, 115],
        [158, 130, 118],
        [158, 130, 118],
        ...,
        [ 75,  57,  44],
        [ 74,  56,  43],
        [ 74,  56,  43]],

       [[166, 138, 126],
        [164, 136, 124],
        [160, 132, 120],
        ...,
        [ 94,  76,  62],
        [ 93,  75,  61],
        [ 92,  74,  60]],

       [[142, 114, 102],
        [143, 115, 103],
        [150, 122, 110],
        ...,
        [116,  98,  84],
        [113,  95,  81],
        [109,  91,  77]]], dtype=uint8)]"
Image_1463.jpg,92,82,71,65,450,300,163,147,71,daskShared_local/images/Image_1463.jpg,1463,"[array([[[  1,  86, 205],
        [  1,  86, 205],
        [  1,  86, 205],
        ...,
        [229, 214,   0],
        [240, 222,   0],
        [231, 216,   0]],

       [[  0,  86, 205],
        [  0,  86, 205],
        [  0,  86, 205],
        ...,
        [231, 218,   0],
        [242, 226,   0],
        [234, 220,   0]],

       [[  1,  86, 205],
        [  1,  86, 205],
        [  1,  86, 205],
        ...,
        [228, 213,   0],
        [239, 221,   0],
        [230, 215,   0]],

       ...,

       [[  0,  86, 197],
        [  0,  86, 197],
        [  0,  86, 197],
        ...,
        [209, 182, 120],
        [220, 192, 127],
        [211, 184, 122]],

       [[  0,  86, 197],
        [  0,  86, 197],
        [  0,  86, 197],
        ...,
        [209, 183, 127],
        [222, 195, 139],
        [212, 185, 130]],

       [[  0,  86, 197],
        [  0,  86, 197],
        [  0,  86, 197],
        ...,
        [209, 182, 122],
        [220, 193, 130],
        [212, 184, 123]]], dtype=uint8)]"
Image_1464.jpg,267,192,191,128,1000,667,458,320,191,daskShared_local/images/Image_1464.jpg,1464,"[array([[[  1,  74, 177],
        [  0,  73, 176],
        [  1,  74, 177],
        ...,
        [  0,  50, 135],
        [  1,  51, 136],
        [  0,  50, 135]],

       [[  1,  72, 178],
        [  2,  73, 177],
        [  1,  72, 178],
        ...,
        [  0,  52, 138],
        [  2,  49, 139],
        [  0,  50, 139]],

       [[  0,  70, 181],
        [  0,  71, 177],
        [  0,  71, 177],
        ...,
        [  0,  49, 141],
        [  1,  48, 138],
        [  2,  49, 137]],

       ...,

       [[ 47, 125, 126],
        [ 55, 121, 113],
        [ 70, 124, 108],
        ...,
        [174, 182, 140],
        [158, 164, 118],
        [125, 139,  92]],

       [[ 72, 142, 123],
        [ 81, 130, 107],
        [ 92, 133, 111],
        ...,
        [168, 170, 124],
        [130, 138,  86],
        [ 83,  89,  63]],

       [[ 83, 147, 117],
        [ 72, 121,  83],
        [ 70,  95,  75],
        ...,
        [152, 159, 107],
        [ 83,  91,  53],
        [ 84,  96,  71]]], dtype=uint8)]"
Image_1465.jpg,400,180,94,54,800,600,494,234,94,daskShared_local/images/Image_1465.jpg,1465,"[array([[[ 73, 109, 134],
        [ 73, 109, 134],
        [ 73, 110, 134],
        ...,
        [ 70,  95, 132],
        [ 70,  92, 137],
        [ 70,  92, 136]],

       [[ 74, 110, 135],
        [ 74, 110, 135],
        [ 73, 110, 134],
        ...,
        [ 70,  95, 132],
        [ 69,  91, 137],
        [ 69,  92, 136]],

       [[ 69, 105, 129],
        [ 69, 105, 129],
        [ 69, 106, 129],
        ...,
        [ 75,  98, 132],
        [ 74,  95, 134],
        [ 74,  96, 134]],

       ...,

       [[ 91, 105, 123],
        [ 90, 105, 123],
        [ 95, 109, 125],
        ...,
        [ 19, 133, 243],
        [ 19, 133, 244],
        [ 19, 133, 244]],

       [[ 89, 101, 123],
        [ 88, 101, 123],
        [ 95, 108, 126],
        ...,
        [ 18, 133, 243],
        [ 18, 132, 244],
        [ 18, 132, 244]],

       [[ 89, 102, 123],
        [ 88, 101, 123],
        [ 95, 108, 126],
        ...,
        [ 18, 133, 243],
        [ 18, 132, 244],
        [ 18, 133, 244]]], dtype=uint8)]"
Image_1466.jpg,626,216,136,109,1000,667,762,325,136,daskShared_local/images/Image_1466.jpg,1466,"[array([[[ 24,  77,  77],
        [ 28,  82,  82],
        [ 36,  91,  91],
        ...,
        [ 28, 111, 126],
        [ 39, 119, 132],
        [ 45, 122, 135]],

       [[ 30,  85,  85],
        [ 34,  89,  90],
        [ 41,  97,  98],
        ...,
        [ 23, 106, 120],
        [ 33, 112, 126],
        [ 39, 116, 129]],

       [[ 42,  99, 100],
        [ 45, 102, 103],
        [ 51, 109, 110],
        ...,
        [ 13,  96, 109],
        [ 22, 101, 114],
        [ 27, 104, 117]],

       ...,

       [[136, 135, 105],
        [129, 127,  98],
        [114, 114,  84],
        ...,
        [ 31, 120, 124],
        [ 22, 112, 118],
        [ 17, 106, 114]],

       [[145, 145, 115],
        [142, 142, 112],
        [135, 135, 104],
        ...,
        [ 36, 124, 129],
        [ 25, 114, 121],
        [ 18, 108, 115]],

       [[146, 147, 116],
        [147, 148, 117],
        [145, 146, 115],
        ...,
        [ 40, 127, 133],
        [ 29, 117, 124],
        [ 21, 110, 118]]], dtype=uint8)]"
Image_1467.jpg,1622,501,897,548,4100,2660,2519,1049,897,daskShared_local/images/Image_1467.jpg,1467,"[array([[[173, 164, 151],
        [172, 161, 145],
        [175, 162, 151],
        ...,
        [148, 141, 125],
        [146, 139, 124],
        [148, 142, 125]],

       [[177, 167, 158],
        [176, 164, 152],
        [171, 159, 145],
        ...,
        [147, 140, 125],
        [145, 138, 123],
        [150, 144, 128]],

       [[176, 164, 154],
        [176, 164, 153],
        [173, 162, 150],
        ...,
        [147, 139, 126],
        [147, 139, 126],
        [146, 138, 125]],

       ...,

       [[ 92,  86,  84],
        [ 83,  76,  72],
        [ 80,  72,  69],
        ...,
        [126, 130, 135],
        [128, 132, 138],
        [127, 132, 138]],

       [[ 73,  63,  59],
        [ 71,  62,  56],
        [ 78,  69,  66],
        ...,
        [123, 126, 133],
        [125, 128, 136],
        [126, 129, 138]],

       [[ 75,  65,  57],
        [ 76,  68,  57],
        [ 75,  68,  60],
        ...,
        [121, 124, 131],
        [123, 126, 133],
        [128, 131, 138]]], dtype=uint8)]"
Image_1468.jpg,438,368,218,218,1024,683,656,586,218,daskShared_local/images/Image_1468.jpg,1468,"[array([[[112,  91,  90],
        [ 98,  71,  66],
        [ 91,  73,  65],
        ...,
        [ 49,  38,  34],
        [ 55,  45,  39],
        [ 50,  41,  34]],

       [[133, 112, 109],
        [113,  89,  83],
        [157, 141, 134],
        ...,
        [ 53,  42,  38],
        [ 51,  42,  35],
        [ 46,  36,  30]],

       [[ 65,  44,  40],
        [103,  81,  75],
        [143, 132, 125],
        ...,
        [ 48,  35,  32],
        [ 49,  38,  32],
        [ 49,  38,  32]],

       ...,

       [[252, 243, 218],
        [217, 206, 177],
        [191, 187, 162],
        ...,
        [200, 150, 107],
        [236, 196, 150],
        [245, 201, 154]],

       [[226, 198, 162],
        [201, 171, 138],
        [158, 159, 118],
        ...,
        [234, 179, 125],
        [251, 213, 157],
        [246, 234, 173]],

       [[234, 207, 163],
        [233, 208, 165],
        [198, 202, 152],
        ...,
        [201, 144,  98],
        [209, 160, 114],
        [237, 216, 163]]], dtype=uint8)]"
Image_1469.jpg,229,10,257,215,980,500,486,225,257,daskShared_local/images/Image_1469.jpg,1469,"[array([[[116, 179, 254],
        [115, 177, 255],
        [115, 177, 254],
        ...,
        [109, 172, 254],
        [108, 171, 250],
        [ 93, 155, 239]],

       [[113, 175, 253],
        [113, 176, 255],
        [114, 176, 255],
        ...,
        [100, 165, 248],
        [111, 174, 252],
        [100, 163, 245]],

       [[111, 172, 253],
        [112, 175, 255],
        [114, 176, 255],
        ...,
        [105, 171, 250],
        [109, 172, 252],
        [111, 174, 252]],

       ...,

       [[119, 106,  99],
        [125, 117, 112],
        [131, 125, 121],
        ...,
        [ 68,  98, 106],
        [ 82, 110, 120],
        [ 91, 116, 127]],

       [[ 97,  88,  79],
        [101,  97,  91],
        [103, 101,  96],
        ...,
        [ 78, 107, 118],
        [ 82, 109, 121],
        [ 81, 108, 120]],

       [[ 75,  72,  65],
        [ 75,  75,  69],
        [ 75,  77,  71],
        ...,
        [ 76, 108, 118],
        [ 69, 100, 112],
        [ 71, 102, 114]]], dtype=uint8)]"
Image_147.jpg,604,225,402,436,1600,1070,1006,661,436,daskShared_local/images/Image_147.jpg,147,"[array([[[ 24,  73, 145],
        [ 27,  72, 145],
        [ 25,  74, 142],
        ...,
        [ 28,  69, 133],
        [ 28,  69, 133],
        [ 28,  69, 133]],

       [[ 25,  73, 145],
        [ 26,  73, 145],
        [ 24,  75, 142],
        ...,
        [ 28,  69, 133],
        [ 28,  69, 133],
        [ 28,  69, 133]],

       [[ 24,  74, 145],
        [ 25,  73, 145],
        [ 24,  75, 142],
        ...,
        [ 28,  69, 133],
        [ 28,  69, 133],
        [ 28,  69, 133]],

       ...,

       [[147, 143, 119],
        [181, 176, 148],
        [225, 196, 160],
        ...,
        [184, 150,  91],
        [179, 150, 103],
        [230, 205, 168]],

       [[123, 104,  88],
        [156, 141, 128],
        [209, 181, 159],
        ...,
        [146, 114,  75],
        [163, 128,  83],
        [218, 177, 132]],

       [[140, 116,  90],
        [158, 134, 121],
        [172, 143, 115],
        ...,
        [133, 100,  59],
        [192, 155, 109],
        [219, 177, 131]]], dtype=uint8)]"
Image_1470.jpg,535,89,310,306,1024,770,845,395,310,daskShared_local/images/Image_1470.jpg,1470,"[array([[[  2, 114, 188],
        [  2, 114, 188],
        [  2, 114, 188],
        ...,
        [ 44,  53,  59],
        [ 44,  55,  62],
        [ 38,  51,  59]],

       [[  1, 113, 185],
        [  1, 113, 185],
        [  2, 114, 186],
        ...,
        [ 39,  50,  58],
        [ 50,  62,  71],
        [ 52,  66,  75]],

       [[  3, 114, 186],
        [  2, 113, 185],
        [  3, 114, 186],
        ...,
        [ 36,  50,  59],
        [ 35,  50,  59],
        [ 60,  76,  87]],

       ...,

       [[116, 113,  82],
        [114, 113,  91],
        [ 68,  69,  59],
        ...,
        [ 37,  35,  32],
        [ 36,  37,  32],
        [ 43,  47,  41]],

       [[136, 132, 102],
        [139, 138, 116],
        [ 81,  80,  71],
        ...,
        [ 46,  47,  43],
        [ 42,  45,  40],
        [ 46,  53,  46]],

       [[130, 126,  96],
        [137, 135, 112],
        [ 78,  77,  66],
        ...,
        [ 50,  53,  48],
        [ 53,  62,  55],
        [ 43,  55,  46]]], dtype=uint8)]"
Image_1471.jpg,798,315,161,149,1536,1024,959,464,161,daskShared_local/images/Image_1471.jpg,1471,"[array([[[  0,  19,  33],
        [  0,  20,  34],
        [  2,  21,  34],
        ...,
        [ 47, 124, 214],
        [ 47, 124, 214],
        [ 47, 124, 214]],

       [[  0,  19,  33],
        [  0,  20,  34],
        [  1,  21,  36],
        ...,
        [ 47, 124, 214],
        [ 47, 124, 214],
        [ 47, 124, 214]],

       [[  1,  20,  34],
        [  1,  21,  35],
        [  1,  21,  38],
        ...,
        [ 47, 124, 214],
        [ 47, 124, 214],
        [ 47, 124, 214]],

       ...,

       [[ 20, 114, 199],
        [ 21, 116, 204],
        [ 21, 117, 205],
        ...,
        [ 17, 114, 203],
        [ 16, 115, 204],
        [ 15, 115, 205]],

       [[ 20, 112, 195],
        [ 25, 117, 203],
        [ 24, 118, 205],
        ...,
        [ 15, 115, 203],
        [ 15, 115, 204],
        [ 13, 115, 205]],

       [[ 21, 112, 193],
        [ 26, 116, 201],
        [ 25, 119, 205],
        ...,
        [ 14, 115, 203],
        [ 12, 114, 204],
        [ 10, 113, 203]]], dtype=uint8)]"
Image_1472.jpg,330,17,615,526,1190,595,945,543,615,daskShared_local/images/Image_1472.jpg,1472,"[array([[[178, 199, 211],
        [177, 198, 209],
        [188, 208, 221],
        ...,
        [206, 218, 210],
        [205, 218, 210],
        [206, 218, 211]],

       [[185, 207, 218],
        [190, 210, 220],
        [195, 214, 224],
        ...,
        [206, 219, 212],
        [206, 218, 211],
        [205, 218, 210]],

       [[194, 213, 222],
        [201, 221, 227],
        [204, 223, 229],
        ...,
        [207, 220, 213],
        [206, 219, 212],
        [204, 218, 210]],

       ...,

       [[115,  52,  69],
        [ 88,  32,  48],
        [ 95,  31,  49],
        ...,
        [136,  61,  49],
        [138,  60,  50],
        [142,  60,  49]],

       [[176,  69, 105],
        [151,  42,  77],
        [160,  56,  91],
        ...,
        [133,  57,  43],
        [134,  56,  47],
        [137,  59,  49]],

       [[191,  83, 122],
        [172,  61,  96],
        [163,  51,  90],
        ...,
        [130,  49,  31],
        [130,  50,  34],
        [129,  52,  43]]], dtype=uint8)]"
Image_1473.jpg,423,130,729,628,1152,763,1152,758,729,daskShared_local/images/Image_1473.jpg,1473,"[array([[[  2, 181, 237],
        [  1, 182, 237],
        [  1, 182, 237],
        ...,
        [  0, 183, 237],
        [  0, 184, 238],
        [  0, 183, 237]],

       [[  1, 180, 236],
        [  0, 180, 236],
        [  0, 180, 236],
        ...,
        [  0, 183, 237],
        [  0, 184, 238],
        [  0, 184, 238]],

       [[  0, 179, 235],
        [  0, 179, 235],
        [  1, 180, 236],
        ...,
        [  0, 183, 237],
        [  0, 184, 238],
        [  0, 184, 238]],

       ...,

       [[156, 179, 152],
        [156, 179, 154],
        [156, 179, 156],
        ...,
        [151, 175, 147],
        [172, 186, 158],
        [182, 204, 201]],

       [[159, 182, 157],
        [159, 182, 159],
        [159, 181, 159],
        ...,
        [158, 182, 171],
        [164, 192, 179],
        [134, 175, 176]],

       [[159, 182, 157],
        [159, 183, 161],
        [159, 183, 160],
        ...,
        [153, 181, 170],
        [123, 174, 172],
        [136, 163, 129]]], dtype=uint8)]"
Image_1474.jpg,121,148,407,298,1152,768,528,446,407,daskShared_local/images/Image_1474.jpg,1474,"[array([[[183, 234, 225],
        [182, 233, 224],
        [182, 233, 224],
        ...,
        [181, 239, 230],
        [177, 237, 229],
        [175, 236, 228]],

       [[185, 233, 225],
        [184, 234, 225],
        [185, 235, 224],
        ...,
        [179, 238, 230],
        [176, 236, 228],
        [174, 235, 227]],

       [[186, 236, 227],
        [186, 236, 227],
        [189, 237, 227],
        ...,
        [176, 236, 229],
        [173, 235, 227],
        [172, 234, 226]],

       ...,

       [[ 50, 158, 179],
        [ 50, 157, 179],
        [ 55, 157, 182],
        ...,
        [113, 121,  97],
        [113, 125, 100],
        [135, 158, 142]],

       [[ 44, 154, 179],
        [ 44, 155, 179],
        [ 48, 154, 180],
        ...,
        [121, 136, 118],
        [124, 141, 120],
        [131, 148, 136]],

       [[ 43, 152, 179],
        [ 42, 152, 179],
        [ 43, 152, 179],
        ...,
        [119, 135, 116],
        [122, 139, 116],
        [140, 154, 143]]], dtype=uint8)]"
Image_1475.jpg,102,259,160,113,900,600,262,372,160,daskShared_local/images/Image_1475.jpg,1475,"[array([[[  3,  80,  90],
        [  1,  77,  87],
        [  0,  78,  85],
        ...,
        [ 33, 108, 121],
        [ 36, 110, 122],
        [ 48, 122, 131]],

       [[  3,  80,  90],
        [  1,  78,  88],
        [  0,  80,  86],
        ...,
        [ 16,  95, 108],
        [ 15,  92, 104],
        [ 24, 101, 111]],

       [[  2,  78,  88],
        [  1,  77,  87],
        [  0,  79,  86],
        ...,
        [  7,  90, 103],
        [  3,  85,  97],
        [  7,  89, 100]],

       ...,

       [[  0,  66,  75],
        [  0,  66,  75],
        [  1,  66,  76],
        ...,
        [ 12,  41,  37],
        [  9,  38,  35],
        [  7,  36,  33]],

       [[  0,  67,  76],
        [  0,  67,  76],
        [  1,  66,  76],
        ...,
        [ 14,  43,  38],
        [ 12,  41,  37],
        [  9,  38,  34]],

       [[  0,  66,  75],
        [  0,  66,  75],
        [  1,  66,  76],
        ...,
        [ 15,  44,  39],
        [ 13,  42,  38],
        [ 11,  40,  36]]], dtype=uint8)]"
Image_1476.png,207,7,371,424,860,460,578,431,424,daskShared_local/images/Image_1476.png,1476,"[array([[[ 56,  61,  55],
        [ 74,  77,  56],
        [ 72,  73,  55],
        ...,
        [ 23, 209, 197],
        [ 13, 208, 201],
        [ 17, 219, 215]],

       [[ 55,  60,  54],
        [ 58,  61,  54],
        [ 60,  62,  51],
        ...,
        [ 15, 194, 193],
        [ 15, 212, 211],
        [ 11, 204, 204]],

       [[ 52,  58,  52],
        [ 63,  68,  61],
        [ 64,  68,  57],
        ...,
        [ 27, 225, 220],
        [  6, 196, 199],
        [ 11, 179, 190]],

       ...,

       [[ 68, 119, 122],
        [ 64, 115, 117],
        [ 65, 115, 114],
        ...,
        [ 44, 163, 180],
        [ 44, 164, 180],
        [ 45, 166, 180]],

       [[ 62, 113, 117],
        [ 68, 119, 123],
        [ 68, 120, 119],
        ...,
        [ 44, 165, 180],
        [ 45, 165, 179],
        [ 46, 167, 179]],

       [[ 63, 113, 117],
        [ 67, 121, 124],
        [ 65, 119, 119],
        ...,
        [ 47, 169, 182],
        [ 48, 170, 182],
        [ 49, 173, 182]]], dtype=uint8)]"
Image_1477.jpg,885,511,219,198,1920,1200,1104,709,219,daskShared_local/images/Image_1477.jpg,1477,"[array([[[  0, 114, 115],
        [  1, 115, 115],
        [  1, 116, 116],
        ...,
        [  2, 122, 121],
        [  3, 123, 122],
        [  6, 126, 125]],

       [[  1, 111, 114],
        [  3, 115, 117],
        [  3, 117, 118],
        ...,
        [  0, 120, 119],
        [  1, 121, 120],
        [  4, 124, 123]],

       [[  4, 112, 115],
        [  4, 113, 116],
        [  4, 113, 116],
        ...,
        [  0, 120, 118],
        [  0, 120, 118],
        [  1, 122, 121]],

       ...,

       [[129, 114,  80],
        [122, 106,  72],
        [115,  99,  66],
        ...,
        [ 57,  40,  20],
        [ 42,  25,   6],
        [ 84,  69,  47]],

       [[123, 109,  74],
        [116, 100,  66],
        [119, 103,  69],
        ...,
        [ 55,  34,  11],
        [ 55,  34,  11],
        [105,  84,  60]],

       [[125, 111,  76],
        [117, 101,  67],
        [119, 103,  68],
        ...,
        [ 59,  35,  11],
        [ 64,  40,  16],
        [ 88,  64,  38]]], dtype=uint8)]"
Image_1478.jpg,612,456,306,228,1600,1200,918,684,306,daskShared_local/images/Image_1478.jpg,1478,"[array([[[  0, 114, 135],
        [  0, 114, 135],
        [  0, 113, 134],
        ...,
        [ 24, 134, 123],
        [ 14, 115, 103],
        [ 10, 101,  88]],

       [[  0, 115, 134],
        [  1, 116, 136],
        [  3, 118, 138],
        ...,
        [ 42, 174, 160],
        [ 29, 154, 139],
        [  8, 120, 105]],

       [[  0, 112, 132],
        [  1, 112, 132],
        [  2, 114, 134],
        ...,
        [ 40, 164, 154],
        [ 52, 172, 162],
        [ 58, 174, 161]],

       ...,

       [[ 91, 106,  78],
        [142, 167, 142],
        [165, 201, 176],
        ...,
        [ 39,  81,  59],
        [ 53,  95,  73],
        [ 36,  78,  56]],

       [[ 66,  85,  59],
        [111, 127,  99],
        [148, 165, 136],
        ...,
        [ 40,  58,  51],
        [ 33,  60,  49],
        [ 60,  97,  81]],

       [[ 52,  49,  31],
        [ 74,  66,  48],
        [ 88,  79,  60],
        ...,
        [ 40,  66,  61],
        [ 32,  64,  56],
        [ 43,  83,  70]]], dtype=uint8)]"
Image_1479.jpg,499,70,163,147,1024,335,662,217,163,daskShared_local/images/Image_1479.jpg,1479,"[array([[[ 48, 218, 237],
        [ 33, 213, 232],
        [ 17, 207, 228],
        ...,
        [  1, 178, 222],
        [  1, 178, 222],
        [  1, 178, 220]],

       [[ 14, 210, 228],
        [ 10, 208, 228],
        [  5, 206, 228],
        ...,
        [  2, 178, 223],
        [  2, 178, 222],
        [  2, 178, 221]],

       [[  1, 206, 229],
        [  1, 204, 229],
        [  1, 204, 229],
        ...,
        [  2, 178, 221],
        [  2, 178, 221],
        [  2, 178, 221]],

       ...,

       [[123, 123,  82],
        [129, 129,  80],
        [130, 135,  80],
        ...,
        [192, 202, 164],
        [190, 202, 164],
        [187, 200, 160]],

       [[134, 134,  80],
        [141, 142,  80],
        [143, 147,  81],
        ...,
        [188, 198, 159],
        [184, 196, 156],
        [178, 191, 150]],

       [[153, 159,  83],
        [157, 165,  82],
        [162, 170,  87],
        ...,
        [193, 197, 152],
        [185, 190, 145],
        [173, 180, 135]]], dtype=uint8)]"
Image_148.jpeg,635,147,262,246,1200,800,897,393,262,daskShared_local/images/Image_148.jpeg,148,"[array([[[159, 211, 225],
        [156, 207, 223],
        [155, 205, 222],
        ...,
        [181, 214, 230],
        [182, 215, 231],
        [177, 210, 227]],

       [[165, 214, 227],
        [162, 210, 224],
        [161, 210, 224],
        ...,
        [181, 214, 231],
        [181, 214, 231],
        [179, 212, 229]],

       [[167, 215, 226],
        [164, 211, 224],
        [165, 211, 225],
        ...,
        [180, 213, 230],
        [179, 212, 229],
        [180, 213, 230]],

       ...,

       [[ 64,  39,   2],
        [ 66,  37,   2],
        [ 98,  64,  20],
        ...,
        [168, 145, 102],
        [161, 135,  96],
        [162, 143, 124]],

       [[112,  90,  27],
        [ 87,  61,   9],
        [ 80,  50,   3],
        ...,
        [169, 145, 106],
        [150, 124,  89],
        [148, 130, 110]],

       [[203, 161, 120],
        [130,  82,  80],
        [ 85,  38,  29],
        ...,
        [169, 127,  44],
        [172, 129,  51],
        [180, 148,  53]]], dtype=uint8)]"
Image_1480.jpg,185,371,216,290,1536,1028,401,661,290,daskShared_local/images/Image_1480.jpg,1480,"[array([[[180, 213, 213],
        [182, 214, 215],
        [181, 214, 213],
        ...,
        [ 81, 123, 110],
        [ 89, 133, 124],
        [ 87, 132, 119]],

       [[184, 212, 216],
        [193, 217, 221],
        [197, 218, 223],
        ...,
        [ 80, 132, 125],
        [ 81, 128, 122],
        [105, 145, 130]],

       [[180, 211, 213],
        [184, 214, 215],
        [188, 216, 214],
        ...,
        [ 85, 132, 120],
        [114, 153, 139],
        [115, 146, 128]],

       ...,

       [[167, 179, 166],
        [166, 186, 166],
        [137, 162, 135],
        ...,
        [ 92, 106,  95],
        [ 89, 103,  90],
        [ 92, 105,  94]],

       [[150, 176, 156],
        [140, 169, 146],
        [134, 163, 136],
        ...,
        [103, 117, 104],
        [ 88, 102,  89],
        [ 87, 101,  88]],

       [[134, 168, 145],
        [155, 178, 157],
        [155, 172, 151],
        ...,
        [ 95, 109,  96],
        [ 81,  95,  81],
        [ 85,  99,  86]]], dtype=uint8)]"
Image_1481.jpg,586,73,232,190,1068,601,818,263,232,daskShared_local/images/Image_1481.jpg,1481,"[array([[[  0,  72, 255],
        [  0,  72, 255],
        [  0,  72, 255],
        ...,
        [  2,  87, 255],
        [  1,  86, 254],
        [  0,  87, 255]],

       [[  0,  72, 255],
        [  0,  72, 255],
        [  0,  72, 255],
        ...,
        [  1,  87, 255],
        [  0,  87, 255],
        [  0,  87, 255]],

       [[  0,  72, 255],
        [  0,  72, 255],
        [  0,  72, 255],
        ...,
        [  1,  88, 255],
        [  0,  87, 255],
        [  0,  87, 255]],

       ...,

       [[189, 161, 116],
        [161, 138,  83],
        [201, 185, 127],
        ...,
        [221, 225, 168],
        [216, 229, 185],
        [213, 228, 189]],

       [[188, 156, 131],
        [155, 127,  84],
        [173, 151, 103],
        ...,
        [221, 225, 171],
        [215, 226, 191],
        [215, 226, 200]],

       [[ 85,  53,  45],
        [ 57,  29,  19],
        [125,  98,  71],
        ...,
        [221, 225, 177],
        [218, 223, 193],
        [219, 224, 202]]], dtype=uint8)]"
Image_1482.jpg,302,298,172,142,966,642,474,440,172,daskShared_local/images/Image_1482.jpg,1482,"[array([[[ 44,  88,  67],
        [ 27,  78,  44],
        [ 33,  86,  56],
        ...,
        [ 90, 151, 136],
        [120, 197, 191],
        [128, 196, 195]],

       [[ 30,  78,  58],
        [ 31,  84,  54],
        [ 28,  82,  54],
        ...,
        [133, 154, 138],
        [204, 222, 214],
        [195, 210, 211]],

       [[ 20,  74,  51],
        [ 32,  83,  57],
        [ 32,  84,  54],
        ...,
        [112, 114, 103],
        [177, 166, 160],
        [194, 177, 178]],

       ...,

       [[ 37, 201, 213],
        [ 38, 201, 212],
        [ 36, 197, 211],
        ...,
        [ 70, 229, 241],
        [ 78, 233, 245],
        [ 73, 230, 242]],

       [[ 34, 198, 208],
        [ 33, 196, 205],
        [ 30, 189, 202],
        ...,
        [ 76, 237, 248],
        [ 84, 241, 253],
        [ 75, 233, 245]],

       [[ 32, 199, 208],
        [ 31, 196, 203],
        [ 29, 190, 202],
        ...,
        [ 77, 239, 250],
        [ 80, 239, 251],
        [ 73, 233, 245]]], dtype=uint8)]"
Image_1483.jpg,249,67,326,352,800,600,575,419,352,daskShared_local/images/Image_1483.jpg,1483,"[array([[[ 68, 143, 108],
        [ 46, 116, 117],
        [ 26, 111, 150],
        ...,
        [  1,  94, 168],
        [  1,  95, 167],
        [  2,  95, 167]],

       [[ 25,  90, 114],
        [  9,  84, 116],
        [ 31, 107, 139],
        ...,
        [  0,  94, 168],
        [  2,  96, 170],
        [  2,  96, 168]],

       [[ 11,  87, 119],
        [  3,  82, 135],
        [ 17, 124, 173],
        ...,
        [  2,  96, 170],
        [  2,  96, 170],
        [  1,  95, 168]],

       ...,

       [[125, 140,  93],
        [133, 140, 107],
        [137, 155, 122],
        ...,
        [  8,  46,   7],
        [ 11,  51,  14],
        [ 10,  47,  10]],

       [[136, 162, 111],
        [144, 157, 121],
        [163, 178, 125],
        ...,
        [  2,  40,   4],
        [ 12,  56,  16],
        [  8,  47,  11]],

       [[143, 175, 123],
        [142, 162, 124],
        [154, 170, 150],
        ...,
        [  9,  47,  10],
        [  3,  42,   4],
        [  3,  47,   8]]], dtype=uint8)]"
Image_1484.jpg,419,140,264,266,1200,822,683,406,266,daskShared_local/images/Image_1484.jpg,1484,"[array([[[  1, 151, 176],
        [  0, 150, 175],
        [  0, 150, 175],
        ...,
        [  0, 157, 186],
        [  0, 157, 186],
        [  0, 157, 186]],

       [[  0, 148, 174],
        [  1, 147, 173],
        [  1, 147, 173],
        ...,
        [  0, 158, 187],
        [  0, 159, 187],
        [  0, 159, 188]],

       [[  1, 146, 173],
        [  1, 146, 173],
        [  1, 145, 172],
        ...,
        [  1, 162, 190],
        [  1, 162, 190],
        [  2, 163, 191]],

       ...,

       [[ 71,  90,  41],
        [ 66,  82,  41],
        [ 83,  99,  64],
        ...,
        [248, 213, 145],
        [249, 209, 137],
        [247, 201, 135]],

       [[ 81,  98,  47],
        [ 69,  85,  43],
        [ 66,  81,  46],
        ...,
        [174, 130,  62],
        [186, 138,  59],
        [237, 191, 113]],

       [[ 84,  99,  47],
        [ 69,  86,  42],
        [ 55,  72,  36],
        ...,
        [121,  80,  18],
        [138,  95,  14],
        [194, 156,  68]]], dtype=uint8)]"
Image_1485.jpg,322,74,98,102,479,313,420,176,102,daskShared_local/images/Image_1485.jpg,1485,"[array([[[  2,  59, 108],
        [  1,  59, 107],
        [  1,  57, 106],
        ...,
        [ 23,  49,  92],
        [ 54,  79, 116],
        [ 56,  80, 118]],

       [[  2,  59, 108],
        [  2,  59, 108],
        [  1,  57, 106],
        ...,
        [ 23,  49,  92],
        [ 56,  80, 118],
        [ 57,  82, 119]],

       [[  5,  61, 108],
        [  5,  61, 108],
        [  4,  58, 105],
        ...,
        [ 27,  49,  86],
        [ 85, 108, 143],
        [ 88, 112, 146]],

       ...,

       [[ 73,  98,  77],
        [ 73,  98,  77],
        [ 75, 100,  79],
        ...,
        [  1,  23,  72],
        [  1,  23,  72],
        [  1,  23,  72]],

       [[ 79, 103,  84],
        [ 79, 103,  84],
        [ 74,  98,  78],
        ...,
        [  1,  23,  72],
        [  1,  23,  72],
        [  1,  23,  72]],

       [[ 80, 104,  84],
        [ 79, 103,  84],
        [ 74,  98,  78],
        ...,
        [  1,  23,  72],
        [  1,  23,  72],
        [  1,  23,  72]]], dtype=uint8)]"
Image_1486.jpg,1624,821,307,266,2100,1400,1931,1087,307,daskShared_local/images/Image_1486.jpg,1486,"[array([[[147, 147, 152],
        [148, 148, 153],
        [142, 141, 146],
        ...,
        [ 24,  28,  34],
        [ 28,  31,  35],
        [ 27,  26,  35]],

       [[155, 159, 163],
        [139, 142, 148],
        [126, 129, 137],
        ...,
        [  5,  18,  22],
        [ 21,  25,  30],
        [ 32,  29,  30]],

       [[128, 135, 141],
        [139, 144, 151],
        [124, 132, 141],
        ...,
        [ 27,  33,  36],
        [ 25,  30,  32],
        [ 38,  35,  32]],

       ...,

       [[ 18,  35,  42],
        [  5,  25,  28],
        [  8,  25,  28],
        ...,
        [  1,   2,  19],
        [  1,   5,  21],
        [  1,   5,  19]],

       [[ 12,  32,  38],
        [ 19,  33,  39],
        [ 27,  36,  41],
        ...,
        [  1,   3,  22],
        [  0,   1,  18],
        [  0,   5,  21]],

       [[ 15,  31,  39],
        [ 19,  33,  40],
        [ 17,  28,  36],
        ...,
        [  0,   5,  23],
        [  2,   0,  20],
        [  0,   2,  18]]], dtype=uint8)]"
Image_1487.jpg,100,326,210,190,735,1102,310,516,210,daskShared_local/images/Image_1487.jpg,1487,"[array([[[  0, 120, 206],
        [  1, 121, 208],
        [  0, 122, 208],
        ...,
        [  0, 147, 224],
        [  0, 144, 221],
        [  0, 146, 223]],

       [[  1, 121, 208],
        [  2, 122, 209],
        [  1, 121, 208],
        ...,
        [  3, 150, 227],
        [  1, 148, 225],
        [  2, 149, 226]],

       [[  1, 123, 209],
        [  1, 122, 211],
        [  1, 123, 209],
        ...,
        [  2, 147, 224],
        [  0, 147, 223],
        [  0, 147, 224]],

       ...,

       [[  0, 122, 208],
        [  0, 120, 207],
        [  0, 121, 210],
        ...,
        [ 23,  67,  89],
        [ 42,  82,  92],
        [ 66, 100, 101]],

       [[  0, 122, 208],
        [  0, 122, 210],
        [  0, 120, 209],
        ...,
        [ 36,  79,  93],
        [ 52,  94,  97],
        [ 62,  96, 102]],

       [[  1, 122, 211],
        [  1, 122, 211],
        [  0, 122, 208],
        ...,
        [ 61, 101, 105],
        [ 52,  88,  89],
        [ 59,  88, 103]]], dtype=uint8)]"
Image_1488.jpg,382,113,155,121,624,468,537,234,155,daskShared_local/images/Image_1488.jpg,1488,"[array([[[  5,  25,  58],
        [ 10,  30,  63],
        [ 10,  41,  68],
        ...,
        [ 18,   4,  28],
        [ 21,   4,  29],
        [ 21,   4,  27]],

       [[  4,  27,  60],
        [  9,  34,  66],
        [  8,  42,  68],
        ...,
        [ 14,   5,  22],
        [ 15,   5,  22],
        [ 12,   4,  21]],

       [[  2,  30,  63],
        [  5,  36,  67],
        [  3,  39,  66],
        ...,
        [ 10,   7,  14],
        [ 10,   7,  15],
        [  9,   8,  17]],

       ...,

       [[208, 187, 135],
        [208, 190, 139],
        [202, 187, 147],
        ...,
        [ 30,  29,  25],
        [ 27,  27,  25],
        [ 23,  25,  24]],

       [[201, 181, 127],
        [203, 186, 135],
        [202, 187, 149],
        ...,
        [ 32,  30,  26],
        [ 29,  29,  25],
        [ 27,  28,  27]],

       [[200, 180, 127],
        [199, 183, 134],
        [199, 185, 149],
        ...,
        [ 31,  29,  25],
        [ 30,  29,  26],
        [ 32,  32,  30]]], dtype=uint8)]"
Image_1489.jpg,444,210,178,201,1200,630,622,411,201,daskShared_local/images/Image_1489.jpg,1489,"[array([[[ 31, 108, 178],
        [ 29, 106, 176],
        [ 31, 105, 176],
        ...,
        [ 14,  45,  47],
        [ 34,  65,  67],
        [ 64,  96,  95]],

       [[ 32, 107, 175],
        [ 30, 104, 175],
        [ 29, 103, 174],
        ...,
        [ 91, 122, 124],
        [122, 153, 155],
        [113, 145, 144]],

       [[ 30, 105, 173],
        [ 28, 103, 171],
        [ 28, 102, 173],
        ...,
        [ 54,  85,  87],
        [ 82, 113, 115],
        [ 44,  76,  75]],

       ...,

       [[ 43, 117, 120],
        [ 36, 107, 111],
        [ 37, 105, 112],
        ...,
        [ 20,  26,  26],
        [ 27,  33,  33],
        [ 38,  44,  44]],

       [[ 14,  83,  88],
        [ 22,  89,  97],
        [ 39, 103, 112],
        ...,
        [ 13,  22,  21],
        [ 26,  35,  34],
        [ 29,  38,  37]],

       [[ 15,  78,  87],
        [ 33,  96, 105],
        [ 59, 119, 130],
        ...,
        [ 19,  30,  26],
        [ 17,  28,  24],
        [ 32,  43,  39]]], dtype=uint8)]"
Image_149.jpg,447,219,175,190,1200,630,622,409,190,daskShared_local/images/Image_149.jpg,149,"[array([[[ 22,  95, 164],
        [ 25,  98, 167],
        [ 26, 101, 169],
        ...,
        [ 33,  68,  64],
        [ 20,  50,  50],
        [ 28,  54,  55]],

       [[ 29, 102, 171],
        [ 28, 101, 170],
        [ 27, 102, 170],
        ...,
        [ 34,  68,  64],
        [ 21,  51,  51],
        [ 23,  47,  49]],

       [[ 31, 104, 173],
        [ 29, 104, 172],
        [ 27, 102, 170],
        ...,
        [ 32,  64,  61],
        [ 28,  57,  55],
        [ 26,  47,  50]],

       ...,

       [[ 44,  92, 115],
        [ 33,  79, 103],
        [ 27,  71,  96],
        ...,
        [ 27,  25,  28],
        [ 29,  29,  31],
        [ 22,  23,  25]],

       [[ 37,  85, 108],
        [ 33,  79, 103],
        [ 34,  78, 103],
        ...,
        [ 24,  22,  25],
        [ 25,  25,  27],
        [ 22,  24,  26]],

       [[ 22,  73,  94],
        [ 31,  77, 101],
        [ 35,  81, 105],
        ...,
        [ 25,  25,  27],
        [ 20,  21,  23],
        [ 14,  18,  19]]], dtype=uint8)]"
Image_1490.jpg,72,110,79,54,350,219,151,164,79,daskShared_local/images/Image_1490.jpg,1490,"[array([[[  2, 126, 181],
        [  2, 125, 181],
        [  2, 126, 181],
        ...,
        [ 18, 144, 193],
        [ 19, 144, 192],
        [ 18, 144, 192]],

       [[  2, 126, 181],
        [  2, 125, 182],
        [  2, 126, 181],
        ...,
        [ 19, 144, 193],
        [ 19, 144, 192],
        [ 19, 144, 193]],

       [[  2, 126, 180],
        [  2, 126, 180],
        [  2, 126, 180],
        ...,
        [ 18, 143, 192],
        [ 18, 143, 192],
        [ 18, 143, 192]],

       ...,

       [[  5, 115, 189],
        [  5, 115, 188],
        [  5, 116, 189],
        ...,
        [ 35,  81,  97],
        [ 35,  81,  99],
        [ 35,  81,  98]],

       [[  3, 122, 187],
        [  3, 122, 187],
        [  3, 122, 187],
        ...,
        [ 31,  77,  96],
        [ 32,  78, 100],
        [ 32,  78,  98]],

       [[  4, 119, 188],
        [  4, 119, 188],
        [  4, 119, 188],
        ...,
        [ 33,  79,  96],
        [ 33,  80,  99],
        [ 33,  80,  98]]], dtype=uint8)]"
Image_1491.jpg,101,98,422,301,800,533,523,399,422,daskShared_local/images/Image_1491.jpg,1491,"[array([[[  1,  11,  58],
        [  1,  12,  58],
        [  3,  12,  59],
        ...,
        [  6,  18,  73],
        [  5,  20,  74],
        [  4,  20,  72]],

       [[  4,  13,  58],
        [  5,  13,  57],
        [  6,  15,  59],
        ...,
        [  9,  18,  72],
        [  6,  19,  72],
        [  5,  20,  73]],

       [[  4,  10,  56],
        [  3,  11,  57],
        [  6,  13,  58],
        ...,
        [ 10,  20,  72],
        [  6,  19,  67],
        [  6,  20,  70]],

       ...,

       [[  8,  17,  60],
        [  9,  14,  59],
        [  8,  15,  59],
        ...,
        [137, 109,  73],
        [140, 114,  76],
        [141, 115,  78]],

       [[  5,  15,  58],
        [  8,  14,  59],
        [ 10,  15,  60],
        ...,
        [139, 116,  89],
        [120,  96,  64],
        [117,  96,  58]],

       [[  6,  15,  58],
        [  8,  14,  58],
        [  6,  14,  58],
        ...,
        [145, 128, 105],
        [129, 109,  78],
        [108,  88,  51]]], dtype=uint8)]"
Image_1492.jpg,124,37,149,144,425,282,273,181,149,daskShared_local/images/Image_1492.jpg,1492,"[array([[[  1,  79, 128],
        [  0,  80, 128],
        [  0,  80, 128],
        ...,
        [  0, 155, 194],
        [  0, 158, 197],
        [  1, 158, 198]],

       [[  0,  79, 127],
        [  1,  79, 128],
        [  1,  80, 128],
        ...,
        [  0, 147, 186],
        [  1, 151, 190],
        [  0, 153, 192]],

       [[  0,  78, 127],
        [  0,  78, 127],
        [  1,  79, 128],
        ...,
        [  0, 137, 178],
        [  0, 141, 181],
        [  0, 144, 184]],

       ...,

       [[  6,   3,   2],
        [  7,   4,   3],
        [ 10,   7,   5],
        ...,
        [128, 137, 118],
        [ 93, 134, 131],
        [ 44, 115, 123]],

       [[  7,   6,   4],
        [  9,   8,   6],
        [ 13,  12,   9],
        ...,
        [124, 131, 114],
        [ 81, 127, 124],
        [ 33, 113, 121]],

       [[  8,   8,   6],
        [ 12,  12,  10],
        [ 18,  18,  15],
        ...,
        [115, 125, 109],
        [ 63, 117, 116],
        [ 19, 107, 115]]], dtype=uint8)]"
Image_1493.jpg,631,149,566,561,1366,917,1197,710,566,daskShared_local/images/Image_1493.jpg,1493,"[array([[[124, 107,  93],
        [133, 121, 107],
        [ 99,  91,  74],
        ...,
        [ 11,  33,  59],
        [ 11,  30,  54],
        [ 11,  28,  50]],

       [[147, 129, 115],
        [136, 122, 103],
        [ 89,  78,  58],
        ...,
        [ 12,  33,  58],
        [ 11,  30,  54],
        [ 11,  28,  50]],

       [[148, 130, 117],
        [110,  95,  72],
        [ 82,  69,  45],
        ...,
        [ 12,  30,  50],
        [ 12,  29,  47],
        [ 12,  28,  45]],

       ...,

       [[  3, 162, 240],
        [  3, 165, 241],
        [  4, 167, 242],
        ...,
        [  9, 153, 239],
        [ 11, 155, 241],
        [ 11, 155, 241]],

       [[  3, 163, 241],
        [  4, 166, 242],
        [  5, 168, 243],
        ...,
        [  9, 154, 239],
        [ 11, 156, 242],
        [ 11, 156, 241]],

       [[  4, 165, 241],
        [  4, 167, 242],
        [  6, 170, 243],
        ...,
        [ 10, 156, 239],
        [ 12, 158, 241],
        [ 11, 157, 241]]], dtype=uint8)]"
Image_1494.jpg,113,127,132,112,800,544,245,239,132,daskShared_local/images/Image_1494.jpg,1494,"[array([[[ 23,  41,  56],
        [ 24,  43,  58],
        [ 25,  48,  62],
        ...,
        [ 38, 122, 163],
        [ 41, 124, 164],
        [ 42, 124, 165]],

       [[ 23,  42,  58],
        [ 25,  45,  61],
        [ 28,  52,  67],
        ...,
        [ 41, 125, 167],
        [ 45, 128, 170],
        [ 46, 128, 170]],

       [[ 24,  44,  61],
        [ 28,  49,  66],
        [ 35,  60,  76],
        ...,
        [ 46, 127, 172],
        [ 51, 132, 176],
        [ 52, 133, 177]],

       ...,

       [[  1,  10,   6],
        [  1,  11,   8],
        [  3,  13,  12],
        ...,
        [ 56,  95,  99],
        [ 57,  96, 101],
        [ 56,  95, 100]],

       [[  3,  13,  11],
        [  2,  12,  12],
        [  3,  11,  14],
        ...,
        [ 47,  86,  90],
        [ 47,  86,  90],
        [ 46,  84,  88]],

       [[  5,  16,  16],
        [  4,  14,  16],
        [  4,  12,  16],
        ...,
        [ 42,  80,  83],
        [ 41,  79,  82],
        [ 40,  78,  82]]], dtype=uint8)]"
Image_1495.jpg,365,169,482,419,1280,854,847,588,482,daskShared_local/images/Image_1495.jpg,1495,"[array([[[118, 151, 176],
        [115, 145, 172],
        [115, 144, 172],
        ...,
        [ 17, 209, 245],
        [ 17, 209, 245],
        [ 18, 210, 246]],

       [[117, 151, 176],
        [116, 149, 177],
        [117, 150, 178],
        ...,
        [ 17, 209, 245],
        [ 18, 210, 246],
        [ 18, 210, 246]],

       [[115, 149, 176],
        [116, 149, 177],
        [118, 150, 179],
        ...,
        [ 18, 209, 241],
        [ 20, 211, 245],
        [ 19, 211, 246]],

       ...,

       [[ 88, 186, 214],
        [ 77, 184, 213],
        [ 54, 172, 201],
        ...,
        [ 14, 195, 240],
        [ 10, 191, 236],
        [  8, 189, 234]],

       [[ 81, 182, 212],
        [ 68, 177, 203],
        [ 58, 176, 202],
        ...,
        [ 16, 197, 242],
        [ 14, 195, 240],
        [ 10, 191, 236]],

       [[ 68, 180, 210],
        [ 66, 182, 209],
        [ 56, 178, 206],
        ...,
        [ 14, 195, 240],
        [ 12, 193, 238],
        [  9, 190, 235]]], dtype=uint8)]"
Image_1496.jpg,581,44,170,166,930,500,751,210,170,daskShared_local/images/Image_1496.jpg,1496,"[array([[[ 10, 148, 211],
        [ 11, 149, 212],
        [ 12, 150, 213],
        ...,
        [ 12, 150, 212],
        [ 11, 149, 211],
        [ 10, 148, 210]],

       [[ 12, 150, 213],
        [ 12, 150, 213],
        [ 13, 151, 214],
        ...,
        [ 10, 148, 210],
        [  9, 147, 209],
        [  8, 146, 208]],

       [[ 10, 148, 211],
        [ 10, 148, 211],
        [ 12, 150, 213],
        ...,
        [  9, 147, 209],
        [  8, 146, 208],
        [  9, 147, 209]],

       ...,

       [[232, 232, 232],
        [224, 224, 224],
        [234, 234, 234],
        ...,
        [  6, 135, 200],
        [  6, 135, 200],
        [  6, 135, 200]],

       [[229, 229, 229],
        [221, 221, 221],
        [230, 230, 230],
        ...,
        [  6, 135, 200],
        [  5, 134, 199],
        [  5, 134, 199]],

       [[230, 230, 230],
        [222, 222, 222],
        [230, 230, 230],
        ...,
        [  6, 135, 200],
        [  5, 134, 199],
        [  5, 134, 199]]], dtype=uint8)]"
Image_1497.jpg,392,24,1085,996,1920,1080,1477,1020,1085,daskShared_local/images/Image_1497.jpg,1497,"[array([[[  0, 124, 156],
        [  0, 123, 155],
        [  0, 124, 156],
        ...,
        [ 33,  80,  84],
        [ 44,  79,  75],
        [ 43,  83,  80]],

       [[  0, 125, 157],
        [  0, 125, 157],
        [  0, 124, 155],
        ...,
        [ 46, 103,  99],
        [ 49,  97,  81],
        [ 52, 103,  92]],

       [[  0, 126, 158],
        [  0, 125, 157],
        [  0, 124, 155],
        ...,
        [ 44, 108,  97],
        [ 54, 114,  91],
        [ 45, 116, 102]],

       ...,

       [[ 96,  86,  49],
        [105,  94,  55],
        [106,  96,  55],
        ...,
        [ 12,  26,  27],
        [ 12,  26,  27],
        [ 13,  26,  27]],

       [[107,  98,  60],
        [102,  93,  55],
        [ 95,  86,  48],
        ...,
        [ 13,  24,  26],
        [ 13,  24,  25],
        [ 13,  24,  26]],

       [[ 97,  87,  49],
        [ 95,  86,  48],
        [ 90,  82,  45],
        ...,
        [ 13,  22,  22],
        [ 14,  23,  23],
        [ 15,  24,  24]]], dtype=uint8)]"
Image_1498.jpg,166,171,179,153,728,500,345,324,179,daskShared_local/images/Image_1498.jpg,1498,"[array([[[  1,  71, 219],
        [  1,  71, 219],
        [  1,  71, 219],
        ...,
        [  2,  81, 225],
        [  1,  82, 225],
        [  1,  80, 225]],

       [[  3,  70, 219],
        [  1,  68, 217],
        [  0,  69, 217],
        ...,
        [  1,  80, 224],
        [  2,  81, 225],
        [  2,  81, 226]],

       [[  1,  68, 219],
        [  1,  67, 219],
        [  1,  68, 219],
        ...,
        [  1,  80, 225],
        [  2,  81, 226],
        [  3,  79, 228]],

       ...,

       [[ 22, 141, 149],
        [ 37, 152, 160],
        [ 43, 151, 153],
        ...,
        [236, 212, 179],
        [239, 220, 201],
        [242, 241, 226]],

       [[ 30, 146, 153],
        [ 32, 145, 156],
        [ 34, 142, 157],
        ...,
        [240, 203, 140],
        [236, 200, 150],
        [236, 210, 193]],

       [[ 24, 146, 155],
        [ 36, 152, 166],
        [ 41, 148, 163],
        ...,
        [243, 216, 139],
        [246, 219, 138],
        [244, 217, 141]]], dtype=uint8)]"
Image_1499.jpg,522,228,180,202,990,681,702,430,202,daskShared_local/images/Image_1499.jpg,1499,"[array([[[ 21,  22,   4],
        [ 21,  22,   4],
        [ 21,  22,   4],
        ...,
        [  3,   2,   0],
        [  6,   3,   0],
        [ 11,   6,   2]],

       [[ 22,  23,   5],
        [ 24,  22,   7],
        [ 23,  21,   6],
        ...,
        [  3,   2,   0],
        [  6,   2,   0],
        [ 14,   6,   4]],

       [[ 26,  25,   7],
        [ 25,  23,   8],
        [ 25,  23,   8],
        ...,
        [  5,   4,   0],
        [  8,   3,   0],
        [ 14,   6,   4]],

       ...,

       [[164, 159, 117],
        [157, 157, 119],
        [163, 163, 125],
        ...,
        [ 25,  33,  18],
        [ 31,  37,  23],
        [ 33,  40,  24]],

       [[164, 162, 121],
        [159, 159, 121],
        [159, 159, 121],
        ...,
        [ 36,  44,  29],
        [ 37,  44,  28],
        [ 32,  39,  23]],

       [[135, 135,  97],
        [143, 141, 102],
        [134, 132,  93],
        ...,
        [ 44,  52,  37],
        [ 37,  46,  29],
        [ 35,  42,  26]]], dtype=uint8)]"
Image_15.jpg,216,188,165,169,500,559,381,357,169,daskShared_local/images/Image_15.jpg,15,"[array([[[ 73, 166, 172],
        [ 76, 168, 173],
        [ 80, 175, 176],
        ...,
        [112, 207, 196],
        [116, 207, 198],
        [120, 210, 200]],

       [[ 69, 165, 166],
        [ 72, 168, 167],
        [ 82, 173, 172],
        ...,
        [111, 206, 195],
        [115, 208, 198],
        [120, 210, 201]],

       [[ 90, 167, 164],
        [ 93, 169, 165],
        [ 99, 171, 166],
        ...,
        [105, 202, 190],
        [109, 204, 194],
        [113, 207, 197]],

       ...,

       [[ 54,  50,  20],
        [ 63,  57,  32],
        [ 39,  32,  21],
        ...,
        [  1, 185, 200],
        [  3, 185, 198],
        [  4, 185, 195]],

       [[ 41,  35,  14],
        [ 50,  41,  26],
        [ 35,  26,  15],
        ...,
        [  1, 182, 198],
        [  0, 184, 197],
        [  0, 186, 196]],

       [[ 16,   8,   2],
        [ 21,  12,   6],
        [ 20,   7,   4],
        ...,
        [  2, 183, 194],
        [  0, 185, 192],
        [  0, 187, 191]]], dtype=uint8)]"
Image_150.jpg,414,143,238,224,1024,686,652,367,238,daskShared_local/images/Image_150.jpg,150,"[array([[[ 33, 189, 240],
        [ 35, 191, 242],
        [ 35, 191, 242],
        ...,
        [  0, 156, 217],
        [  0, 156, 217],
        [  1, 157, 218]],

       [[ 34, 190, 241],
        [ 35, 191, 242],
        [ 34, 190, 241],
        ...,
        [  0, 156, 217],
        [  0, 156, 217],
        [  1, 157, 218]],

       [[ 34, 190, 241],
        [ 33, 190, 241],
        [ 32, 188, 239],
        ...,
        [  0, 156, 217],
        [  0, 156, 217],
        [  1, 157, 218]],

       ...,

       [[210, 193, 178],
        [211, 192, 179],
        [204, 182, 175],
        ...,
        [  2, 115, 181],
        [  3, 116, 182],
        [  3, 116, 182]],

       [[215, 202, 188],
        [226, 211, 199],
        [218, 200, 195],
        ...,
        [  2, 115, 181],
        [  3, 116, 182],
        [  5, 118, 184]],

       [[228, 218, 208],
        [242, 232, 225],
        [243, 230, 227],
        ...,
        [  3, 116, 182],
        [  4, 117, 183],
        [  4, 117, 183]]], dtype=uint8)]"
Image_1500.jpg,106,81,88,88,500,461,194,169,88,daskShared_local/images/Image_1500.jpg,1500,"[array([[[ 40, 151, 138],
        [ 41, 153, 139],
        [ 40, 148, 135],
        ...,
        [ 32, 102,  99],
        [ 30,  99,  97],
        [ 31, 100,  97]],

       [[ 39, 151, 137],
        [ 39, 152, 138],
        [ 39, 147, 135],
        ...,
        [ 33, 103,  99],
        [ 31, 100,  98],
        [ 32, 101,  98]],

       [[ 44, 154, 141],
        [ 45, 155, 142],
        [ 43, 150, 138],
        ...,
        [ 30,  99,  97],
        [ 28,  97,  95],
        [ 28,  97,  95]],

       ...,

       [[ 32,  90,  94],
        [ 32,  90,  94],
        [ 32,  90,  94],
        ...,
        [129,  48,  49],
        [131,  49,  50],
        [131,  49,  49]],

       [[ 31,  89,  93],
        [ 31,  89,  93],
        [ 31,  89,  93],
        ...,
        [132,  47,  47],
        [128,  45,  44],
        [129,  46,  45]],

       [[ 31,  89,  93],
        [ 31,  89,  93],
        [ 31,  89,  93],
        ...,
        [131,  47,  48],
        [129,  46,  45],
        [129,  46,  46]]], dtype=uint8)]"
Image_1501.jpg,323,137,280,204,845,563,603,341,280,daskShared_local/images/Image_1501.jpg,1501,"[array([[[ 62, 180, 184],
        [ 61, 181, 184],
        [ 59, 182, 185],
        ...,
        [ 89, 195, 193],
        [ 93, 200, 198],
        [ 91, 199, 198]],

       [[ 67, 181, 186],
        [ 70, 183, 189],
        [ 70, 185, 190],
        ...,
        [ 89, 195, 193],
        [ 88, 197, 195],
        [ 85, 196, 195]],

       [[ 74, 187, 193],
        [ 80, 189, 195],
        [ 81, 190, 195],
        ...,
        [ 91, 197, 195],
        [ 86, 197, 194],
        [ 82, 197, 194]],

       ...,

       [[ 62, 105,  21],
        [ 64, 101,  20],
        [ 61,  94,  15],
        ...,
        [ 26, 190, 181],
        [ 37, 198, 187],
        [ 45, 201, 192]],

       [[ 73, 119,  39],
        [ 76, 117,  38],
        [ 71, 106,  30],
        ...,
        [ 20, 183, 177],
        [ 27, 189, 182],
        [ 37, 194, 188]],

       [[ 78, 121,  55],
        [ 74, 119,  52],
        [ 66, 113,  46],
        ...,
        [ 26, 186, 181],
        [ 30, 188, 184],
        [ 36, 192, 188]]], dtype=uint8)]"
Image_1502.jpg,313,157,172,172,1200,735,485,329,172,daskShared_local/images/Image_1502.jpg,1502,"[array([[[104, 180, 194],
        [105, 181, 195],
        [106, 182, 196],
        ...,
        [  7,  36,  55],
        [ 10,  31,  55],
        [ 11,  28,  56]],

       [[108, 184, 198],
        [106, 182, 196],
        [106, 182, 196],
        ...,
        [  3,  34,  47],
        [  8,  29,  48],
        [ 11,  28,  52]],

       [[111, 187, 201],
        [108, 184, 198],
        [106, 182, 196],
        ...,
        [  2,  33,  41],
        [  6,  28,  43],
        [ 12,  27,  47]],

       ...,

       [[167, 202, 230],
        [160, 195, 220],
        [151, 185, 206],
        ...,
        [ 89,  47,  14],
        [ 74,  32,   9],
        [ 59,  18,   1]],

       [[172, 207, 234],
        [168, 202, 227],
        [160, 195, 216],
        ...,
        [ 73,  38,  11],
        [ 58,  24,   8],
        [ 49,  18,   7]],

       [[174, 210, 232],
        [176, 212, 232],
        [174, 210, 226],
        ...,
        [ 84,  54,  27],
        [108,  79,  38],
        [114,  85,  33]]], dtype=uint8)]"
Image_1503.jpg,643,289,108,87,900,678,751,376,108,daskShared_local/images/Image_1503.jpg,1503,"[array([[[  1, 138, 193],
        [  1, 138, 193],
        [  1, 139, 194],
        ...,
        [  6, 147, 200],
        [  4, 145, 198],
        [  4, 144, 197]],

       [[  1, 138, 193],
        [  1, 138, 193],
        [  1, 139, 194],
        ...,
        [  7, 147, 200],
        [  4, 145, 198],
        [  4, 144, 197]],

       [[  3, 142, 197],
        [  3, 142, 197],
        [  2, 141, 196],
        ...,
        [ 11, 151, 204],
        [  5, 145, 198],
        [  4, 144, 197]],

       ...,

       [[106, 196, 241],
        [106, 196, 241],
        [107, 196, 241],
        ...,
        [ 62, 180, 220],
        [ 64, 181, 220],
        [ 64, 181, 220]],

       [[102, 194, 238],
        [102, 194, 238],
        [103, 193, 239],
        ...,
        [ 62, 180, 221],
        [ 62, 180, 220],
        [ 63, 180, 220]],

       [[102, 194, 238],
        [102, 194, 238],
        [102, 193, 238],
        ...,
        [ 61, 180, 221],
        [ 62, 180, 220],
        [ 62, 180, 220]]], dtype=uint8)]"
Image_1504.jpg,350,96,158,198,728,486,508,294,198,daskShared_local/images/Image_1504.jpg,1504,"[array([[[  1,  64, 255],
        [  2,  62, 255],
        [  1,  64, 253],
        ...,
        [  2, 108, 254],
        [  2, 108, 252],
        [  1, 107, 255]],

       [[  0,  63, 254],
        [  2,  65, 255],
        [  2,  65, 254],
        ...,
        [  1, 107, 255],
        [  0, 108, 253],
        [  2, 108, 254]],

       [[  0,  63, 255],
        [  0,  65, 255],
        [  1,  64, 255],
        ...,
        [  1, 105, 254],
        [  1, 107, 255],
        [  0, 106, 254]],

       ...,

       [[206, 161, 122],
        [200, 159, 129],
        [199, 158, 128],
        ...,
        [ 70,  77,  33],
        [ 82,  88,  44],
        [111, 140, 110]],

       [[202, 158, 129],
        [187, 151, 127],
        [194, 152, 114],
        ...,
        [ 74,  79,  49],
        [ 81,  84,  57],
        [ 72,  79,  38]],

       [[203, 157, 124],
        [200, 154, 120],
        [201, 149, 112],
        ...,
        [ 84,  87,  78],
        [ 73,  83,  74],
        [ 74,  78,  63]]], dtype=uint8)]"
Image_1505.png,227,52,187,191,449,252,414,243,191,daskShared_local/images/Image_1505.png,1505,"[array([[[  4, 100,  97],
        [  7,  97,  85],
        [  7,  97,  84],
        ...,
        [  0, 122, 172],
        [  0, 122, 172],
        [  0, 122, 172]],

       [[  4, 100,  97],
        [ 12, 107,  89],
        [ 13, 107,  89],
        ...,
        [  0, 118, 175],
        [  0, 118, 175],
        [  0, 118, 175]],

       [[  4, 100,  97],
        [ 19,  99,  99],
        [ 44, 112,  96],
        ...,
        [  0, 118, 175],
        [  0, 118, 175],
        [  0, 118, 175]],

       ...,

       [[  0,   0,   1],
        [  0,   0,   1],
        [  0,   0,   1],
        ...,
        [ 18,  35,  23],
        [ 22,  51,  13],
        [ 19,  62,  28]],

       [[  0,   0,   1],
        [  0,   0,   1],
        [  0,   0,   1],
        ...,
        [  5,  32,  11],
        [  5,  33,  12],
        [  3,  48,  31]],

       [[  0,   0,   1],
        [  0,   0,   1],
        [  0,   0,   1],
        ...,
        [  5,  32,  11],
        [  5,  32,  12],
        [  3,  31,  29]]], dtype=uint8)]"
Image_1506.jpg,660,241,360,313,2121,1063,1020,554,360,daskShared_local/images/Image_1506.jpg,1506,"[array([[[ 98, 152, 168],
        [ 96, 150, 164],
        [ 89, 141, 154],
        ...,
        [128, 148, 153],
        [125, 145, 149],
        [124, 143, 147]],

       [[ 99, 155, 170],
        [ 96, 154, 166],
        [101, 158, 170],
        ...,
        [121, 140, 141],
        [119, 135, 136],
        [118, 132, 133]],

       [[ 97, 154, 166],
        [102, 160, 172],
        [ 93, 153, 164],
        ...,
        [121, 137, 136],
        [113, 128, 125],
        [117, 129, 127]],

       ...,

       [[ 57, 108, 127],
        [ 54, 105, 124],
        [ 55, 106, 125],
        ...,
        [139, 141, 136],
        [158, 160, 154],
        [162, 163, 154]],

       [[ 54, 105, 124],
        [ 53, 104, 123],
        [ 53, 104, 123],
        ...,
        [136, 141, 137],
        [143, 148, 143],
        [153, 157, 150]],

       [[ 56, 107, 126],
        [ 55, 106, 125],
        [ 55, 106, 125],
        ...,
        [159, 160, 154],
        [152, 153, 145],
        [138, 138, 129]]], dtype=uint8)]"
Image_1507.jpg,491,297,142,136,1024,670,633,433,142,daskShared_local/images/Image_1507.jpg,1507,"[array([[[ 60, 106,  69],
        [ 82, 130,  93],
        [ 97, 147, 112],
        ...,
        [  1, 102,  88],
        [  1, 102,  88],
        [  1, 102,  88]],

       [[100, 142, 103],
        [101, 144, 105],
        [107, 153, 116],
        ...,
        [  0, 101,  87],
        [  0, 101,  87],
        [  0, 101,  87]],

       [[149, 184, 142],
        [134, 170, 128],
        [132, 172, 131],
        ...,
        [  0, 101,  87],
        [  0, 101,  87],
        [  0, 101,  87]],

       ...,

       [[  0, 136, 108],
        [  0, 136, 109],
        [  0, 136, 112],
        ...,
        [  0, 141, 115],
        [  0, 142, 115],
        [  0, 142, 115]],

       [[  2, 138, 110],
        [  2, 138, 112],
        [  2, 138, 114],
        ...,
        [  0, 143, 116],
        [  0, 143, 116],
        [  0, 143, 116]],

       [[  3, 140, 111],
        [  3, 140, 112],
        [  3, 140, 113],
        ...,
        [  1, 143, 116],
        [  1, 144, 116],
        [  1, 144, 116]]], dtype=uint8)]"
Image_1508.jpg,487,120,143,117,800,600,630,237,143,daskShared_local/images/Image_1508.jpg,1508,"[array([[[ 26, 166, 189],
        [ 29, 169, 192],
        [ 29, 170, 193],
        ...,
        [ 48, 160, 171],
        [ 53, 165, 176],
        [ 56, 168, 179]],

       [[ 29, 170, 192],
        [ 30, 171, 194],
        [ 29, 171, 193],
        ...,
        [ 50, 163, 174],
        [ 54, 167, 178],
        [ 57, 170, 181]],

       [[ 30, 172, 193],
        [ 28, 170, 192],
        [ 25, 167, 189],
        ...,
        [ 55, 169, 181],
        [ 57, 171, 183],
        [ 57, 171, 183]],

       ...,

       [[154, 148, 123],
        [148, 142, 117],
        [121, 115,  91],
        ...,
        [  0, 140, 160],
        [  0, 140, 160],
        [  0, 140, 160]],

       [[129, 123,  98],
        [124, 118,  93],
        [110, 104,  78],
        ...,
        [  0, 140, 160],
        [  0, 140, 160],
        [  0, 140, 160]],

       [[100,  94,  68],
        [ 89,  83,  57],
        [ 78,  72,  46],
        ...,
        [  0, 140, 160],
        [  0, 140, 160],
        [  0, 140, 160]]], dtype=uint8)]"
Image_1509.jpg,117,372,269,204,1200,800,386,576,269,daskShared_local/images/Image_1509.jpg,1509,"[array([[[  4,  99, 103],
        [  3,  98, 102],
        [  0,  93,  98],
        ...,
        [ 21,  48,  59],
        [ 40,  68,  73],
        [ 26,  63,  61]],

       [[  1,  97, 100],
        [  0,  97, 100],
        [  1,  96, 100],
        ...,
        [ 25,  61,  67],
        [ 46,  73,  77],
        [ 36,  62,  61]],

       [[  0,  96,  99],
        [  0,  98, 101],
        [  2, 100, 103],
        ...,
        [ 45,  99, 100],
        [ 56,  91,  94],
        [ 43,  66,  68]],

       ...,

       [[188, 239, 158],
        [187, 231, 157],
        [190, 227, 158],
        ...,
        [  4,  91,  83],
        [  1,  91,  83],
        [  3,  99,  90]],

       [[178, 227, 144],
        [189, 229, 155],
        [193, 222, 159],
        ...,
        [  2,  93,  84],
        [  1,  94,  85],
        [  2, 102,  91]],

       [[184, 217, 139],
        [186, 221, 143],
        [173, 206, 131],
        ...,
        [  0,  91,  82],
        [  1,  96,  87],
        [  0, 105,  97]]], dtype=uint8)]"
Image_151.jpg,209,191,174,171,500,559,383,362,174,daskShared_local/images/Image_151.jpg,151,"[array([[[108, 174, 172],
        [106, 171, 170],
        [105, 171, 168],
        ...,
        [101, 199, 187],
        [104, 201, 190],
        [109, 205, 194]],

       [[179, 205, 205],
        [174, 200, 199],
        [171, 196, 196],
        ...,
        [ 95, 193, 180],
        [ 96, 195, 184],
        [102, 199, 188]],

       [[210, 205, 198],
        [209, 204, 196],
        [208, 202, 193],
        ...,
        [110, 205, 192],
        [112, 206, 195],
        [115, 207, 197]],

       ...,

       [[ 34,  42,   3],
        [ 40,  52,   6],
        [ 43,  59,   7],
        ...,
        [  0, 187, 194],
        [  0, 187, 194],
        [  0, 187, 194]],

       [[ 31,  40,   1],
        [ 40,  53,   4],
        [ 49,  66,   8],
        ...,
        [  0, 187, 194],
        [  0, 187, 194],
        [  0, 187, 194]],

       [[ 26,  35,   0],
        [ 36,  49,   0],
        [ 45,  63,   1],
        ...,
        [  0, 187, 194],
        [  0, 187, 194],
        [  0, 187, 194]]], dtype=uint8)]"
Image_1510.jpg,2143,261,716,519,3033,1757,2859,780,716,daskShared_local/images/Image_1510.jpg,1510,"[array([[[  0,  53, 217],
        [  0,  53, 217],
        [  0,  53, 217],
        ...,
        [  0,  53, 217],
        [  0,  53, 217],
        [  0,  53, 217]],

       [[  0,  53, 217],
        [  0,  53, 217],
        [  0,  53, 217],
        ...,
        [  0,  53, 217],
        [  0,  53, 217],
        [  0,  53, 217]],

       [[  0,  53, 217],
        [  0,  53, 217],
        [  0,  53, 217],
        ...,
        [  0,  53, 217],
        [  0,  53, 217],
        [  0,  53, 217]],

       ...,

       [[ 70,  74,  47],
        [ 74,  78,  52],
        [ 69,  73,  48],
        ...,
        [  0,  53, 217],
        [  0,  53, 217],
        [  0,  53, 217]],

       [[ 66,  70,  44],
        [ 68,  72,  47],
        [ 63,  67,  44],
        ...,
        [  0,  53, 217],
        [  0,  53, 217],
        [  0,  53, 217]],

       [[ 64,  68,  43],
        [ 65,  69,  45],
        [ 60,  64,  42],
        ...,
        [  0,  53, 217],
        [  0,  53, 217],
        [  0,  53, 217]]], dtype=uint8)]"
Image_1511.jpg,201,188,133,96,1280,960,334,284,133,daskShared_local/images/Image_1511.jpg,1511,"[array([[[122, 196, 255],
        [122, 196, 254],
        [122, 196, 254],
        ...,
        [140, 207, 253],
        [143, 210, 254],
        [145, 211, 255]],

       [[128, 202, 254],
        [128, 202, 254],
        [128, 202, 254],
        ...,
        [139, 204, 254],
        [141, 206, 254],
        [143, 208, 255]],

       [[135, 208, 254],
        [135, 209, 254],
        [136, 210, 253],
        ...,
        [135, 198, 253],
        [136, 199, 254],
        [137, 199, 254]],

       ...,

       [[ 46, 144, 255],
        [ 46, 144, 255],
        [ 47, 145, 255],
        ...,
        [  0,   0,   0],
        [  0,   0,   0],
        [  0,   0,   0]],

       [[ 47, 145, 255],
        [ 47, 145, 255],
        [ 48, 146, 255],
        ...,
        [  0,   0,   0],
        [  0,   0,   0],
        [  0,   0,   0]],

       [[ 47, 145, 255],
        [ 47, 145, 255],
        [ 48, 146, 255],
        ...,
        [  0,   0,   0],
        [  0,   0,   0],
        [  0,   0,   0]]], dtype=uint8)]"
Image_1512.jpg,417,1,402,504,1280,720,819,505,504,daskShared_local/images/Image_1512.jpg,1512,"[array([[[163, 229, 238],
        [160, 228, 239],
        [157, 227, 237],
        ...,
        [ 54, 180, 208],
        [ 53, 181, 210],
        [ 42, 179, 204]],

       [[161, 227, 236],
        [158, 226, 237],
        [157, 227, 237],
        ...,
        [ 36, 177, 206],
        [ 26, 175, 201],
        [ 41, 178, 203]],

       [[160, 226, 236],
        [159, 226, 238],
        [158, 228, 239],
        ...,
        [ 47, 177, 205],
        [ 53, 179, 206],
        [ 55, 181, 207]],

       ...,

       [[ 78,  68,  51],
        [ 47,  42,  31],
        [ 45,  41,  36],
        ...,
        [  3,  75,  99],
        [  3,  75,  99],
        [  3,  75,  99]],

       [[ 57,  47,  31],
        [ 44,  39,  30],
        [ 56,  50,  44],
        ...,
        [  2,  74,  98],
        [  3,  75,  99],
        [  3,  75,  99]],

       [[ 96,  81,  55],
        [ 71,  64,  45],
        [ 68,  58,  47],
        ...,
        [  3,  74,  98],
        [  3,  74,  98],
        [  2,  74,  98]]], dtype=uint8)]"
Image_1513.jpg,319,290,153,104,1280,720,472,394,153,daskShared_local/images/Image_1513.jpg,1513,"[array([[[  1,  60, 136],
        [  1,  61, 135],
        [  1,  61, 134],
        ...,
        [  0,  62, 139],
        [  0,  62, 139],
        [  0,  62, 139]],

       [[  0,  60, 135],
        [  1,  60, 134],
        [  1,  61, 134],
        ...,
        [  0,  62, 139],
        [  0,  62, 139],
        [  0,  62, 139]],

       [[  0,  59, 135],
        [  0,  60, 134],
        [  1,  61, 134],
        ...,
        [  0,  62, 139],
        [  0,  62, 139],
        [  0,  62, 139]],

       ...,

       [[ 40, 116, 138],
        [ 41, 116, 139],
        [ 41, 116, 139],
        ...,
        [ 43,  75,  89],
        [ 47,  72,  80],
        [ 52,  74,  78]],

       [[ 43, 118, 139],
        [ 42, 117, 139],
        [ 42, 117, 139],
        ...,
        [ 38,  70,  83],
        [ 40,  64,  72],
        [ 45,  66,  70]],

       [[ 44, 119, 140],
        [ 43, 118, 139],
        [ 42, 117, 138],
        ...,
        [ 31,  63,  75],
        [ 30,  54,  62],
        [ 36,  57,  61]]], dtype=uint8)]"
Image_1514.jpg,326,277,101,69,800,600,427,346,101,daskShared_local/images/Image_1514.jpg,1514,"[array([[[  0, 158, 255],
        [  0, 158, 255],
        [  1, 159, 255],
        ...,
        [  0, 163, 255],
        [  0, 163, 255],
        [  0, 163, 255]],

       [[  0, 158, 255],
        [  0, 158, 255],
        [  1, 159, 255],
        ...,
        [  0, 163, 255],
        [  0, 163, 255],
        [  0, 163, 255]],

       [[  0, 158, 255],
        [  0, 158, 255],
        [  0, 158, 255],
        ...,
        [  0, 163, 255],
        [  0, 163, 255],
        [  0, 163, 255]],

       ...,

       [[ 44, 105,  93],
        [ 44, 105,  93],
        [ 42, 103, 102],
        ...,
        [ 39,  50,  43],
        [ 40,  51,  42],
        [ 40,  51,  42]],

       [[ 28,  88,  73],
        [ 28,  88,  74],
        [ 29,  91,  89],
        ...,
        [ 47,  58,  50],
        [ 47,  58,  48],
        [ 47,  58,  48]],

       [[ 27,  87,  72],
        [ 27,  87,  73],
        [ 29,  91,  88],
        ...,
        [ 47,  58,  50],
        [ 47,  58,  48],
        [ 47,  58,  48]]], dtype=uint8)]"
Image_1515.jpg,193,335,276,208,1024,768,469,543,276,daskShared_local/images/Image_1515.jpg,1515,"[array([[[ 65, 115, 152],
        [ 84, 138, 171],
        [102, 159, 186],
        ...,
        [ 42,  55,  71],
        [ 35,  45,  62],
        [ 29,  36,  55]],

       [[ 84, 133, 172],
        [ 93, 145, 179],
        [100, 156, 183],
        ...,
        [ 17,  27,  43],
        [ 32,  41,  58],
        [ 24,  30,  49]],

       [[ 96, 148, 163],
        [ 94, 147, 164],
        [101, 153, 174],
        ...,
        [ 31,  38,  57],
        [ 36,  41,  61],
        [ 23,  28,  49]],

       ...,

       [[ 21,  24,  46],
        [ 31,  36,  44],
        [ 36,  44,  62],
        ...,
        [ 15,   3,   3],
        [ 15,   3,   3],
        [ 13,   1,   1]],

       [[ 10,  12,  32],
        [ 19,  25,  30],
        [ 17,  26,  42],
        ...,
        [ 16,   2,   2],
        [ 16,   3,   3],
        [ 14,   2,   2]],

       [[  4,  10,  11],
        [  8,  18,  34],
        [ 20,  41,  80],
        ...,
        [ 15,   1,   1],
        [ 16,   2,   2],
        [ 17,   3,   3]]], dtype=uint8)]"
Image_1516.jpg,675,285,290,323,1600,900,965,608,323,daskShared_local/images/Image_1516.jpg,1516,"[array([[[  0, 116, 201],
        [  0, 116, 201],
        [  0, 116, 201],
        ...,
        [  0, 120, 203],
        [  0, 120, 203],
        [  0, 120, 203]],

       [[  0, 116, 201],
        [  0, 116, 201],
        [  0, 116, 201],
        ...,
        [  0, 120, 203],
        [  0, 120, 203],
        [  0, 120, 203]],

       [[  0, 116, 199],
        [  0, 116, 199],
        [  0, 116, 199],
        ...,
        [  0, 119, 203],
        [  0, 119, 203],
        [  0, 119, 203]],

       ...,

       [[147, 138,  96],
        [150, 141, 101],
        [153, 144, 106],
        ...,
        [ 79,  90,  66],
        [ 84,  87,  64],
        [108, 107,  85]],

       [[170, 160, 124],
        [182, 174, 137],
        [183, 175, 140],
        ...,
        [ 81,  92,  75],
        [ 55,  56,  35],
        [113, 107,  83]],

       [[187, 177, 144],
        [207, 199, 165],
        [213, 205, 171],
        ...,
        [ 60,  73,  60],
        [ 74,  73,  55],
        [148, 140, 116]]], dtype=uint8)]"
Image_1517.jpg,786,539,1211,1456,3072,2304,1997,1995,1456,daskShared_local/images/Image_1517.jpg,1517,"[array([[[ 88,  84,  70],
        [ 78,  70,  59],
        [ 73,  64,  56],
        ...,
        [ 84,  60,  62],
        [ 90,  68,  72],
        [106,  81,  91]],

       [[ 86,  81,  69],
        [ 81,  73,  63],
        [ 76,  67,  61],
        ...,
        [ 70,  42,  49],
        [ 67,  44,  51],
        [ 74,  51,  63]],

       [[ 82,  76,  66],
        [ 80,  72,  66],
        [ 78,  68,  66],
        ...,
        [ 84,  53,  61],
        [ 64,  43,  48],
        [ 65,  43,  50]],

       ...,

       [[  5, 112, 118],
        [  6, 113, 119],
        [  6, 113, 119],
        ...,
        [ 13,  99, 116],
        [ 12,  98, 115],
        [ 12,  98, 111]],

       [[  6, 113, 119],
        [  6, 113, 119],
        [  5, 112, 119],
        ...,
        [ 16,  97, 117],
        [ 12,  98, 115],
        [  9,  97, 108]],

       [[  6, 113, 119],
        [  6, 113, 119],
        [  6, 113, 119],
        ...,
        [ 17,  98, 117],
        [ 14,  99, 115],
        [  9,  98, 109]]], dtype=uint8)]"
Image_1518.jpg,486,485,119,70,750,1000,605,555,119,daskShared_local/images/Image_1518.jpg,1518,"[array([[[  1,  72, 116],
        [  1,  71, 115],
        [  0,  70, 114],
        ...,
        [  0,  66, 109],
        [  0,  66, 109],
        [  0,  66, 109]],

       [[  1,  71, 115],
        [  1,  71, 115],
        [  0,  69, 113],
        ...,
        [  0,  66, 109],
        [  0,  66, 109],
        [  0,  66, 109]],

       [[  0,  70, 114],
        [  0,  69, 113],
        [  0,  68, 112],
        ...,
        [  0,  65, 108],
        [  0,  65, 108],
        [  0,  65, 108]],

       ...,

       [[ 12,  11,   7],
        [ 13,  12,   8],
        [ 16,  15,  10],
        ...,
        [  2,  64, 103],
        [  1,  63, 102],
        [  1,  63, 102]],

       [[ 44,  39,  20],
        [ 48,  43,  24],
        [ 60,  56,  36],
        ...,
        [  1,  63, 102],
        [  1,  63, 102],
        [  0,  62, 101]],

       [[ 55,  48,  24],
        [ 60,  54,  29],
        [ 75,  70,  45],
        ...,
        [  0,  62, 101],
        [  0,  62, 101],
        [  0,  62, 101]]], dtype=uint8)]"
Image_1519.jpg,66,137,114,107,525,340,180,244,114,daskShared_local/images/Image_1519.jpg,1519,"[array([[[ 41,  93, 114],
        [ 40,  93, 112],
        [ 36,  89, 108],
        ...,
        [130, 150, 115],
        [120, 142, 111],
        [118, 140, 109]],

       [[ 39,  92, 112],
        [ 38,  91, 111],
        [ 35,  88, 106],
        ...,
        [135, 155, 120],
        [122, 144, 112],
        [119, 140, 109]],

       [[ 33,  85, 105],
        [ 32,  85, 104],
        [ 30,  83, 101],
        ...,
        [153, 173, 137],
        [128, 149, 116],
        [121, 142, 110]],

       ...,

       [[ 25,  47,  40],
        [ 28,  49,  42],
        [ 36,  57,  50],
        ...,
        [ 36,  55,  36],
        [ 55,  75,  56],
        [ 60,  81,  62]],

       [[ 33,  61,  51],
        [ 39,  67,  57],
        [ 59,  87,  76],
        ...,
        [ 54,  74,  55],
        [ 49,  70,  51],
        [ 48,  69,  50]],

       [[ 35,  65,  54],
        [ 41,  71,  60],
        [ 65,  94,  83],
        ...,
        [ 58,  79,  60],
        [ 48,  69,  50],
        [ 45,  66,  47]]], dtype=uint8)]"
Image_152.jpg,445,233,171,170,900,586,616,403,171,daskShared_local/images/Image_152.jpg,152,"[array([[[203, 231, 252],
        [195, 228, 252],
        [191, 229, 252],
        ...,
        [102, 203, 227],
        [102, 202, 226],
        [102, 202, 226]],

       [[181, 220, 221],
        [176, 219, 219],
        [175, 221, 219],
        ...,
        [100, 203, 227],
        [100, 202, 227],
        [100, 202, 227]],

       [[176, 221, 229],
        [173, 221, 226],
        [171, 221, 225],
        ...,
        [ 98, 202, 227],
        [ 98, 201, 226],
        [ 98, 201, 226]],

       ...,

       [[137, 162, 131],
        [124, 154, 123],
        [126, 159, 130],
        ...,
        [  2, 165, 211],
        [  2, 165, 211],
        [  3, 166, 211]],

       [[102, 137, 109],
        [104, 143, 115],
        [114, 155, 128],
        ...,
        [  1, 166, 211],
        [  1, 166, 211],
        [  2, 167, 212]],

       [[ 90, 132, 107],
        [ 78, 123,  97],
        [ 67, 114,  88],
        ...,
        [  1, 166, 211],
        [  1, 166, 211],
        [  1, 166, 211]]], dtype=uint8)]"
Image_1520.jpg,807,209,230,199,1200,900,1037,408,230,daskShared_local/images/Image_1520.jpg,1520,"[array([[[187, 203, 216],
        [185, 201, 214],
        [185, 201, 215],
        ...,
        [191, 205, 218],
        [188, 204, 217],
        [187, 203, 216]],

       [[186, 202, 215],
        [185, 201, 215],
        [185, 201, 214],
        ...,
        [190, 204, 217],
        [190, 204, 217],
        [189, 204, 217]],

       [[185, 201, 215],
        [185, 201, 216],
        [185, 201, 214],
        ...,
        [190, 204, 217],
        [190, 203, 217],
        [190, 204, 217]],

       ...,

       [[ 78,  53,  42],
        [105,  74,  58],
        [134, 100,  79],
        ...,
        [ 72, 113, 152],
        [ 71, 113, 152],
        [ 72, 114, 152]],

       [[ 56,  38,  35],
        [ 73,  47,  38],
        [ 98,  67,  51],
        ...,
        [ 73, 113, 153],
        [ 73, 114, 154],
        [ 72, 114, 154]],

       [[ 44,  28,  26],
        [ 47,  27,  26],
        [ 55,  32,  24],
        ...,
        [ 73, 114, 155],
        [ 73, 112, 153],
        [ 75, 114, 155]]], dtype=uint8)]"
Image_1521.jpg,287,133,152,116,800,505,439,249,152,daskShared_local/images/Image_1521.jpg,1521,"[array([[[ 73,  90,  83],
        [ 87, 108,  98],
        [103, 126, 115],
        ...,
        [  7,  30,  38],
        [  5,  27,  36],
        [  5,  25,  34]],

       [[ 64,  84,  75],
        [ 77, 101,  90],
        [ 95, 120, 109],
        ...,
        [  6,  28,  38],
        [  5,  25,  35],
        [  3,  22,  33]],

       [[ 70,  93,  84],
        [ 76, 103,  93],
        [ 85, 112, 103],
        ...,
        [  5,  26,  38],
        [  4,  22,  35],
        [  1,  19,  32]],

       ...,

       [[110, 112,  74],
        [117, 118,  82],
        [123, 122,  89],
        ...,
        [220, 198, 166],
        [223, 202, 172],
        [224, 202, 174]],

       [[118, 120,  82],
        [125, 125,  90],
        [130, 129,  96],
        ...,
        [212, 191, 160],
        [210, 190, 161],
        [208, 189, 161]],

       [[121, 122,  86],
        [128, 127,  93],
        [132, 129,  96],
        ...,
        [205, 185, 154],
        [199, 181, 151],
        [195, 177, 149]]], dtype=uint8)]"
Image_1522.jpg,1794,2578,530,417,2720,4080,2324,2995,530,daskShared_local/images/Image_1522.jpg,1522,"[array([[[105, 101,  83],
        [110,  99,  78],
        [154, 136, 109],
        ...,
        [  4, 121, 193],
        [  5, 123, 196],
        [  5, 124, 199]],

       [[126, 112,  88],
        [154, 136, 112],
        [145, 123,  96],
        ...,
        [  3, 120, 192],
        [  3, 121, 194],
        [  2, 121, 197]],

       [[126, 121, 106],
        [134, 125, 112],
        [113,  93,  71],
        ...,
        [  5, 120, 193],
        [  6, 123, 197],
        [  4, 122, 196]],

       ...,

       [[  4, 116, 190],
        [  6, 117, 191],
        [  4, 113, 187],
        ...,
        [  4, 115, 189],
        [  5, 114, 189],
        [  5, 113, 188]],

       [[  6, 118, 192],
        [  2, 112, 186],
        [  6, 117, 191],
        ...,
        [  3, 114, 188],
        [  3, 112, 187],
        [  5, 115, 190]],

       [[  4, 116, 190],
        [  3, 112, 186],
        [  3, 111, 185],
        ...,
        [  1, 111, 185],
        [  4, 114, 188],
        [  3, 113, 188]]], dtype=uint8)]"
Image_1523.jpg,745,237,122,100,1024,516,867,337,122,daskShared_local/images/Image_1523.jpg,1523,"[array([[[138, 151, 160],
        [134, 146, 155],
        [123, 133, 145],
        ...,
        [  0, 142, 174],
        [  1, 143, 177],
        [  1, 144, 177]],

       [[137, 150, 159],
        [133, 145, 155],
        [124, 134, 145],
        ...,
        [  0, 142, 175],
        [  1, 143, 177],
        [  1, 144, 178]],

       [[136, 148, 157],
        [133, 145, 154],
        [127, 137, 147],
        ...,
        [  0, 142, 176],
        [  1, 144, 178],
        [  2, 144, 178]],

       ...,

       [[  0,  77, 104],
        [  0,  78, 106],
        [  1,  80, 110],
        ...,
        [  0,  44,  73],
        [  0,  46,  74],
        [  0,  46,  75]],

       [[  0,  81, 109],
        [  0,  82, 111],
        [  0,  84, 116],
        ...,
        [  1,  46,  75],
        [  2,  48,  77],
        [  2,  49,  78]],

       [[  0,  83, 111],
        [  0,  83, 113],
        [  0,  86, 118],
        ...,
        [  2,  46,  75],
        [  3,  49,  78],
        [  3,  50,  79]]], dtype=uint8)]"
Image_1524.jpg,563,186,94,67,1000,700,657,253,94,daskShared_local/images/Image_1524.jpg,1524,"[array([[[  2, 159, 230],
        [  2, 159, 230],
        [  2, 159, 230],
        ...,
        [  0, 156, 225],
        [  0, 156, 225],
        [  0, 156, 225]],

       [[  2, 159, 230],
        [  2, 159, 230],
        [  2, 159, 230],
        ...,
        [  0, 156, 225],
        [  0, 156, 225],
        [  0, 156, 225]],

       [[  2, 159, 230],
        [  2, 159, 230],
        [  2, 159, 230],
        ...,
        [  0, 156, 225],
        [  0, 155, 224],
        [  0, 155, 224]],

       ...,

       [[ 10,  69,  90],
        [  9,  69,  89],
        [ 14,  74,  95],
        ...,
        [  0, 152, 222],
        [  0, 151, 223],
        [  0, 151, 223]],

       [[  5,  55,  82],
        [  5,  54,  81],
        [  7,  66,  92],
        ...,
        [  0, 152, 222],
        [  0, 151, 222],
        [  0, 151, 222]],

       [[  5,  57,  83],
        [  5,  56,  82],
        [  8,  67,  92],
        ...,
        [  0, 152, 222],
        [  0, 151, 222],
        [  0, 151, 222]]], dtype=uint8)]"
Image_1525.jpg,805,192,184,151,1120,922,989,343,184,daskShared_local/images/Image_1525.jpg,1525,"[array([[[  2, 155, 197],
        [  0, 149, 189],
        [  1, 146, 190],
        ...,
        [  0, 168, 195],
        [  0, 170, 194],
        [  0, 169, 192]],

       [[  0, 160, 205],
        [  1, 149, 192],
        [  0, 146, 189],
        ...,
        [  0, 160, 183],
        [  1, 163, 186],
        [  0, 159, 181]],

       [[  1, 159, 204],
        [  0, 151, 195],
        [  1, 148, 191],
        ...,
        [  0, 165, 185],
        [  0, 164, 183],
        [  0, 156, 176]],

       ...,

       [[201,  88,  24],
        [221, 116,  65],
        [212, 115,  51],
        ...,
        [  0, 148, 181],
        [  0, 156, 188],
        [  0, 159, 193]],

       [[199,  88,  19],
        [215, 115,  58],
        [215, 120,  61],
        ...,
        [  1, 156, 190],
        [  0, 159, 195],
        [  2, 163, 196]],

       [[190,  78,   3],
        [211, 108,  50],
        [214, 123,  66],
        ...,
        [  1, 159, 190],
        [  2, 166, 198],
        [ 20, 174, 205]]], dtype=uint8)]"
Image_1526.jpg,166,10,103,95,498,272,269,105,103,daskShared_local/images/Image_1526.jpg,1526,"[array([[[  3,  33,  65],
        [  3,  33,  65],
        [  3,  33,  65],
        ...,
        [  0,  29,  53],
        [  0,  30,  53],
        [  0,  30,  53]],

       [[  3,  33,  65],
        [  3,  33,  65],
        [  3,  33,  65],
        ...,
        [  0,  29,  53],
        [  0,  30,  53],
        [  0,  30,  53]],

       [[  2,  34,  67],
        [  2,  34,  67],
        [  2,  34,  67],
        ...,
        [  0,  28,  52],
        [  0,  29,  52],
        [  0,  29,  52]],

       ...,

       [[127, 131, 104],
        [125, 130, 103],
        [109, 113,  96],
        ...,
        [161, 174, 167],
        [166, 178, 173],
        [166, 179, 174]],

       [[103, 109,  96],
        [102, 108,  96],
        [ 97, 101,  96],
        ...,
        [163, 176, 169],
        [167, 181, 176],
        [167, 181, 176]],

       [[101, 107,  95],
        [101, 106,  95],
        [ 96, 101,  96],
        ...,
        [163, 176, 169],
        [167, 181, 176],
        [167, 181, 176]]], dtype=uint8)]"
Image_1527.jpg,340,126,53,66,768,514,393,192,66,daskShared_local/images/Image_1527.jpg,1527,"[array([[[  0,  79, 187],
        [  0,  79, 187],
        [  0,  79, 187],
        ...,
        [  1,  82, 194],
        [  0,  81, 193],
        [  1,  82, 194]],

       [[  0,  79, 187],
        [  0,  79, 187],
        [  0,  79, 187],
        ...,
        [  1,  82, 194],
        [  0,  81, 193],
        [  1,  82, 194]],

       [[  0,  79, 187],
        [  0,  79, 187],
        [  0,  79, 187],
        ...,
        [  1,  82, 194],
        [  0,  81, 193],
        [  1,  82, 194]],

       ...,

       [[231, 223, 189],
        [220, 212, 179],
        [231, 223, 189],
        ...,
        [163, 124,  69],
        [182, 139,  85],
        [163, 124,  69]],

       [[240, 235, 203],
        [236, 230, 198],
        [240, 235, 203],
        ...,
        [154, 115,  63],
        [171, 128,  77],
        [154, 115,  63]],

       [[231, 223, 189],
        [220, 212, 179],
        [231, 223, 189],
        ...,
        [163, 124,  69],
        [182, 139,  85],
        [163, 124,  69]]], dtype=uint8)]"
Image_1528.jpg,556,463,165,189,1020,800,721,652,189,daskShared_local/images/Image_1528.jpg,1528,"[array([[[ 52,  50,  46],
        [ 63,  62,  58],
        [ 77,  76,  71],
        ...,
        [ 77,  88,  90],
        [ 70,  82,  83],
        [ 60,  73,  74]],

       [[ 62,  55,  38],
        [ 78,  73,  55],
        [ 89,  86,  69],
        ...,
        [ 73,  86,  79],
        [ 80,  90,  83],
        [ 70,  78,  71]],

       [[ 85,  73,  56],
        [ 84,  72,  56],
        [ 78,  71,  54],
        ...,
        [ 67,  78,  74],
        [ 78,  88,  80],
        [ 72,  79,  72]],

       ...,

       [[105,  93,  97],
        [108,  96, 100],
        [111, 100, 104],
        ...,
        [ 67,  48,  46],
        [ 68,  50,  48],
        [ 69,  51,  49]],

       [[ 97,  86,  90],
        [100,  91,  94],
        [104,  98, 100],
        ...,
        [ 62,  43,  39],
        [ 63,  45,  41],
        [ 65,  47,  43]],

       [[ 95,  86,  89],
        [ 99,  90,  93],
        [103,  96,  98],
        ...,
        [ 60,  41,  35],
        [ 60,  43,  36],
        [ 61,  43,  39]]], dtype=uint8)]"
Image_1529.jpg,737,158,262,173,1050,700,999,331,262,daskShared_local/images/Image_1529.jpg,1529,"[array([[[  4, 163, 152],
        [  2, 163, 154],
        [  8, 165, 160],
        ...,
        [ 20, 180, 174],
        [ 42, 176, 173],
        [ 50, 169, 166]],

       [[  6, 168, 157],
        [  0, 161, 150],
        [ 11, 170, 161],
        ...,
        [ 23, 179, 166],
        [ 40, 147, 141],
        [ 34, 127, 118]],

       [[ 15, 171, 161],
        [  5, 163, 149],
        [ 13, 168, 156],
        ...,
        [ 66, 144, 143],
        [ 63,  91,  99],
        [ 51,  74,  74]],

       ...,

       [[ 32,  40,  49],
        [ 31,  41,  50],
        [ 34,  49,  56],
        ...,
        [ 58, 114, 121],
        [ 41,  61,  75],
        [ 32,  42,  56]],

       [[ 32,  42,  48],
        [ 32,  43,  49],
        [ 29,  43,  47],
        ...,
        [ 47, 122, 127],
        [ 23,  60,  72],
        [ 12,  19,  38]],

       [[ 38,  44,  49],
        [ 37,  42,  48],
        [ 35,  42,  48],
        ...,
        [ 24, 122, 120],
        [  9,  97,  95],
        [  3,  36,  49]]], dtype=uint8)]"
Image_153.jpg,1911,612,1182,1177,4752,3168,3093,1789,1182,daskShared_local/images/Image_153.jpg,153,"[array([[[ 69,  63,  37],
        [ 69,  62,  36],
        [ 65,  59,  33],
        ...,
        [ 44, 118, 149],
        [ 45, 118, 150],
        [ 47, 119, 150]],

       [[ 73,  68,  43],
        [ 70,  65,  40],
        [ 66,  61,  36],
        ...,
        [ 42, 117, 149],
        [ 43, 117, 149],
        [ 43, 117, 149]],

       [[ 74,  70,  44],
        [ 71,  67,  42],
        [ 70,  66,  42],
        ...,
        [ 44, 118, 149],
        [ 44, 118, 149],
        [ 44, 117, 149]],

       ...,

       [[  2,  95, 139],
        [  2,  95, 139],
        [  1,  95, 139],
        ...,
        [119, 100,  86],
        [101,  84,  78],
        [ 82,  69,  67]],

       [[  3,  96, 140],
        [  3,  97, 141],
        [  2,  96, 140],
        ...,
        [104,  85,  73],
        [ 84,  69,  67],
        [ 72,  58,  59]],

       [[  5,  96, 140],
        [  3,  96, 140],
        [  4,  96, 140],
        ...,
        [104,  85,  70],
        [ 78,  64,  60],
        [ 66,  53,  51]]], dtype=uint8)]"
Image_1530.jpg,555,101,130,84,700,477,685,185,130,daskShared_local/images/Image_1530.jpg,1530,"[array([[[ 42,  48, 110],
        [ 42,  48, 110],
        [ 42,  48, 110],
        ...,
        [ 40,  45, 103],
        [ 40,  45, 103],
        [ 40,  45, 103]],

       [[ 42,  48, 110],
        [ 42,  48, 110],
        [ 42,  48, 110],
        ...,
        [ 40,  45, 103],
        [ 40,  45, 103],
        [ 40,  45, 103]],

       [[ 42,  48, 110],
        [ 42,  48, 110],
        [ 42,  48, 110],
        ...,
        [ 39,  44, 102],
        [ 39,  44, 102],
        [ 39,  44, 102]],

       ...,

       [[ 35,  48, 100],
        [ 35,  48, 100],
        [ 35,  48, 100],
        ...,
        [ 35,  42,  96],
        [ 35,  42,  96],
        [ 35,  42,  96]],

       [[ 34,  47,  99],
        [ 34,  47,  99],
        [ 35,  48, 100],
        ...,
        [ 35,  42,  96],
        [ 35,  42,  96],
        [ 35,  42,  96]],

       [[ 34,  47,  99],
        [ 34,  47,  99],
        [ 34,  47,  99],
        ...,
        [ 35,  42,  96],
        [ 35,  42,  96],
        [ 35,  42,  96]]], dtype=uint8)]"
Image_1531.jpg,152,280,186,190,894,900,338,470,190,daskShared_local/images/Image_1531.jpg,1531,"[array([[[ 96, 168, 218],
        [131, 202, 252],
        [119, 190, 241],
        ...,
        [137, 215, 254],
        [119, 197, 243],
        [100, 178, 224]],

       [[127, 199, 249],
        [111, 183, 233],
        [109, 181, 232],
        ...,
        [134, 212, 254],
        [116, 194, 240],
        [111, 189, 235]],

       [[122, 192, 241],
        [113, 183, 232],
        [105, 176, 225],
        ...,
        [104, 183, 226],
        [121, 200, 244],
        [109, 188, 231]],

       ...,

       [[ 28,  75, 143],
        [ 17,  64, 132],
        [ 27,  75, 141],
        ...,
        [170, 178, 150],
        [148, 152, 124],
        [201, 205, 177]],

       [[ 12,  59, 127],
        [ 28,  75, 143],
        [ 20,  68, 134],
        ...,
        [140, 146, 111],
        [176, 180, 145],
        [178, 179, 144]],

       [[ 19,  66, 134],
        [ 27,  74, 142],
        [ 21,  69, 135],
        ...,
        [164, 169, 128],
        [179, 181, 141],
        [172, 173, 133]]], dtype=uint8)]"
Image_1532.jpg,220,214,135,140,800,600,355,354,140,daskShared_local/images/Image_1532.jpg,1532,"[array([[[ 68, 185, 208],
        [ 66, 185, 208],
        [ 63, 185, 208],
        ...,
        [ 19, 165, 192],
        [ 20, 165, 192],
        [ 20, 165, 192]],

       [[ 67, 186, 208],
        [ 66, 186, 208],
        [ 63, 186, 208],
        ...,
        [ 18, 164, 192],
        [ 18, 164, 192],
        [ 19, 164, 192]],

       [[ 67, 187, 208],
        [ 66, 186, 207],
        [ 63, 185, 207],
        ...,
        [ 16, 164, 192],
        [ 17, 165, 193],
        [ 18, 165, 193]],

       ...,

       [[ 17, 146, 154],
        [ 17, 146, 153],
        [ 16, 144, 150],
        ...,
        [222, 194, 142],
        [218, 190, 129],
        [216, 187, 121]],

       [[ 20, 146, 152],
        [ 22, 146, 152],
        [ 22, 145, 149],
        ...,
        [222, 195, 144],
        [222, 195, 138],
        [222, 195, 133]],

       [[ 22, 145, 150],
        [ 24, 146, 151],
        [ 26, 146, 150],
        ...,
        [224, 198, 147],
        [226, 199, 148],
        [227, 199, 147]]], dtype=uint8)]"
Image_1533.jpg,415,344,297,245,1536,1024,712,589,297,daskShared_local/images/Image_1533.jpg,1533,"[array([[[ 13, 139, 244],
        [ 13, 134, 247],
        [ 13, 135, 246],
        ...,
        [ 19, 189, 250],
        [ 16, 186, 249],
        [ 17, 186, 251]],

       [[  8, 139, 241],
        [  9, 137, 245],
        [ 10, 137, 244],
        ...,
        [ 17, 184, 250],
        [ 16, 182, 247],
        [ 14, 180, 246]],

       [[  9, 142, 243],
        [  9, 140, 245],
        [  8, 139, 243],
        ...,
        [ 14, 179, 247],
        [ 15, 180, 246],
        [ 14, 178, 245]],

       ...,

       [[  9,  63, 208],
        [ 16,  69, 200],
        [  8,  61, 195],
        ...,
        [ 20,  30,  19],
        [ 22,  33,  23],
        [ 36,  30,  36]],

       [[ 11,  66, 207],
        [ 22,  77, 193],
        [  6,  58, 182],
        ...,
        [ 24,  39,  21],
        [ 23,  42,  24],
        [ 18,  37,  25]],

       [[ 11,  65, 205],
        [ 15,  70, 186],
        [  5,  59, 181],
        ...,
        [ 16,  56,  44],
        [ 16,  65,  51],
        [  8,  89,  92]]], dtype=uint8)]"
Image_1534.jpg,292,167,237,199,1000,664,529,366,237,daskShared_local/images/Image_1534.jpg,1534,"[array([[[  1,  80, 149],
        [  1,  82, 148],
        [  1,  81, 148],
        ...,
        [  0, 104, 173],
        [  0, 105, 172],
        [  2, 105, 172]],

       [[  3,  82, 149],
        [  1,  82, 148],
        [  1,  81, 149],
        ...,
        [  0, 103, 173],
        [  0, 103, 173],
        [  0, 102, 172]],

       [[  1,  81, 148],
        [  1,  81, 148],
        [  1,  81, 148],
        ...,
        [  0, 102, 173],
        [  0, 102, 173],
        [  0, 103, 174]],

       ...,

       [[ 40,  32,  28],
        [ 36,  35,  35],
        [ 33,  45,  46],
        ...,
        [174, 161, 143],
        [179, 166, 144],
        [204, 193, 167]],

       [[ 39,  29,  28],
        [ 37,  36,  35],
        [ 31,  40,  37],
        ...,
        [150, 133, 107],
        [123, 108,  81],
        [135, 121, 101]],

       [[ 37,  32,  28],
        [ 35,  36,  31],
        [ 31,  38,  29],
        ...,
        [158, 141, 107],
        [124, 103,  65],
        [115,  93,  56]]], dtype=uint8)]"
Image_1535.jpg,609,214,392,425,1600,1070,1001,639,425,daskShared_local/images/Image_1535.jpg,1535,"[array([[[ 24,  74, 145],
        [ 24,  74, 145],
        [ 24,  74, 145],
        ...,
        [ 28,  69, 133],
        [ 28,  69, 133],
        [ 28,  69, 133]],

       [[ 24,  74, 145],
        [ 24,  74, 145],
        [ 24,  74, 145],
        ...,
        [ 28,  69, 133],
        [ 28,  69, 133],
        [ 28,  69, 133]],

       [[ 24,  74, 145],
        [ 24,  74, 145],
        [ 24,  74, 145],
        ...,
        [ 28,  69, 133],
        [ 28,  69, 133],
        [ 28,  69, 133]],

       ...,

       [[173, 159, 127],
        [167, 147, 116],
        [201, 176, 142],
        ...,
        [128, 102,  56],
        [192, 167, 116],
        [206, 182, 134]],

       [[189, 171, 140],
        [165, 148, 119],
        [176, 163, 131],
        ...,
        [231, 207, 156],
        [217, 192, 143],
        [175, 152, 107]],

       [[174, 164, 137],
        [139, 135, 117],
        [132, 135, 120],
        ...,
        [206, 186, 147],
        [211, 188, 147],
        [178, 155, 110]]], dtype=uint8)]"
Image_1536.jpg,441,218,189,195,1200,630,630,413,195,daskShared_local/images/Image_1536.jpg,1536,"[array([[[ 24,  97, 166],
        [ 19,  92, 161],
        [ 23,  95, 167],
        ...,
        [ 37,  62,  66],
        [ 53,  74,  79],
        [ 37,  56,  62]],

       [[ 30, 103, 172],
        [ 25,  98, 167],
        [ 22,  95, 164],
        ...,
        [ 41,  62,  67],
        [ 37,  56,  62],
        [ 28,  45,  52]],

       [[ 29, 102, 170],
        [ 27, 100, 169],
        [ 29, 102, 171],
        ...,
        [ 33,  52,  58],
        [ 25,  42,  49],
        [ 17,  32,  39]],

       ...,

       [[ 67, 120, 136],
        [ 50, 101, 120],
        [ 28,  79,  98],
        ...,
        [ 30,  41,  37],
        [ 20,  31,  27],
        [ 18,  29,  25]],

       [[ 55, 106, 123],
        [ 43,  94, 113],
        [ 33,  81, 101],
        ...,
        [ 36,  48,  44],
        [ 37,  49,  45],
        [ 43,  55,  51]],

       [[ 27,  76,  93],
        [ 26,  75,  92],
        [ 30,  79,  96],
        ...,
        [ 43,  58,  53],
        [ 60,  77,  71],
        [ 61,  78,  72]]], dtype=uint8)]"
Image_1537.jpg,383,136,228,186,869,574,611,322,228,daskShared_local/images/Image_1537.jpg,1537,"[array([[[  8, 156, 224],
        [  3, 152, 220],
        [  4, 155, 221],
        ...,
        [ 83, 168, 241],
        [ 85, 168, 242],
        [ 89, 168, 243]],

       [[ 39, 160, 228],
        [ 42, 157, 230],
        [ 42, 161, 231],
        ...,
        [ 85, 168, 242],
        [ 86, 168, 241],
        [ 89, 170, 243]],

       [[ 82, 163, 238],
        [ 84, 167, 242],
        [ 87, 171, 246],
        ...,
        [ 86, 168, 242],
        [ 86, 168, 241],
        [ 87, 170, 243]],

       ...,

       [[  7,  55,  34],
        [  4,  55,  35],
        [  5,  55,  35],
        ...,
        [  0, 107, 181],
        [  0, 107, 180],
        [  0, 107, 180]],

       [[ 24,  61,  46],
        [ 19,  69,  51],
        [ 10,  60,  40],
        ...,
        [  0, 107, 180],
        [  0, 106, 180],
        [  0, 106, 180]],

       [[ 20,  62,  46],
        [  7,  39,  28],
        [  7,  39,  25],
        ...,
        [  1, 106, 180],
        [  2, 105, 180],
        [  2, 105, 180]]], dtype=uint8)]"
Image_1538.jpg,1850,603,1262,1177,4752,3168,3112,1780,1262,daskShared_local/images/Image_1538.jpg,1538,"[array([[[ 70,  78,  79],
        [ 68,  75,  76],
        [ 67,  74,  74],
        ...,
        [ 43, 116, 150],
        [ 43, 116, 149],
        [ 44, 117, 149]],

       [[ 63,  73,  78],
        [ 60,  70,  77],
        [ 58,  67,  74],
        ...,
        [ 45, 118, 150],
        [ 43, 116, 149],
        [ 43, 116, 149]],

       [[ 59,  68,  75],
        [ 59,  70,  75],
        [ 63,  75,  77],
        ...,
        [ 48, 121, 151],
        [ 47, 120, 151],
        [ 44, 117, 150]],

       ...,

       [[ 47, 130, 152],
        [ 48, 130, 153],
        [ 49, 130, 153],
        ...,
        [197, 197, 149],
        [193, 201, 176],
        [160, 163, 159]],

       [[ 55, 136, 152],
        [ 56, 138, 155],
        [ 58, 140, 156],
        ...,
        [196, 198, 171],
        [172, 175, 163],
        [134, 130, 135]],

       [[ 56, 133, 144],
        [ 56, 132, 145],
        [ 59, 135, 148],
        ...,
        [184, 179, 159],
        [157, 150, 138],
        [125, 114, 110]]], dtype=uint8)]"
Image_1539.jpg,1735,533,1407,1605,4631,3087,3142,2138,1605,daskShared_local/images/Image_1539.jpg,1539,"[array([[[ 20,  94, 241],
        [ 20,  94, 240],
        [ 20,  93, 240],
        ...,
        [  1,  60, 196],
        [  1,  60, 196],
        [  0,  59, 195]],

       [[ 20,  93, 240],
        [ 20,  93, 240],
        [ 21,  93, 240],
        ...,
        [  1,  59, 195],
        [  1,  59, 195],
        [  1,  59, 195]],

       [[ 21,  93, 240],
        [ 21,  92, 240],
        [ 21,  92, 240],
        ...,
        [  0,  59, 194],
        [  1,  59, 194],
        [  1,  59, 193]],

       ...,

       [[ 39,  45,  55],
        [ 83,  82,  81],
        [128, 122,  99],
        ...,
        [ 29,  36,  16],
        [ 37,  44,  22],
        [ 53,  62,  36]],

       [[ 33,  39,  46],
        [ 69,  65,  64],
        [116, 104,  86],
        ...,
        [ 32,  40,  18],
        [ 42,  50,  26],
        [ 52,  60,  35]],

       [[ 30,  38,  43],
        [ 60,  54,  54],
        [103,  87,  76],
        ...,
        [ 35,  42,  20],
        [ 41,  47,  26],
        [ 36,  43,  25]]], dtype=uint8)]"
Image_154.png,239,31,86,85,589,295,325,116,86,daskShared_local/images/Image_154.png,154,"[array([[[  0, 171, 192],
        [  0, 170, 192],
        [  0, 171, 192],
        ...,
        [  0, 165, 191],
        [  0, 165, 192],
        [  0, 165, 192]],

       [[  0, 171, 192],
        [  0, 171, 192],
        [  0, 172, 193],
        ...,
        [  0, 165, 191],
        [  0, 166, 192],
        [  0, 165, 192]],

       [[  0, 170, 190],
        [  0, 169, 190],
        [  0, 170, 190],
        ...,
        [  0, 164, 190],
        [  0, 165, 192],
        [  0, 164, 191]],

       ...,

       [[ 46,  24,  18],
        [ 47,  24,  17],
        [ 46,  24,  18],
        ...,
        [157,  94,  88],
        [132,  73,  68],
        [140,  79,  74]],

       [[ 51,  27,  29],
        [ 51,  25,  28],
        [ 53,  30,  30],
        ...,
        [101,  52,  48],
        [ 69,  27,  26],
        [ 79,  35,  33]],

       [[ 50,  26,  25],
        [ 49,  25,  25],
        [ 50,  28,  27],
        ...,
        [118,  65,  61],
        [ 88,  41,  39],
        [ 97,  48,  46]]], dtype=uint8)]"
Image_1540.jpg,414,136,237,237,1024,686,651,373,237,daskShared_local/images/Image_1540.jpg,1540,"[array([[[ 33, 189, 240],
        [ 35, 191, 242],
        [ 35, 191, 242],
        ...,
        [  0, 157, 218],
        [  0, 156, 217],
        [  0, 156, 217]],

       [[ 34, 190, 241],
        [ 35, 191, 242],
        [ 34, 190, 241],
        ...,
        [  0, 157, 218],
        [  0, 156, 217],
        [  0, 156, 217]],

       [[ 34, 190, 241],
        [ 33, 190, 241],
        [ 32, 188, 239],
        ...,
        [  0, 157, 218],
        [  0, 156, 217],
        [  0, 156, 217]],

       ...,

       [[227, 208, 196],
        [214, 193, 181],
        [204, 179, 172],
        ...,
        [  3, 115, 181],
        [  2, 115, 181],
        [  2, 115, 181]],

       [[204, 187, 172],
        [208, 190, 177],
        [203, 182, 175],
        ...,
        [  3, 115, 181],
        [  2, 115, 181],
        [  3, 116, 182]],

       [[221, 208, 196],
        [233, 218, 207],
        [224, 206, 201],
        ...,
        [  3, 115, 181],
        [  3, 116, 182],
        [  4, 117, 183]]], dtype=uint8)]"
Image_1541.jpg,443,232,170,159,900,586,613,391,170,daskShared_local/images/Image_1541.jpg,1541,"[array([[[  2, 172, 207],
        [  2, 172, 207],
        [  3, 173, 208],
        ...,
        [103, 205, 227],
        [104, 206, 228],
        [104, 206, 228]],

       [[  0, 170, 205],
        [  0, 170, 205],
        [  1, 171, 206],
        ...,
        [103, 205, 227],
        [103, 205, 227],
        [104, 206, 228]],

       [[  2, 172, 207],
        [  2, 172, 207],
        [  3, 173, 208],
        ...,
        [103, 205, 227],
        [103, 205, 227],
        [103, 205, 227]],

       ...,

       [[ 19,  66,  66],
        [ 10,  70,  67],
        [  5,  86,  77],
        ...,
        [  1, 163, 209],
        [  1, 163, 209],
        [  1, 163, 209]],

       [[ 27,  79,  74],
        [ 16,  78,  73],
        [  6,  77,  70],
        ...,
        [  1, 163, 209],
        [  1, 163, 209],
        [  1, 163, 209]],

       [[ 33,  87,  75],
        [ 29,  89,  80],
        [ 15,  79,  74],
        ...,
        [  1, 163, 209],
        [  1, 163, 209],
        [  1, 163, 209]]], dtype=uint8)]"
Image_1542.jpg,512,247,327,220,1200,900,839,467,327,daskShared_local/images/Image_1542.jpg,1542,"[array([[[ 56, 178, 195],
        [ 32, 169, 173],
        [ 57, 172, 185],
        ...,
        [ 74, 186, 204],
        [ 76, 187, 204],
        [ 74, 187, 208]],

       [[ 68, 181, 191],
        [  3, 168, 172],
        [ 46, 173, 184],
        ...,
        [ 90, 191, 207],
        [ 83, 190, 210],
        [ 79, 189, 209]],

       [[ 60, 174, 183],
        [ 47, 160, 173],
        [ 42, 170, 184],
        ...,
        [ 85, 188, 199],
        [ 91, 190, 204],
        [ 84, 189, 206]],

       ...,

       [[165, 205, 200],
        [220, 237, 239],
        [222, 240, 244],
        ...,
        [132, 202, 219],
        [135, 203, 214],
        [135, 200, 215]],

       [[199, 227, 230],
        [204, 232, 233],
        [222, 238, 241],
        ...,
        [150, 207, 219],
        [125, 199, 208],
        [120, 197, 208]],

       [[183, 222, 226],
        [213, 234, 239],
        [216, 236, 240],
        ...,
        [162, 212, 223],
        [148, 208, 224],
        [105, 194, 207]]], dtype=uint8)]"
Image_1543.jpg,722,435,500,378,2119,1414,1222,813,500,daskShared_local/images/Image_1543.jpg,1543,"[array([[[104, 165, 193],
        [107, 168, 196],
        [100, 161, 189],
        ...,
        [ 71, 136, 168],
        [ 72, 137, 169],
        [ 72, 137, 169]],

       [[101, 159, 188],
        [102, 161, 189],
        [ 99, 158, 186],
        ...,
        [ 73, 138, 170],
        [ 72, 138, 170],
        [ 66, 132, 164]],

       [[ 98, 154, 184],
        [ 96, 152, 181],
        [ 95, 151, 181],
        ...,
        [ 71, 137, 169],
        [ 70, 137, 169],
        [ 65, 131, 163]],

       ...,

       [[ 79, 175, 200],
        [ 77, 173, 198],
        [ 74, 172, 197],
        ...,
        [118,  97,  52],
        [110,  88,  42],
        [119,  97,  53]],

       [[ 79, 175, 200],
        [ 78, 174, 199],
        [ 73, 171, 196],
        ...,
        [119, 100,  59],
        [107,  89,  52],
        [119, 101,  64]],

       [[ 79, 175, 200],
        [ 78, 174, 199],
        [ 74, 172, 197],
        ...,
        [131, 113,  72],
        [133, 119,  80],
        [136, 122,  81]]], dtype=uint8)]"
Image_1544.png,241,31,85,85,589,295,326,116,85,daskShared_local/images/Image_1544.png,1544,"[array([[[  0, 167, 189],
        [  0, 167, 187],
        [  0, 167, 193],
        ...,
        [  0, 169, 195],
        [  0, 173, 198],
        [  0, 171, 197]],

       [[  0, 167, 189],
        [  0, 167, 187],
        [  0, 167, 192],
        ...,
        [  0, 169, 195],
        [  0, 173, 198],
        [  0, 172, 197]],

       [[  0, 168, 190],
        [  0, 168, 188],
        [  0, 168, 194],
        ...,
        [  0, 169, 196],
        [  0, 172, 200],
        [  0, 171, 198]],

       ...,

       [[102,  64,  47],
        [102,  66,  49],
        [102,  60,  43],
        ...,
        [124,  75,  69],
        [116,  66,  61],
        [118,  69,  64]],

       [[ 68,  40,  31],
        [ 64,  39,  30],
        [ 76,  43,  32],
        ...,
        [166, 102,  94],
        [160, 100,  92],
        [162, 101,  92]],

       [[ 79,  48,  36],
        [ 77,  48,  36],
        [ 85,  49,  36],
        ...,
        [152,  93,  85],
        [145,  89,  82],
        [147,  90,  83]]], dtype=uint8)]"
Image_1545.jpg,204,188,180,164,500,559,384,352,180,daskShared_local/images/Image_1545.jpg,1545,"[array([[[ 64, 177, 175],
        [ 71, 182, 179],
        [ 78, 187, 183],
        ...,
        [120, 208, 194],
        [124, 212, 198],
        [125, 216, 201]],

       [[ 60, 172, 173],
        [ 64, 176, 177],
        [ 68, 180, 180],
        ...,
        [129, 220, 209],
        [130, 223, 211],
        [129, 225, 212]],

       [[ 54, 167, 172],
        [ 57, 171, 176],
        [ 59, 173, 179],
        ...,
        [121, 217, 208],
        [119, 218, 208],
        [118, 219, 208]],

       ...,

       [[ 31,  17,   1],
        [ 75,  61,  25],
        [ 97,  89,  46],
        ...,
        [  4, 185, 187],
        [  2, 185, 185],
        [  2, 186, 184]],

       [[ 28,  11,   0],
        [ 62,  44,   9],
        [ 77,  64,  23],
        ...,
        [  0, 184, 191],
        [  0, 184, 191],
        [  0, 184, 192]],

       [[ 25,   5,   1],
        [ 73,  51,  21],
        [ 77,  59,  26],
        ...,
        [  0, 187, 201],
        [  0, 187, 205],
        [  0, 188, 207]]], dtype=uint8)]"
Image_1546.jpg,359,94,151,198,728,486,510,292,198,daskShared_local/images/Image_1546.jpg,1546,"[array([[[  3,  66, 255],
        [  1,  70, 251],
        [  0,  70, 253],
        ...,
        [  0, 111, 253],
        [  1, 110, 253],
        [  0, 111, 252]],

       [[  2,  67, 255],
        [  0,  68, 253],
        [  0,  68, 253],
        ...,
        [  1, 110, 253],
        [  0, 106, 254],
        [  3, 114, 255]],

       [[  1,  69, 254],
        [  2,  67, 255],
        [  2,  67, 255],
        ...,
        [  2, 108, 254],
        [  0, 109, 254],
        [  0, 111, 253]],

       ...,

       [[148,  82,  60],
        [150,  89,  61],
        [171, 117,  91],
        ...,
        [ 91, 106,  85],
        [ 86,  98,  88],
        [ 93,  96,  87]],

       [[179, 119,  85],
        [195, 136, 104],
        [199, 145, 111],
        ...,
        [ 99, 117,  77],
        [ 89, 102,  74],
        [ 89,  96,  78]],

       [[199, 154, 125],
        [181, 141, 116],
        [173, 124,  94],
        ...,
        [153, 164, 134],
        [106, 120,  59],
        [102, 113,  70]]], dtype=uint8)]"
Image_1547.jpg,276,160,183,175,800,533,459,335,183,daskShared_local/images/Image_1547.jpg,1547,"[array([[[254, 253, 224],
        [254, 254, 230],
        [255, 254, 234],
        ...,
        [ 99, 101, 113],
        [ 48,  50,  62],
        [ 31,  33,  45]],

       [[255, 254, 235],
        [253, 254, 238],
        [254, 254, 241],
        ...,
        [ 74,  78,  90],
        [ 41,  45,  57],
        [ 21,  25,  37]],

       [[255, 253, 244],
        [254, 253, 246],
        [253, 254, 247],
        ...,
        [ 62,  65,  79],
        [ 58,  61,  76],
        [ 51,  54,  69]],

       ...,

       [[162, 126, 112],
        [153, 117, 103],
        [154, 118, 104],
        ...,
        [105,  91,  82],
        [112,  98,  89],
        [115, 101,  92]],

       [[149, 113,  99],
        [146, 110,  96],
        [153, 117, 103],
        ...,
        [112,  98,  89],
        [114, 100,  91],
        [111,  97,  88]],

       [[116,  80,  65],
        [116,  80,  64],
        [132,  96,  80],
        ...,
        [103,  89,  80],
        [107,  93,  84],
        [106,  92,  83]]], dtype=uint8)]"
Image_1548.jpg,697,265,462,521,1920,1080,1159,786,521,daskShared_local/images/Image_1548.jpg,1548,"[array([[[  0, 119, 203],
        [  0, 119, 203],
        [  0, 118, 202],
        ...,
        [  2, 117, 200],
        [  1, 116, 199],
        [  1, 116, 199]],

       [[  0, 119, 203],
        [  0, 119, 203],
        [  0, 118, 202],
        ...,
        [  2, 117, 200],
        [  1, 116, 199],
        [  1, 116, 199]],

       [[  0, 119, 203],
        [  0, 119, 203],
        [  0, 119, 203],
        ...,
        [  2, 117, 200],
        [  1, 116, 199],
        [  1, 116, 199]],

       ...,

       [[144, 148, 123],
        [ 89,  94,  72],
        [ 67,  76,  57],
        ...,
        [202, 193, 157],
        [188, 180, 145],
        [197, 188, 155]],

       [[111, 116,  87],
        [ 80,  88,  66],
        [ 86,  99,  79],
        ...,
        [199, 194, 160],
        [186, 180, 145],
        [205, 199, 166]],

       [[100, 105,  80],
        [ 75,  82,  63],
        [103, 115,  97],
        ...,
        [168, 162, 134],
        [165, 161, 129],
        [175, 171, 139]]], dtype=uint8)]"
Image_1549.jpg,313,137,285,214,845,563,598,351,285,daskShared_local/images/Image_1549.jpg,1549,"[array([[[ 36, 184, 188],
        [ 30, 181, 186],
        [ 29, 180, 185],
        ...,
        [107, 203, 198],
        [105, 205, 200],
        [100, 202, 198]],

       [[ 44, 188, 191],
        [ 39, 185, 188],
        [ 36, 182, 186],
        ...,
        [109, 205, 201],
        [107, 207, 202],
        [101, 204, 200]],

       [[ 55, 191, 191],
        [ 50, 189, 190],
        [ 45, 186, 187],
        ...,
        [105, 202, 197],
        [105, 205, 201],
        [101, 204, 200]],

       ...,

       [[ 59, 101,  10],
        [ 61, 104,  14],
        [ 67, 109,  26],
        ...,
        [ 63, 199, 186],
        [ 69, 203, 193],
        [ 73, 205, 197]],

       [[ 62, 104,  37],
        [ 60, 103,  30],
        [ 58, 104,  25],
        ...,
        [ 56, 198, 186],
        [ 63, 202, 192],
        [ 69, 205, 195]],

       [[ 59,  96,  31],
        [ 59, 100,  30],
        [ 56,  99,  24],
        ...,
        [ 57, 198, 186],
        [ 66, 203, 193],
        [ 72, 206, 197]]], dtype=uint8)]"
Image_155.jpg,1726,552,1398,1573,4631,3087,3124,2125,1573,daskShared_local/images/Image_155.jpg,155,"[array([[[ 21,  92, 239],
        [ 21,  92, 239],
        [ 22,  92, 240],
        ...,
        [  0,  59, 195],
        [  0,  59, 195],
        [  0,  58, 194]],

       [[ 21,  91, 239],
        [ 21,  91, 239],
        [ 21,  91, 239],
        ...,
        [  0,  59, 195],
        [  0,  58, 194],
        [  0,  58, 194]],

       [[ 21,  91, 239],
        [ 21,  91, 239],
        [ 21,  91, 239],
        ...,
        [  0,  58, 194],
        [  0,  58, 193],
        [  0,  58, 193]],

       ...,

       [[118, 116,  95],
        [132, 131,  99],
        [131, 128,  95],
        ...,
        [ 31,  37,  20],
        [ 37,  46,  26],
        [ 31,  39,  21]],

       [[ 67,  71,  77],
        [114, 113,  97],
        [134, 133, 103],
        ...,
        [ 33,  39,  21],
        [ 37,  44,  27],
        [ 32,  38,  22]],

       [[ 43,  48,  57],
        [ 97,  90,  83],
        [130, 122,  98],
        ...,
        [ 40,  46,  26],
        [ 36,  41,  25],
        [ 35,  40,  24]]], dtype=uint8)]"
Image_1550.jpg,310,213,192,198,1000,600,502,411,198,daskShared_local/images/Image_1550.jpg,1550,"[array([[[  1, 146, 193],
        [  1, 146, 193],
        [  1, 146, 193],
        ...,
        [  1, 158, 201],
        [  1, 158, 201],
        [  1, 158, 201]],

       [[  1, 146, 193],
        [  1, 146, 193],
        [  1, 146, 193],
        ...,
        [  1, 158, 201],
        [  1, 158, 201],
        [  1, 158, 201]],

       [[  1, 146, 193],
        [  1, 146, 193],
        [  1, 146, 193],
        ...,
        [  1, 158, 201],
        [  1, 158, 201],
        [  1, 158, 201]],

       ...,

       [[222, 183, 144],
        [223, 186, 115],
        [229, 198,  81],
        ...,
        [249, 218, 151],
        [249, 219, 155],
        [249, 223, 162]],

       [[226, 193, 114],
        [210, 179,  89],
        [206, 174,  89],
        ...,
        [248, 219, 151],
        [249, 221, 158],
        [248, 223, 159]],

       [[209, 181,  71],
        [166, 140,  47],
        [143, 111,  70],
        ...,
        [248, 221, 154],
        [248, 223, 159],
        [246, 222, 158]]], dtype=uint8)]"
Image_1551.jpg,37,83,251,183,800,600,288,266,251,daskShared_local/images/Image_1551.jpg,1551,"[array([[[  2, 154, 203],
        [  4, 153, 203],
        [  5, 154, 204],
        ...,
        [ 23, 180, 228],
        [ 22, 177, 226],
        [ 24, 178, 229]],

       [[  5, 155, 204],
        [  5, 153, 201],
        [  7, 157, 204],
        ...,
        [ 19, 175, 223],
        [ 19, 172, 220],
        [ 25, 177, 226]],

       [[ 15, 166, 213],
        [  9, 158, 206],
        [  6, 154, 201],
        ...,
        [ 19, 174, 223],
        [ 22, 176, 223],
        [ 27, 179, 226]],

       ...,

       [[ 62, 112, 100],
        [ 63, 113, 101],
        [ 65, 115, 106],
        ...,
        [ 65,  24,  23],
        [ 69,  27,  27],
        [ 70,  25,  30]],

       [[ 65, 115, 103],
        [ 63, 113, 103],
        [ 65, 117, 107],
        ...,
        [ 62,  19,  21],
        [ 63,  22,  23],
        [ 62,  20,  23]],

       [[ 64, 114, 102],
        [ 63, 114, 105],
        [ 65, 117, 107],
        ...,
        [ 83,  39,  43],
        [ 90,  50,  53],
        [ 91,  54,  55]]], dtype=uint8)]"
Image_1552.png,372,190,327,275,900,600,699,465,327,daskShared_local/images/Image_1552.png,1552,"[array([[[127, 116,  97],
        [128, 120,  97],
        [116, 111,  99],
        ...,
        [ 22, 150, 183],
        [ 26, 148, 187],
        [ 15, 151, 182]],

       [[140, 124, 101],
        [139, 123,  91],
        [135, 116,  94],
        ...,
        [ 21, 150, 184],
        [ 23, 149, 185],
        [ 20, 151, 187]],

       [[104,  94,  87],
        [115, 104,  83],
        [112,  98,  76],
        ...,
        [ 23, 150, 182],
        [ 33, 149, 180],
        [ 18, 150, 182]],

       ...,

       [[ 27,  72,  66],
        [ 25,  68,  69],
        [ 25,  69,  67],
        ...,
        [ 90, 148, 148],
        [ 96, 150, 146],
        [ 91, 154, 149]],

       [[ 26,  69,  67],
        [ 27,  67,  68],
        [ 24,  69,  65],
        ...,
        [ 83, 145, 149],
        [ 92, 147, 151],
        [ 91, 153, 149]],

       [[ 24,  72,  69],
        [ 21,  70,  62],
        [ 25,  67,  63],
        ...,
        [ 90, 149, 145],
        [ 91, 146, 141],
        [ 88, 149, 140]]], dtype=uint8)]"
Image_1553.jpg,425,153,260,253,1200,822,685,406,260,daskShared_local/images/Image_1553.jpg,1553,"[array([[[  0, 147, 173],
        [  0, 147, 173],
        [  0, 147, 173],
        ...,
        [  0, 164, 191],
        [  1, 165, 192],
        [  2, 166, 193]],

       [[  0, 148, 174],
        [  0, 148, 174],
        [  0, 148, 174],
        ...,
        [  0, 164, 191],
        [  1, 165, 192],
        [  3, 167, 194]],

       [[  0, 149, 174],
        [  0, 150, 175],
        [  0, 150, 175],
        ...,
        [  0, 164, 191],
        [  3, 167, 194],
        [  4, 168, 195]],

       ...,

       [[ 91, 117,  74],
        [ 81, 104,  59],
        [ 73,  96,  49],
        ...,
        [112,  78,   9],
        [142, 107,  22],
        [199, 168,  85]],

       [[ 94, 121,  71],
        [ 91, 116,  64],
        [ 84, 110,  56],
        ...,
        [116,  89,  34],
        [135, 103,  32],
        [166, 131,  55]],

       [[ 81, 104,  53],
        [ 96, 118,  61],
        [ 99, 123,  62],
        ...,
        [110,  88,  49],
        [123,  92,  41],
        [140, 104,  45]]], dtype=uint8)]"
Image_1554.jpg,245,388,849,597,1512,1231,1094,985,849,daskShared_local/images/Image_1554.jpg,1554,"[array([[[ 82, 103, 106],
        [ 82, 102, 107],
        [ 82, 101, 107],
        ...,
        [ 86, 120,  86],
        [ 81, 115,  82],
        [ 78, 110,  79]],

       [[ 77,  95,  93],
        [ 78,  95,  96],
        [ 81,  97,  98],
        ...,
        [ 87, 121,  86],
        [ 83, 117,  83],
        [ 79, 113,  80]],

       [[ 77,  92,  87],
        [ 77,  93,  91],
        [ 78,  94,  92],
        ...,
        [ 91, 125,  90],
        [ 83, 120,  84],
        [ 79, 115,  79]],

       ...,

       [[255, 241, 215],
        [255, 241, 215],
        [255, 241, 215],
        ...,
        [251, 230, 209],
        [249, 228, 208],
        [245, 226, 201]],

       [[255, 241, 215],
        [255, 241, 215],
        [255, 241, 215],
        ...,
        [243, 222, 191],
        [245, 223, 193],
        [246, 226, 197]],

       [[255, 241, 215],
        [255, 241, 215],
        [255, 241, 215],
        ...,
        [242, 218, 183],
        [240, 214, 177],
        [246, 222, 189]]], dtype=uint8)]"
Image_1555.jpg,465,127,281,316,1600,1019,746,443,316,daskShared_local/images/Image_1555.jpg,1555,"[array([[[ 29, 108, 213],
        [ 29, 108, 213],
        [ 29, 108, 213],
        ...,
        [ 28, 116, 213],
        [ 28, 116, 213],
        [ 28, 116, 213]],

       [[ 26, 109, 213],
        [ 26, 109, 213],
        [ 26, 109, 213],
        ...,
        [ 28, 116, 213],
        [ 28, 116, 213],
        [ 28, 116, 213]],

       [[ 26, 109, 213],
        [ 26, 109, 213],
        [ 26, 109, 213],
        ...,
        [ 28, 116, 213],
        [ 28, 116, 213],
        [ 28, 116, 213]],

       ...,

       [[240, 242, 229],
        [245, 246, 233],
        [250, 251, 238],
        ...,
        [ 85,  65,  56],
        [121, 104,  95],
        [151, 137, 128]],

       [[254, 254, 245],
        [255, 255, 246],
        [251, 253, 242],
        ...,
        [ 68,  39,  33],
        [ 92,  62,  56],
        [ 98,  67,  62]],

       [[228, 229, 224],
        [245, 246, 241],
        [254, 255, 249],
        ...,
        [ 75,  39,  35],
        [109,  66,  63],
        [127,  79,  76]]], dtype=uint8)]"
Image_1556.jpg,983,140,259,336,1686,1216,1242,476,336,daskShared_local/images/Image_1556.jpg,1556,"[array([[[127, 184, 214],
        [127, 184, 214],
        [127, 184, 214],
        ...,
        [161, 201, 226],
        [161, 201, 226],
        [161, 201, 226]],

       [[126, 183, 213],
        [125, 182, 212],
        [124, 181, 211],
        ...,
        [160, 200, 225],
        [160, 200, 225],
        [161, 201, 226]],

       [[123, 181, 211],
        [125, 183, 213],
        [122, 181, 211],
        ...,
        [159, 201, 225],
        [159, 201, 225],
        [160, 201, 226]],

       ...,

       [[101, 122, 106],
        [ 67,  88,  69],
        [ 76, 100,  77],
        ...,
        [ 85, 165, 202],
        [ 82, 162, 199],
        [ 82, 162, 199]],

       [[136, 153, 137],
        [ 78,  97,  78],
        [ 58,  81,  60],
        ...,
        [ 85, 165, 202],
        [ 84, 164, 201],
        [ 80, 160, 197]],

       [[183, 195, 176],
        [143, 157, 137],
        [115, 134, 113],
        ...,
        [ 83, 163, 200],
        [ 83, 163, 200],
        [ 83, 164, 201]]], dtype=uint8)]"
Image_1557.jpg,423,159,803,644,1500,1000,1226,803,803,daskShared_local/images/Image_1557.jpg,1557,"[array([[[  3,  55,  66],
        [  3,  55,  66],
        [  2,  54,  65],
        ...,
        [173, 161, 168],
        [181, 170, 176],
        [183, 173, 181]],

       [[  3,  55,  66],
        [  3,  55,  66],
        [  2,  54,  65],
        ...,
        [173, 163, 171],
        [180, 172, 180],
        [181, 173, 184]],

       [[  3,  56,  66],
        [  3,  55,  66],
        [  2,  54,  65],
        ...,
        [171, 162, 175],
        [177, 169, 183],
        [177, 169, 184]],

       ...,

       [[134, 143, 168],
        [123, 137, 174],
        [148, 164, 193],
        ...,
        [ 36,  63,  41],
        [ 40,  66,  44],
        [ 46,  73,  49]],

       [[169, 174, 179],
        [148, 155, 174],
        [138, 152, 183],
        ...,
        [ 37,  64,  42],
        [ 40,  65,  43],
        [ 46,  72,  49]],

       [[188, 190, 195],
        [173, 176, 185],
        [147, 155, 182],
        ...,
        [ 37,  64,  42],
        [ 40,  65,  43],
        [ 47,  73,  49]]], dtype=uint8)]"
Image_1558.jpg,362,130,227,183,1280,720,589,313,227,daskShared_local/images/Image_1558.jpg,1558,"[array([[[ 12, 108, 195],
        [ 17, 113, 200],
        [ 20, 116, 203],
        ...,
        [ 26, 148, 223],
        [ 23, 145, 220],
        [ 16, 138, 213]],

       [[ 11, 107, 194],
        [ 14, 110, 197],
        [ 19, 115, 202],
        ...,
        [ 18, 140, 215],
        [ 17, 139, 214],
        [ 15, 137, 212]],

       [[ 15, 111, 198],
        [ 14, 110, 197],
        [ 13, 109, 196],
        ...,
        [ 13, 135, 210],
        [ 13, 135, 210],
        [ 14, 136, 211]],

       ...,

       [[ 15,  80, 172],
        [ 10,  75, 167],
        [ 10,  75, 167],
        ...,
        [ 35,  31,  14],
        [ 54,  49,  25],
        [124, 118,  82]],

       [[ 13,  78, 170],
        [ 11,  76, 168],
        [ 14,  79, 171],
        ...,
        [ 61,  55,  42],
        [148, 142, 116],
        [208, 200, 169]],

       [[ 15,  80, 172],
        [ 14,  79, 171],
        [ 17,  82, 174],
        ...,
        [168, 160, 145],
        [208, 198, 178],
        [184, 173, 148]]], dtype=uint8)]"
Image_1559.jpg,605,223,152,112,1000,667,757,335,152,daskShared_local/images/Image_1559.jpg,1559,"[array([[[  0, 120, 146],
        [  0, 119, 145],
        [  2, 121, 147],
        ...,
        [  1,  67,  81],
        [  1,  74,  88],
        [  2,  79,  94]],

       [[  0, 124, 149],
        [  0, 122, 147],
        [  2, 122, 147],
        ...,
        [  4,  77,  89],
        [  4,  81,  94],
        [  5,  84,  97]],

       [[  0, 132, 156],
        [  0, 128, 152],
        [  1, 125, 149],
        ...,
        [ 19,  97, 108],
        [ 17,  97, 109],
        [ 15,  96, 108]],

       ...,

       [[106, 114,  97],
        [104, 113,  95],
        [123, 132, 113],
        ...,
        [ 26,  44,  52],
        [ 18,  33,  41],
        [ 14,  26,  35]],

       [[110, 119, 102],
        [101, 110,  91],
        [103, 112,  93],
        ...,
        [ 21,  35,  43],
        [ 15,  26,  35],
        [ 11,  21,  30]],

       [[105, 114,  97],
        [104, 113,  95],
        [103, 112,  93],
        ...,
        [ 19,  29,  38],
        [ 14,  22,  32],
        [ 11,  18,  28]]], dtype=uint8)]"
Image_156.jpg,329,137,269,220,845,563,598,357,269,daskShared_local/images/Image_156.jpg,156,"[array([[[119, 206, 212],
        [137, 211, 218],
        [158, 219, 229],
        ...,
        [ 78, 194, 191],
        [ 82, 196, 194],
        [ 86, 198, 196]],

       [[118, 209, 215],
        [133, 213, 219],
        [152, 220, 228],
        ...,
        [ 73, 194, 192],
        [ 78, 197, 195],
        [ 82, 198, 196]],

       [[109, 207, 212],
        [122, 210, 215],
        [137, 216, 221],
        ...,
        [ 72, 196, 194],
        [ 76, 198, 196],
        [ 79, 198, 196]],

       ...,

       [[ 68, 117,  51],
        [ 69, 115,  51],
        [ 72, 114,  50],
        ...,
        [ 51, 196, 193],
        [ 42, 193, 189],
        [ 35, 189, 185]],

       [[ 58, 112,  51],
        [ 62, 109,  50],
        [ 66, 105,  49],
        ...,
        [ 56, 198, 193],
        [ 51, 196, 192],
        [ 46, 193, 190]],

       [[ 60, 106,  45],
        [ 59, 102,  42],
        [ 57,  98,  37],
        ...,
        [ 60, 200, 191],
        [ 60, 200, 192],
        [ 58, 198, 193]]], dtype=uint8)]"
Image_1560.jpg,446,267,171,178,850,567,617,445,178,daskShared_local/images/Image_1560.jpg,1560,"[array([[[ 43,  32,  32],
        [ 32,  25,  23],
        [ 53,  38,  36],
        ...,
        [160, 152, 147],
        [127, 126, 147],
        [122, 120, 134]],

       [[ 41,  36,  35],
        [ 35,  29,  32],
        [ 54,  39,  43],
        ...,
        [ 74,  75,  95],
        [ 57,  67,  93],
        [ 84,  86, 101]],

       [[ 43,  35,  35],
        [ 44,  35,  38],
        [ 55,  36,  42],
        ...,
        [ 41,  52,  90],
        [ 28,  49,  77],
        [ 40,  45,  73]],

       ...,

       [[  8, 123, 232],
        [  7, 122, 231],
        [  9, 124, 233],
        ...,
        [ 11, 129, 234],
        [  9, 128, 233],
        [ 10, 129, 233]],

       [[ 10, 125, 234],
        [  8, 123, 232],
        [  9, 124, 233],
        ...,
        [ 11, 129, 235],
        [ 10, 128, 234],
        [ 10, 128, 234]],

       [[ 11, 126, 235],
        [  9, 124, 233],
        [  8, 123, 232],
        ...,
        [  9, 127, 233],
        [ 10, 128, 234],
        [ 10, 128, 234]]], dtype=uint8)]"
Image_1561.jpg,2418,899,629,549,3840,2160,3047,1448,629,daskShared_local/images/Image_1561.jpg,1561,"[array([[[ 99,  82,  65],
        [111,  94,  79],
        [142, 127, 112],
        ...,
        [  1, 129, 174],
        [  0, 130, 174],
        [  0, 130, 174]],

       [[ 97,  79,  62],
        [125, 108,  92],
        [139, 122, 108],
        ...,
        [  1, 130, 174],
        [  0, 131, 175],
        [  0, 131, 174]],

       [[ 84,  64,  49],
        [108,  90,  75],
        [145, 125, 113],
        ...,
        [  2, 131, 175],
        [  0, 133, 176],
        [  0, 133, 176]],

       ...,

       [[  7, 140, 170],
        [  4, 135, 166],
        [  3, 131, 163],
        ...,
        [  0, 121, 166],
        [  2, 120, 168],
        [  2, 120, 168]],

       [[  1, 130, 161],
        [  1, 128, 160],
        [  1, 125, 159],
        ...,
        [  1, 121, 166],
        [  3, 121, 168],
        [  3, 121, 168]],

       [[  0, 129, 160],
        [  2, 129, 162],
        [  3, 127, 161],
        ...,
        [  1, 121, 166],
        [  3, 121, 167],
        [  3, 121, 167]]], dtype=uint8)]"
Image_1562.jpg,658,288,300,330,1600,1000,958,618,330,daskShared_local/images/Image_1562.jpg,1562,"[array([[[  0,  71, 163],
        [  0,  71, 163],
        [  0,  71, 163],
        ...,
        [  1,  68, 159],
        [  1,  68, 159],
        [  1,  68, 159]],

       [[  0,  71, 163],
        [  0,  71, 163],
        [  0,  71, 163],
        ...,
        [  1,  68, 159],
        [  1,  68, 159],
        [  1,  68, 159]],

       [[  1,  70, 163],
        [  0,  70, 162],
        [  0,  69, 162],
        ...,
        [  1,  68, 159],
        [  1,  68, 159],
        [  1,  68, 159]],

       ...,

       [[ 26,  38,  23],
        [ 27,  44,  27],
        [ 43,  53,  39],
        ...,
        [149, 136,  99],
        [160, 149, 112],
        [134, 123,  86]],

       [[ 28,  40,  23],
        [ 50,  67,  49],
        [ 79,  89,  77],
        ...,
        [159, 149, 108],
        [183, 179, 132],
        [155, 148, 101]],

       [[ 56,  69,  50],
        [ 73,  90,  69],
        [ 71,  81,  66],
        ...,
        [122, 115,  77],
        [147, 145, 103],
        [139, 135,  90]]], dtype=uint8)]"
Image_1563.png,364,59,193,142,600,600,557,201,193,daskShared_local/images/Image_1563.png,1563,"[array([[[  0, 100, 248],
        [  0, 100, 248],
        [  0, 100, 248],
        ...,
        [  0, 118, 254],
        [  0, 118, 254],
        [  0, 118, 254]],

       [[  0, 100, 248],
        [  0, 100, 248],
        [  1, 101, 249],
        ...,
        [  0, 118, 254],
        [  0, 118, 254],
        [  0, 118, 254]],

       [[  0, 102, 249],
        [  0, 102, 249],
        [  0, 102, 249],
        ...,
        [  0, 118, 254],
        [  0, 118, 254],
        [  0, 118, 254]],

       ...,

       [[234, 247, 191],
        [160, 172, 197],
        [141, 100,  55],
        ...,
        [239, 244, 193],
        [244, 247, 197],
        [247, 250, 179]],

       [[183, 158, 102],
        [167, 162,  99],
        [179, 166,  95],
        ...,
        [242, 249, 193],
        [244, 253, 174],
        [245, 253, 171]],

       [[203, 177, 116],
        [199, 189, 115],
        [211, 204, 148],
        ...,
        [238, 250, 174],
        [238, 249, 171],
        [244, 250, 189]]], dtype=uint8)]"
Image_1564.jpg,217,213,143,156,800,600,360,369,156,daskShared_local/images/Image_1564.jpg,1564,"[array([[[ 68, 187, 209],
        [ 67, 186, 208],
        [ 67, 186, 208],
        ...,
        [ 23, 165, 195],
        [ 21, 165, 195],
        [ 20, 165, 196]],

       [[ 67, 187, 208],
        [ 66, 186, 208],
        [ 65, 186, 207],
        ...,
        [ 22, 166, 196],
        [ 21, 165, 196],
        [ 20, 164, 195]],

       [[ 65, 186, 207],
        [ 65, 186, 207],
        [ 64, 185, 206],
        ...,
        [ 19, 166, 195],
        [ 18, 165, 195],
        [ 17, 164, 194]],

       ...,

       [[ 31, 122, 105],
        [ 28, 118, 101],
        [ 27, 116, 101],
        ...,
        [223, 188, 108],
        [214, 180,  86],
        [220, 187, 108]],

       [[ 30, 122, 105],
        [ 27, 119, 102],
        [ 25, 115, 100],
        ...,
        [221, 186,  94],
        [211, 179,  74],
        [219, 186, 102]],

       [[ 29, 122, 104],
        [ 25, 120, 103],
        [ 21, 115, 100],
        ...,
        [218, 184,  87],
        [212, 180,  68],
        [222, 190,  96]]], dtype=uint8)]"
Image_1565.jpg,605,314,200,167,1400,933,805,481,200,daskShared_local/images/Image_1565.jpg,1565,"[array([[[  0, 171, 227],
        [  0, 171, 227],
        [  0, 171, 227],
        ...,
        [  0, 207, 249],
        [  0, 206, 248],
        [  0, 205, 247]],

       [[  0, 171, 227],
        [  0, 171, 227],
        [  0, 171, 227],
        ...,
        [  0, 206, 246],
        [  0, 205, 245],
        [  0, 205, 245]],

       [[  0, 171, 227],
        [  0, 171, 227],
        [  0, 171, 227],
        ...,
        [  0, 205, 245],
        [  0, 205, 245],
        [  0, 206, 246]],

       ...,

       [[191, 165, 135],
        [142, 130,  83],
        [ 84,  86,  43],
        ...,
        [  1, 182, 235],
        [  1, 181, 234],
        [  1, 181, 234]],

       [[ 94,  61,  41],
        [100,  72,  57],
        [217, 190, 178],
        ...,
        [  0, 181, 234],
        [  0, 181, 234],
        [  0, 180, 233]],

       [[ 97,  66,  46],
        [104,  77,  58],
        [195, 168, 151],
        ...,
        [  0, 181, 234],
        [  0, 181, 234],
        [  0, 180, 233]]], dtype=uint8)]"
Image_1566.jpg,233,453,141,180,2015,1510,374,633,180,daskShared_local/images/Image_1566.jpg,1566,"[array([[[ 42,  38,  37],
        [ 36,  32,  31],
        [ 62,  58,  57],
        ...,
        [ 19,  15,  12],
        [ 17,  13,  10],
        [ 16,  12,   9]],

       [[ 22,  20,  18],
        [ 26,  22,  21],
        [ 42,  38,  37],
        ...,
        [ 18,  14,  11],
        [ 16,  12,   9],
        [ 16,  12,   9]],

       [[  5,   4,   4],
        [ 17,  13,  12],
        [ 19,  15,  14],
        ...,
        [ 16,  11,   8],
        [ 14,  11,   8],
        [ 14,  12,   8]],

       ...,

       [[ 98,  90,  77],
        [104,  96,  83],
        [111, 102,  89],
        ...,
        [154, 162, 165],
        [150, 155, 159],
        [153, 158, 162]],

       [[ 97,  89,  76],
        [101,  93,  80],
        [109,  99,  87],
        ...,
        [148, 155, 158],
        [148, 153, 156],
        [144, 149, 152]],

       [[ 92,  84,  71],
        [ 91,  83,  70],
        [ 97,  87,  75],
        ...,
        [146, 154, 156],
        [143, 148, 151],
        [136, 141, 144]]], dtype=uint8)]"
Image_1567.jpg,905,454,732,510,3008,2000,1637,964,732,daskShared_local/images/Image_1567.jpg,1567,"[array([[[148, 187, 194],
        [148, 187, 194],
        [148, 187, 194],
        ...,
        [128, 176, 190],
        [128, 176, 190],
        [128, 176, 190]],

       [[148, 187, 194],
        [148, 187, 194],
        [148, 187, 194],
        ...,
        [128, 176, 190],
        [128, 176, 190],
        [128, 176, 190]],

       [[148, 187, 194],
        [148, 187, 194],
        [148, 187, 194],
        ...,
        [128, 176, 190],
        [128, 176, 190],
        [128, 176, 190]],

       ...,

       [[109, 168, 174],
        [110, 168, 174],
        [115, 168, 176],
        ...,
        [ 54,  67,  73],
        [ 50,  61,  68],
        [ 49,  58,  65]],

       [[109, 168, 174],
        [110, 168, 174],
        [115, 168, 176],
        ...,
        [ 49,  62,  68],
        [ 44,  56,  62],
        [ 38,  47,  54]],

       [[111, 169, 179],
        [111, 169, 178],
        [115, 168, 176],
        ...,
        [ 45,  55,  62],
        [ 46,  56,  63],
        [ 43,  52,  59]]], dtype=uint8)]"
Image_1568.jpg,401,1021,851,565,4601,3200,1252,1586,851,daskShared_local/images/Image_1568.jpg,1568,"[array([[[ 31, 155, 240],
        [ 38, 164, 247],
        [ 35, 162, 240],
        ...,
        [ 47, 160, 234],
        [ 48, 159, 231],
        [ 50, 162, 233]],

       [[ 32, 156, 241],
        [ 37, 170, 245],
        [ 34, 166, 241],
        ...,
        [ 51, 157, 242],
        [ 52, 158, 241],
        [ 54, 164, 241]],

       [[ 37, 153, 236],
        [ 42, 166, 240],
        [ 37, 163, 237],
        ...,
        [ 51, 161, 236],
        [ 48, 157, 232],
        [ 49, 155, 229]],

       ...,

       [[ 23, 154, 221],
        [ 23, 152, 219],
        [ 20, 151, 217],
        ...,
        [ 43, 153, 213],
        [ 44, 153, 211],
        [ 46, 152, 210]],

       [[ 21, 152, 220],
        [ 21, 151, 218],
        [ 22, 152, 219],
        ...,
        [ 44, 149, 199],
        [ 47, 158, 205],
        [ 51, 157, 208]],

       [[ 23, 155, 220],
        [ 24, 156, 218],
        [ 23, 159, 220],
        ...,
        [ 49, 154, 203],
        [ 52, 160, 210],
        [ 49, 156, 206]]], dtype=uint8)]"
Image_1569.jpg,421,0,396,520,1280,720,817,520,520,daskShared_local/images/Image_1569.jpg,1569,"[array([[[159, 228, 240],
        [161, 229, 240],
        [165, 232, 241],
        ...,
        [ 69, 186, 210],
        [ 81, 190, 218],
        [ 71, 184, 211]],

       [[160, 228, 240],
        [161, 228, 239],
        [163, 230, 239],
        ...,
        [ 59, 182, 210],
        [ 39, 180, 205],
        [ 37, 180, 206]],

       [[161, 230, 240],
        [160, 228, 239],
        [161, 228, 237],
        ...,
        [ 32, 176, 205],
        [ 39, 178, 207],
        [ 57, 183, 213]],

       ...,

       [[ 51,  45,  18],
        [ 46,  41,  18],
        [ 47,  42,  24],
        ...,
        [  2,  72,  96],
        [  2,  72,  97],
        [  1,  71,  96]],

       [[102,  87,  45],
        [103,  84,  43],
        [103,  83,  44],
        ...,
        [  2,  72,  97],
        [  1,  71,  96],
        [  1,  71,  96]],

       [[108,  93,  51],
        [113,  93,  51],
        [119,  94,  53],
        ...,
        [  1,  71,  95],
        [  1,  71,  96],
        [  0,  70,  95]]], dtype=uint8)]"
Image_157.jpg,278,168,176,170,800,533,454,338,176,daskShared_local/images/Image_157.jpg,157,"[array([[[246, 226, 216],
        [240, 218, 208],
        [241, 220, 204],
        ...,
        [ 54,  53,  73],
        [ 80,  79,  97],
        [100,  99, 115]],

       [[253, 238, 236],
        [245, 229, 228],
        [246, 226, 219],
        ...,
        [ 21,  20,  38],
        [ 42,  41,  57],
        [ 86,  85, 101]],

       [[245, 234, 240],
        [238, 227, 232],
        [243, 224, 226],
        ...,
        [ 23,  22,  39],
        [ 10,  10,  25],
        [ 29,  28,  43]],

       ...,

       [[136, 100,  83],
        [157, 121, 105],
        [183, 153, 135],
        ...,
        [105,  91,  82],
        [ 98,  84,  75],
        [ 94,  80,  71]],

       [[139, 104,  85],
        [169, 134, 115],
        [190, 159, 142],
        ...,
        [108,  94,  85],
        [ 97,  83,  74],
        [ 95,  81,  72]],

       [[157, 122, 102],
        [180, 145, 125],
        [187, 154, 139],
        ...,
        [112,  98,  89],
        [ 99,  85,  76],
        [101,  87,  78]]], dtype=uint8)]"
Image_1570.jpg,689,185,198,140,1000,600,887,325,198,daskShared_local/images/Image_1570.jpg,1570,"[array([[[  1, 152, 205],
        [  0, 150, 203],
        [  0, 150, 203],
        ...,
        [  1, 141, 200],
        [  2, 142, 201],
        [  3, 143, 202]],

       [[  2, 153, 206],
        [  0, 151, 204],
        [  0, 149, 202],
        ...,
        [  2, 142, 201],
        [  2, 142, 201],
        [  3, 143, 202]],

       [[  3, 154, 207],
        [  2, 153, 206],
        [  1, 152, 205],
        ...,
        [  2, 142, 201],
        [  3, 143, 202],
        [  3, 143, 202]],

       ...,

       [[ 32,  12,   3],
        [ 26,   6,   0],
        [ 37,  16,  11],
        ...,
        [144, 153,  86],
        [137, 137, 125],
        [135, 131, 158]],

       [[ 38,   7,  22],
        [ 23,   0,   0],
        [ 23,   2,   0],
        ...,
        [165, 164, 134],
        [153, 151, 128],
        [135, 133, 110]],

       [[ 21,   0,   1],
        [ 27,   4,   0],
        [ 26,   8,   0],
        ...,
        [189, 187, 166],
        [175, 172, 155],
        [173, 170, 151]]], dtype=uint8)]"
Image_1571.jpg,382,343,315,202,1904,803,697,545,315,daskShared_local/images/Image_1571.jpg,1571,"[array([[[  0,  52, 105],
        [  0,  51, 105],
        [  0,  51, 105],
        ...,
        [ 34, 144, 128],
        [ 27, 142, 129],
        [ 36, 152, 143]],

       [[  0,  49, 105],
        [  0,  49, 105],
        [  0,  49, 105],
        ...,
        [ 42, 151, 139],
        [ 30, 156, 140],
        [ 28, 163, 147]],

       [[  0,  49, 105],
        [  0,  49, 105],
        [  0,  49, 105],
        ...,
        [ 58, 167, 155],
        [ 51, 172, 157],
        [ 44, 168, 155]],

       ...,

       [[ 28,   0,  36],
        [  6,   0,  24],
        [  7,   6,  29],
        ...,
        [  8,  93, 115],
        [ 14, 107, 124],
        [ 13, 106, 121]],

       [[  7,   2,   3],
        [ 10,   0,  26],
        [ 15,   6,  35],
        ...,
        [ 14, 104, 120],
        [ 21, 115, 127],
        [ 21, 114, 124]],

       [[  1,  27,   0],
        [  4,   3,  19],
        [  9,   1,  26],
        ...,
        [ 10, 101, 110],
        [ 10, 100, 108],
        [ 11,  99, 107]]], dtype=uint8)]"
Image_1572.jpg,215,40,208,174,900,521,423,214,208,daskShared_local/images/Image_1572.jpg,1572,"[array([[[ 17,  59, 171],
        [ 18,  60, 172],
        [ 17,  59, 171],
        ...,
        [ 32,  69, 184],
        [ 32,  69, 184],
        [ 32,  69, 184]],

       [[ 16,  58, 170],
        [ 16,  58, 170],
        [ 16,  58, 170],
        ...,
        [ 32,  69, 184],
        [ 32,  69, 184],
        [ 33,  70, 185]],

       [[ 16,  58, 170],
        [ 16,  58, 170],
        [ 16,  58, 170],
        ...,
        [ 32,  69, 184],
        [ 32,  69, 184],
        [ 33,  70, 185]],

       ...,

       [[  2,  54, 140],
        [  0,  54, 142],
        [  0,  54, 142],
        ...,
        [210, 226, 223],
        [195, 211, 210],
        [174, 190, 189]],

       [[  0,  54, 140],
        [  0,  54, 142],
        [  0,  54, 142],
        ...,
        [221, 237, 234],
        [208, 224, 223],
        [187, 203, 202]],

       [[  0,  54, 140],
        [  0,  54, 142],
        [  0,  54, 142],
        ...,
        [220, 236, 233],
        [208, 224, 223],
        [192, 208, 207]]], dtype=uint8)]"
Image_1573.jpg,104,263,169,114,900,600,273,377,169,daskShared_local/images/Image_1573.jpg,1573,"[array([[[  0,  80,  84],
        [  2,  83,  89],
        [  1,  81,  87],
        ...,
        [  0,  94, 108],
        [  1,  95, 108],
        [  0,  95, 110]],

       [[  0,  83,  85],
        [  3,  84,  88],
        [  2,  81,  85],
        ...,
        [  0,  93, 107],
        [  0,  95, 107],
        [  0,  96, 111]],

       [[  0,  81,  86],
        [  2,  81,  86],
        [  2,  78,  84],
        ...,
        [  0,  93, 107],
        [  0,  94, 107],
        [  1,  92, 109]],

       ...,

       [[  0,  67,  76],
        [  0,  67,  76],
        [  0,  67,  76],
        ...,
        [ 16,  49,  44],
        [ 17,  50,  44],
        [ 21,  53,  46]],

       [[  2,  70,  79],
        [  1,  69,  78],
        [  0,  68,  77],
        ...,
        [ 16,  51,  47],
        [ 17,  52,  48],
        [ 21,  56,  49]],

       [[  4,  72,  81],
        [  3,  71,  80],
        [  2,  70,  79],
        ...,
        [ 16,  52,  48],
        [ 17,  54,  49],
        [ 17,  57,  49]]], dtype=uint8)]"
Image_1574.jpg,517,85,140,184,1200,630,657,269,184,daskShared_local/images/Image_1574.jpg,1574,"[array([[[  1, 154, 221],
        [  3, 155, 222],
        [  3, 155, 222],
        ...,
        [  2, 154, 221],
        [  2, 154, 221],
        [  2, 154, 221]],

       [[  1, 154, 221],
        [  3, 155, 222],
        [  3, 155, 222],
        ...,
        [  2, 154, 221],
        [  2, 154, 221],
        [  2, 154, 221]],

       [[  1, 154, 221],
        [  3, 155, 222],
        [  3, 155, 222],
        ...,
        [  2, 154, 221],
        [  2, 154, 221],
        [  2, 154, 221]],

       ...,

       [[ 30,  21,  18],
        [ 41,  25,  24],
        [ 36,  20,  20],
        ...,
        [  3,  85, 123],
        [  0,  81, 119],
        [  0,  80, 118]],

       [[ 25,  18,  12],
        [ 35,  20,  19],
        [ 30,  14,  15],
        ...,
        [  0,  81, 119],
        [  0,  80, 118],
        [  0,  81, 119]],

       [[ 25,  18,  12],
        [ 32,  19,  18],
        [ 27,  13,  13],
        ...,
        [  0,  81, 119],
        [  1,  83, 121],
        [  1,  83, 121]]], dtype=uint8)]"
Image_1575.jpg,985,0,2576,2732,4608,3072,3561,2732,2732,daskShared_local/images/Image_1575.jpg,1575,"[array([[[ 45,  49,  51],
        [ 52,  55,  58],
        [ 57,  60,  63],
        ...,
        [176, 170, 124],
        [175, 168, 124],
        [174, 168, 123]],

       [[ 49,  51,  53],
        [ 52,  54,  56],
        [ 53,  55,  57],
        ...,
        [175, 169, 125],
        [175, 168, 123],
        [174, 168, 123]],

       [[ 49,  51,  52],
        [ 51,  52,  53],
        [ 52,  53,  54],
        ...,
        [175, 169, 124],
        [175, 168, 123],
        [174, 168, 123]],

       ...,

       [[102,  85,  56],
        [102,  86,  55],
        [103,  86,  55],
        ...,
        [128, 119,  95],
        [135, 125,  99],
        [144, 130,  95]],

       [[ 98,  81,  50],
        [ 99,  83,  52],
        [100,  83,  53],
        ...,
        [133, 103,  69],
        [129, 112,  87],
        [148, 133,  96]],

       [[ 97,  80,  49],
        [ 97,  80,  50],
        [ 97,  81,  54],
        ...,
        [166, 138,  64],
        [164, 133,  78],
        [158, 137,  95]]], dtype=uint8)]"
Image_1576.jpg,364,25,151,118,550,380,515,143,151,daskShared_local/images/Image_1576.jpg,1576,"[array([[[ 75,  94, 150],
        [ 75,  94, 150],
        [ 75,  94, 150],
        ...,
        [ 72,  87, 146],
        [ 71,  86, 145],
        [ 70,  85, 144]],

       [[ 74,  93, 149],
        [ 74,  93, 149],
        [ 75,  94, 150],
        ...,
        [ 71,  86, 145],
        [ 71,  86, 145],
        [ 71,  86, 145]],

       [[ 74,  93, 149],
        [ 74,  93, 149],
        [ 74,  93, 149],
        ...,
        [ 70,  85, 144],
        [ 71,  86, 145],
        [ 71,  86, 145]],

       ...,

       [[183, 161, 137],
        [155, 135, 110],
        [135, 118,  91],
        ...,
        [ 64,  78, 139],
        [ 64,  78, 139],
        [ 64,  78, 139]],

       [[200, 178, 155],
        [181, 162, 138],
        [163, 146, 122],
        ...,
        [ 64,  78, 139],
        [ 64,  78, 139],
        [ 64,  78, 139]],

       [[199, 178, 155],
        [193, 174, 151],
        [184, 167, 144],
        ...,
        [ 65,  79, 140],
        [ 65,  79, 140],
        [ 64,  78, 139]]], dtype=uint8)]"
Image_1577.jpg,1135,1026,513,426,2592,1944,1648,1452,513,daskShared_local/images/Image_1577.jpg,1577,"[array([[[ 40,  80,  61],
        [ 43,  82,  60],
        [ 45,  82,  60],
        ...,
        [ 25,  90,  80],
        [ 47, 115, 132],
        [ 44, 103, 159]],

       [[ 41,  80,  61],
        [ 43,  82,  61],
        [ 45,  84,  62],
        ...,
        [ 34, 107, 114],
        [ 42, 117, 151],
        [ 43, 111, 167]],

       [[ 42,  81,  62],
        [ 45,  83,  63],
        [ 46,  84,  61],
        ...,
        [ 38, 116, 145],
        [ 37, 117, 166],
        [ 40, 115, 161]],

       ...,

       [[ 38, 121, 165],
        [ 38, 120, 167],
        [ 39, 121, 168],
        ...,
        [ 37, 126, 166],
        [ 42, 126, 169],
        [ 43, 121, 167]],

       [[ 37, 121, 167],
        [ 38, 121, 167],
        [ 38, 122, 168],
        ...,
        [ 37, 125, 165],
        [ 39, 123, 166],
        [ 42, 122, 168]],

       [[ 37, 121, 167],
        [ 37, 121, 167],
        [ 38, 122, 166],
        ...,
        [ 37, 126, 166],
        [ 38, 122, 165],
        [ 39, 121, 165]]], dtype=uint8)]"
Image_1578.jpg,124,158,381,279,1152,768,505,437,381,daskShared_local/images/Image_1578.jpg,1578,"[array([[[193, 240, 231],
        [196, 241, 231],
        [198, 240, 230],
        ...,
        [155, 227, 222],
        [154, 227, 221],
        [152, 226, 221]],

       [[192, 239, 230],
        [195, 240, 230],
        [199, 241, 231],
        ...,
        [151, 226, 221],
        [151, 226, 221],
        [151, 226, 221]],

       [[190, 238, 230],
        [193, 239, 230],
        [197, 241, 231],
        ...,
        [150, 226, 220],
        [149, 226, 220],
        [151, 226, 221]],

       ...,

       [[ 98, 181, 191],
        [ 96, 179, 188],
        [ 91, 177, 185],
        ...,
        [117, 143, 134],
        [124, 151, 137],
        [124, 150, 136]],

       [[ 93, 179, 188],
        [ 88, 177, 185],
        [ 86, 175, 184],
        ...,
        [ 96, 127, 117],
        [123, 149, 136],
        [122, 144, 132]],

       [[ 91, 174, 185],
        [ 84, 173, 183],
        [ 82, 172, 182],
        ...,
        [101, 134, 124],
        [113, 137, 126],
        [129, 147, 136]]], dtype=uint8)]"
Image_1579.jpg,519,87,295,465,1600,900,814,552,465,daskShared_local/images/Image_1579.jpg,1579,"[array([[[  0, 153, 205],
        [  0, 153, 205],
        [  0, 154, 206],
        ...,
        [157, 202, 242],
        [157, 202, 241],
        [157, 202, 243]],

       [[  0, 153, 204],
        [  0, 153, 205],
        [  0, 153, 205],
        ...,
        [155, 200, 241],
        [156, 201, 241],
        [157, 202, 243]],

       [[  0, 154, 204],
        [  0, 154, 204],
        [  0, 154, 206],
        ...,
        [156, 201, 242],
        [156, 201, 242],
        [156, 201, 242]],

       ...,

       [[  0, 138, 201],
        [  0, 138, 201],
        [  0, 138, 201],
        ...,
        [ 85,  90,  60],
        [ 74,  77,  48],
        [ 95,  92,  58]],

       [[  0, 138, 201],
        [  0, 138, 201],
        [  0, 138, 201],
        ...,
        [ 75,  85,  58],
        [ 88,  96,  66],
        [ 94,  95,  61]],

       [[  0, 138, 201],
        [  0, 138, 201],
        [  0, 138, 201],
        ...,
        [ 78,  87,  65],
        [ 88,  96,  69],
        [ 85,  89,  55]]], dtype=uint8)]"
Image_158.jpg,654,123,196,179,1156,650,850,302,196,daskShared_local/images/Image_158.jpg,158,"[array([[[ 79, 173, 207],
        [ 69, 166, 199],
        [ 38, 138, 170],
        ...,
        [ 16, 117, 133],
        [ 21, 127, 141],
        [ 20, 136, 149]],

       [[ 67, 164, 197],
        [ 57, 156, 188],
        [ 50, 153, 184],
        ...,
        [ 81, 178, 194],
        [ 48, 148, 163],
        [ 25, 133, 146]],

       [[ 77, 177, 209],
        [ 72, 175, 206],
        [ 78, 183, 213],
        ...,
        [105, 198, 213],
        [ 87, 176, 192],
        [ 59, 156, 171]],

       ...,

       [[ 83,  82,  52],
        [ 69,  68,  38],
        [ 54,  50,  23],
        ...,
        [ 16, 129, 178],
        [  2, 132, 168],
        [  2, 132, 168]],

       [[ 89,  88,  58],
        [ 74,  73,  42],
        [ 53,  49,  20],
        ...,
        [  0, 117, 165],
        [  0, 132, 170],
        [  0, 132, 170]],

       [[ 82,  81,  51],
        [ 82,  81,  50],
        [ 54,  53,  23],
        ...,
        [  7, 132, 178],
        [  0, 132, 171],
        [  1, 132, 174]]], dtype=uint8)]"
Image_1580.jpg,959,382,215,212,2000,1000,1174,594,215,daskShared_local/images/Image_1580.jpg,1580,"[array([[[202, 182, 141],
        [203, 179, 145],
        [201, 177, 143],
        ...,
        [207, 184, 152],
        [205, 185, 152],
        [206, 185, 154]],

       [[195, 172, 134],
        [196, 172, 138],
        [199, 175, 141],
        ...,
        [210, 187, 153],
        [208, 187, 154],
        [205, 185, 152]],

       [[192, 170, 135],
        [191, 168, 135],
        [195, 172, 138],
        ...,
        [207, 184, 149],
        [209, 185, 149],
        [204, 183, 147]],

       ...,

       [[135, 137, 123],
        [141, 143, 131],
        [143, 144, 134],
        ...,
        [206, 183, 142],
        [210, 184, 144],
        [213, 184, 146]],

       [[159, 162, 146],
        [160, 161, 146],
        [160, 161, 148],
        ...,
        [202, 178, 138],
        [198, 173, 132],
        [189, 161, 122]],

       [[140, 143, 124],
        [144, 145, 127],
        [177, 178, 161],
        ...,
        [197, 172, 132],
        [203, 178, 138],
        [202, 176, 139]]], dtype=uint8)]"
Image_1581.jpg,594,82,217,169,1068,601,811,251,217,daskShared_local/images/Image_1581.jpg,1581,"[array([[[  0,  73, 255],
        [  1,  74, 255],
        [  2,  75, 255],
        ...,
        [  0,  87, 255],
        [  0,  87, 255],
        [  0,  87, 255]],

       [[  0,  75, 255],
        [  1,  76, 255],
        [  1,  76, 255],
        ...,
        [  0,  88, 255],
        [  0,  88, 255],
        [  0,  88, 255]],

       [[  1,  76, 255],
        [  1,  76, 255],
        [  1,  76, 255],
        ...,
        [  0,  88, 255],
        [  0,  88, 255],
        [  0,  88, 255]],

       ...,

       [[217, 208, 201],
        [197, 191, 185],
        [168, 164, 163],
        ...,
        [209, 225, 222],
        [211, 224, 228],
        [210, 220, 232]],

       [[134, 124, 122],
        [169, 165, 162],
        [111, 111, 108],
        ...,
        [209, 228, 222],
        [209, 225, 226],
        [208, 220, 232]],

       [[ 91,  80,  75],
        [ 74,  67,  62],
        [105, 102,  99],
        ...,
        [212, 230, 224],
        [211, 226, 226],
        [209, 219, 229]]], dtype=uint8)]"
Image_1582.jpg,417,149,239,199,1000,667,656,348,239,daskShared_local/images/Image_1582.jpg,1582,"[array([[[ 18, 171, 249],
        [ 26, 173, 250],
        [ 28, 174, 251],
        ...,
        [  0, 140, 220],
        [  0, 139, 221],
        [  0, 139, 220]],

       [[ 16, 171, 250],
        [ 22, 173, 251],
        [ 28, 174, 251],
        ...,
        [  0, 140, 220],
        [  0, 139, 220],
        [  2, 138, 219]],

       [[ 35, 179, 252],
        [ 34, 179, 252],
        [ 35, 179, 252],
        ...,
        [  0, 139, 219],
        [  0, 138, 219],
        [  0, 137, 218]],

       ...,

       [[197, 184, 136],
        [174, 158, 107],
        [149, 128,  81],
        ...,
        [  1,  60, 102],
        [  0,  60, 104],
        [  1,  60, 103]],

       [[197, 184, 139],
        [196, 185, 134],
        [184, 171, 118],
        ...,
        [  1,  60, 101],
        [  1,  60, 102],
        [  2,  59, 102]],

       [[186, 172, 123],
        [200, 192, 144],
        [205, 195, 145],
        ...,
        [  0,  59, 100],
        [  1,  59, 100],
        [  1,  58, 101]]], dtype=uint8)]"
Image_1583.jpg,430,154,719,609,1152,763,1149,763,719,daskShared_local/images/Image_1583.jpg,1583,"[array([[[  0, 179, 235],
        [  0, 179, 235],
        [  0, 179, 235],
        ...,
        [  0, 183, 237],
        [  0, 183, 237],
        [  0, 183, 237]],

       [[  0, 179, 235],
        [  0, 179, 235],
        [  0, 179, 235],
        ...,
        [  0, 184, 238],
        [  0, 183, 237],
        [  0, 183, 237]],

       [[  0, 179, 235],
        [  0, 179, 235],
        [  0, 179, 235],
        ...,
        [  0, 183, 236],
        [  0, 183, 237],
        [  0, 183, 237]],

       ...,

       [[142, 168, 132],
        [143, 169, 134],
        [145, 171, 140],
        ...,
        [186, 195, 169],
        [187, 203, 186],
        [165, 188, 173]],

       [[147, 172, 140],
        [148, 172, 142],
        [149, 174, 147],
        ...,
        [182, 197, 190],
        [166, 189, 180],
        [152, 182, 161]],

       [[153, 176, 147],
        [153, 176, 148],
        [153, 177, 153],
        ...,
        [159, 181, 172],
        [146, 180, 172],
        [130, 167, 156]]], dtype=uint8)]"
Image_1584.jpg,537,237,161,187,990,681,698,424,187,daskShared_local/images/Image_1584.jpg,1584,"[array([[[ 35,  29,  15],
        [ 37,  31,  17],
        [ 39,  33,  19],
        ...,
        [ 21,  21,   5],
        [ 27,  26,   7],
        [ 35,  33,  12]],

       [[ 35,  29,  15],
        [ 37,  31,  17],
        [ 38,  32,  18],
        ...,
        [ 17,  18,   1],
        [ 23,  22,   2],
        [ 32,  30,   7]],

       [[ 36,  30,  16],
        [ 37,  31,  17],
        [ 38,  32,  18],
        ...,
        [ 15,  16,   0],
        [ 22,  21,   1],
        [ 30,  28,   5]],

       ...,

       [[147, 137, 101],
        [142, 134,  95],
        [137, 128,  87],
        ...,
        [ 53,  59,  49],
        [ 55,  61,  51],
        [ 52,  58,  46]],

       [[126, 118,  81],
        [130, 122,  83],
        [130, 123,  81],
        ...,
        [ 48,  54,  44],
        [ 50,  56,  46],
        [ 47,  53,  42]],

       [[121, 116,  78],
        [131, 126,  86],
        [127, 122,  82],
        ...,
        [ 40,  46,  35],
        [ 42,  48,  36],
        [ 41,  47,  35]]], dtype=uint8)]"
Image_1585.jpg,491,166,103,79,660,438,594,245,103,daskShared_local/images/Image_1585.jpg,1585,"[array([[[  7,  28,  69],
        [  7,  28,  69],
        [  8,  29,  70],
        ...,
        [  5,  17,  64],
        [  2,  11,  57],
        [  2,  10,  56]],

       [[  7,  28,  69],
        [  7,  28,  69],
        [  7,  29,  70],
        ...,
        [  5,  18,  65],
        [  2,  11,  57],
        [  2,  11,  56]],

       [[  4,  24,  66],
        [  4,  24,  66],
        [  6,  26,  68],
        ...,
        [  7,  21,  67],
        [  2,  13,  58],
        [  2,  12,  57]],

       ...,

       [[ 56,  68,  83],
        [ 56,  67,  82],
        [ 52,  56,  64],
        ...,
        [ 39,  30,  46],
        [ 45,  34,  52],
        [ 45,  34,  52]],

       [[184, 189, 166],
        [184, 189, 166],
        [184, 185, 164],
        ...,
        [ 40,  30,  46],
        [ 41,  30,  46],
        [ 41,  30,  46]],

       [[194, 199, 173],
        [194, 199, 173],
        [194, 196, 171],
        ...,
        [ 40,  30,  46],
        [ 41,  30,  46],
        [ 41,  30,  46]]], dtype=uint8)]"
Image_1586.jpg,385,161,119,133,900,600,504,294,133,daskShared_local/images/Image_1586.jpg,1586,"[array([[[ 48, 115, 179],
        [ 54, 118, 182],
        [ 65, 124, 188],
        ...,
        [138, 135, 150],
        [129, 130, 147],
        [125, 127, 145]],

       [[ 56, 120, 182],
        [ 58, 122, 184],
        [ 66, 125, 188],
        ...,
        [121, 127, 149],
        [114, 124, 147],
        [112, 122, 146]],

       [[ 67, 128, 188],
        [ 66, 128, 187],
        [ 67, 127, 188],
        ...,
        [ 82, 112, 148],
        [ 80, 111, 147],
        [ 80, 111, 147]],

       ...,

       [[  0,  89, 169],
        [  0,  89, 168],
        [  0,  88, 167],
        ...,
        [139, 103, 116],
        [128,  93, 106],
        [122,  87, 101]],

       [[  0, 102, 177],
        [  0, 101, 176],
        [  0,  98, 174],
        ...,
        [133,  97, 109],
        [127,  91, 103],
        [124,  88, 101]],

       [[  0, 109, 182],
        [  0, 108, 181],
        [  0, 104, 178],
        ...,
        [129,  93, 105],
        [126,  90, 102],
        [126,  90, 102]]], dtype=uint8)]"
Image_1587.jpg,395,130,138,93,759,422,533,223,138,daskShared_local/images/Image_1587.jpg,1587,"[array([[[159, 218, 219],
        [160, 219, 219],
        [159, 221, 220],
        ...,
        [ 10, 126, 139],
        [ 15, 132, 145],
        [ 19, 136, 150]],

       [[159, 218, 219],
        [157, 218, 218],
        [153, 216, 215],
        ...,
        [ 17, 130, 145],
        [ 30, 144, 159],
        [ 40, 154, 170]],

       [[156, 217, 217],
        [151, 214, 213],
        [141, 206, 205],
        ...,
        [ 37, 143, 161],
        [ 59, 167, 185],
        [ 76, 184, 202]],

       ...,

       [[  3, 151, 187],
        [  3, 151, 187],
        [  3, 151, 187],
        ...,
        [  3, 120, 138],
        [  3, 122, 140],
        [  2, 123, 140]],

       [[  3, 151, 187],
        [  3, 151, 187],
        [  3, 151, 187],
        ...,
        [  1, 119, 136],
        [  2, 122, 139],
        [  3, 124, 140]],

       [[  3, 151, 187],
        [  3, 151, 187],
        [  3, 151, 187],
        ...,
        [  1, 119, 136],
        [  3, 124, 139],
        [  4, 126, 142]]], dtype=uint8)]"
Image_1588.jpg,475,159,239,273,981,650,714,432,273,daskShared_local/images/Image_1588.jpg,1588,"[array([[[244, 244, 244],
        [244, 244, 244],
        [244, 244, 244],
        ...,
        [243, 243, 243],
        [243, 243, 243],
        [243, 243, 243]],

       [[244, 244, 244],
        [244, 244, 244],
        [244, 244, 244],
        ...,
        [242, 242, 242],
        [242, 242, 242],
        [242, 242, 242]],

       [[244, 244, 244],
        [244, 244, 244],
        [244, 244, 244],
        ...,
        [242, 242, 242],
        [242, 242, 242],
        [242, 242, 242]],

       ...,

       [[ 24,  91, 169],
        [ 26,  93, 172],
        [ 29,  96, 175],
        ...,
        [ 22,  91, 169],
        [ 22,  89, 168],
        [ 24,  91, 170]],

       [[ 24,  91, 170],
        [ 25,  92, 171],
        [ 27,  94, 173],
        ...,
        [ 24,  92, 173],
        [ 23,  90, 168],
        [ 24,  91, 170]],

       [[ 25,  92, 171],
        [ 25,  92, 171],
        [ 25,  92, 171],
        ...,
        [ 26,  94, 176],
        [ 24,  91, 171],
        [ 24,  91, 170]]], dtype=uint8)]"
Image_1589.jpg,409,314,248,215,1500,1000,657,529,248,daskShared_local/images/Image_1589.jpg,1589,"[array([[[  1, 131, 155],
        [  2, 132, 156],
        [  3, 133, 157],
        ...,
        [  1, 114, 132],
        [  1, 114, 132],
        [  0, 113, 133]],

       [[  0, 131, 153],
        [  0, 133, 155],
        [  1, 134, 157],
        ...,
        [  0, 114, 131],
        [  3, 120, 136],
        [  4, 124, 143]],

       [[  0, 134, 154],
        [  0, 134, 156],
        [  0, 135, 156],
        ...,
        [  0, 118, 130],
        [  7, 129, 142],
        [ 11, 135, 153]],

       ...,

       [[ 79, 122, 105],
        [ 59, 102,  83],
        [ 51,  94,  72],
        ...,
        [104,  70,  11],
        [107,  71,  15],
        [142, 133,  78]],

       [[ 80, 123, 103],
        [ 71, 113,  93],
        [ 53,  96,  75],
        ...,
        [112,  82,  33],
        [ 67,  36,   1],
        [ 64,  50,  15]],

       [[ 88, 128, 109],
        [ 79, 121, 101],
        [ 53,  95,  75],
        ...,
        [160, 135,  85],
        [ 84,  56,  15],
        [ 37,  20,   0]]], dtype=uint8)]"
Image_159.jpg,737,438,442,327,2119,1414,1179,765,442,daskShared_local/images/Image_159.jpg,159,"[array([[[ 99, 156, 186],
        [ 98, 155, 185],
        [102, 159, 189],
        ...,
        [ 80, 142, 170],
        [ 81, 145, 174],
        [ 77, 142, 172]],

       [[100, 159, 189],
        [ 93, 152, 182],
        [ 98, 157, 187],
        ...,
        [ 75, 140, 169],
        [ 82, 148, 177],
        [ 79, 145, 175]],

       [[104, 163, 193],
        [100, 159, 189],
        [ 93, 152, 182],
        ...,
        [ 70, 137, 166],
        [ 80, 147, 176],
        [ 80, 147, 176]],

       ...,

       [[ 87, 177, 201],
        [ 88, 178, 202],
        [ 89, 179, 203],
        ...,
        [237, 246, 231],
        [231, 245, 230],
        [229, 244, 234]],

       [[ 85, 175, 199],
        [ 85, 175, 199],
        [ 85, 175, 199],
        ...,
        [243, 245, 249],
        [233, 237, 243],
        [235, 243, 254]],

       [[ 85, 177, 200],
        [ 85, 176, 199],
        [ 84, 176, 199],
        ...,
        [200, 194, 214],
        [216, 211, 233],
        [223, 223, 249]]], dtype=uint8)]"
Image_1590.jpg,1274,635,197,156,2304,1536,1471,791,197,daskShared_local/images/Image_1590.jpg,1590,"[array([[[  2, 109, 151],
        [  3, 110, 152],
        [  3, 110, 152],
        ...,
        [  3, 118, 149],
        [  2, 117, 148],
        [  0, 114, 148]],

       [[  2, 109, 151],
        [  2, 109, 151],
        [  2, 109, 151],
        ...,
        [  3, 116, 150],
        [  0, 112, 146],
        [  0, 110, 144]],

       [[  0, 107, 149],
        [  0, 107, 151],
        [  0, 107, 151],
        ...,
        [  5, 115, 150],
        [  1, 111, 146],
        [  0, 109, 144]],

       ...,

       [[130, 158, 161],
        [147, 180, 187],
        [165, 202, 208],
        ...,
        [ 26,  25,  56],
        [ 40,  27,  45],
        [ 32,  28,  42]],

       [[185, 211, 208],
        [187, 218, 220],
        [157, 197, 197],
        ...,
        [ 26,  22,  59],
        [ 43,  24,  44],
        [ 38,  26,  40]],

       [[165, 200, 202],
        [141, 182, 188],
        [104, 152, 156],
        ...,
        [ 26,  25,  56],
        [ 36,  25,  41],
        [ 38,  26,  40]]], dtype=uint8)]"
Image_1591.jpg,187,102,385,278,1024,670,572,380,385,daskShared_local/images/Image_1591.jpg,1591,"[array([[[ 31,  41,  48],
        [ 28,  36,  47],
        [ 31,  31,  48],
        ...,
        [ 29,  67,  96],
        [ 37,  62,  92],
        [ 35,  59,  85]],

       [[ 26,  35,  44],
        [ 28,  34,  49],
        [ 21,  27,  46],
        ...,
        [ 12,  58,  88],
        [ 18,  55,  84],
        [ 17,  53,  79]],

       [[ 21,  27,  41],
        [ 22,  27,  46],
        [ 23,  34,  54],
        ...,
        [ 23,  75, 107],
        [ 13,  56,  86],
        [  5,  45,  73]],

       ...,

       [[ 78, 199, 215],
        [ 83, 205, 217],
        [ 72, 204, 206],
        ...,
        [ 47,  82,  67],
        [ 94,  99,  81],
        [154, 143, 125]],

       [[ 59, 172, 206],
        [ 64, 183, 215],
        [ 52, 190, 205],
        ...,
        [152, 148, 113],
        [149, 124,  98],
        [122,  95,  80]],

       [[ 53, 143, 165],
        [ 39, 130, 150],
        [ 57, 141, 171],
        ...,
        [184, 177, 134],
        [234, 216, 169],
        [165, 136,  95]]], dtype=uint8)]"
Image_1592.jpg,251,213,134,161,775,518,385,374,161,daskShared_local/images/Image_1592.jpg,1592,"[array([[[ 59,  67,  28],
        [ 61,  71,  31],
        [ 60,  70,  35],
        ...,
        [129, 107,  88],
        [121, 100,  81],
        [130, 109,  90]],

       [[ 56,  65,  25],
        [ 58,  68,  27],
        [ 56,  66,  33],
        ...,
        [152, 130, 109],
        [149, 127, 107],
        [135, 113,  93]],

       [[ 56,  64,  24],
        [ 58,  67,  26],
        [ 56,  65,  34],
        ...,
        [174, 152, 129],
        [170, 148, 125],
        [149, 127, 104]],

       ...,

       [[ 95,  72,  39],
        [ 96,  74,  40],
        [ 98,  70,  36],
        ...,
        [114,  77,  46],
        [105,  68,  38],
        [ 96,  59,  31]],

       [[ 92,  72,  40],
        [ 96,  76,  44],
        [ 92,  66,  35],
        ...,
        [113,  79,  48],
        [105,  72,  42],
        [ 94,  61,  33]],

       [[ 82,  63,  33],
        [ 88,  69,  38],
        [ 85,  61,  31],
        ...,
        [107,  77,  46],
        [103,  73,  44],
        [ 94,  63,  35]]], dtype=uint8)]"
Image_1593.jpg,312,301,172,135,966,642,484,436,172,daskShared_local/images/Image_1593.jpg,1593,"[array([[[ 13,  91,  66],
        [  6,  90,  68],
        [ 13,  92,  82],
        ...,
        [ 76, 129, 146],
        [ 94, 134, 145],
        [106, 128, 135]],

       [[  3,  79,  62],
        [  8,  91,  76],
        [  9,  90,  89],
        ...,
        [ 76, 129, 124],
        [ 57, 102, 105],
        [ 68,  97, 112]],

       [[ 14,  85,  81],
        [ 10,  90,  92],
        [ 12,  95, 109],
        ...,
        [167, 175, 170],
        [ 93, 122, 125],
        [ 26,  76,  90]],

       ...,

       [[ 23, 196, 207],
        [ 25, 198, 209],
        [ 25, 198, 210],
        ...,
        [ 72, 239, 250],
        [ 71, 237, 249],
        [ 69, 235, 247]],

       [[ 25, 192, 206],
        [ 27, 196, 210],
        [ 27, 198, 210],
        ...,
        [ 72, 237, 249],
        [ 70, 236, 248],
        [ 70, 236, 248]],

       [[ 29, 193, 207],
        [ 31, 198, 212],
        [ 30, 199, 212],
        ...,
        [ 71, 236, 248],
        [ 68, 234, 246],
        [ 69, 235, 247]]], dtype=uint8)]"
Image_1594.jpg,736,347,175,156,1600,1000,911,503,175,daskShared_local/images/Image_1594.jpg,1594,"[array([[[  0,  81, 163],
        [  0,  81, 163],
        [  0,  81, 163],
        ...,
        [  1,  77, 161],
        [  1,  77, 161],
        [  1,  77, 161]],

       [[  0,  81, 163],
        [  0,  81, 163],
        [  0,  81, 163],
        ...,
        [  1,  77, 161],
        [  1,  77, 161],
        [  1,  77, 161]],

       [[  0,  81, 163],
        [  0,  81, 163],
        [  0,  81, 163],
        ...,
        [  1,  77, 161],
        [  1,  77, 161],
        [  1,  77, 161]],

       ...,

       [[108,  83,  44],
        [ 95,  73,  33],
        [108,  86,  46],
        ...,
        [215, 198, 168],
        [235, 223, 198],
        [237, 229, 208]],

       [[201, 166, 114],
        [166, 135,  83],
        [144, 115,  66],
        ...,
        [216, 200, 171],
        [235, 223, 198],
        [235, 226, 205]],

       [[204, 144, 117],
        [176, 122,  94],
        [115,  74,  46],
        ...,
        [238, 219, 200],
        [243, 226, 201],
        [227, 210, 181]]], dtype=uint8)]"
Image_1595.jpg,408,323,135,134,800,600,543,457,135,daskShared_local/images/Image_1595.jpg,1595,"[array([[[227, 205, 163],
        [233, 211, 170],
        [239, 219, 179],
        ...,
        [  5,  92, 102],
        [  4,  90, 100],
        [  3,  89,  99]],

       [[229, 202, 163],
        [234, 208, 170],
        [239, 215, 178],
        ...,
        [  6,  91, 102],
        [  4,  90, 100],
        [  3,  89,  99]],

       [[230, 201, 166],
        [234, 206, 172],
        [236, 210, 177],
        ...,
        [  6,  90, 101],
        [  5,  89, 100],
        [  4,  88,  99]],

       ...,

       [[ 29,  54,  50],
        [ 28,  53,  50],
        [ 27,  52,  49],
        ...,
        [ 39, 113,  71],
        [ 40, 112,  69],
        [ 41, 111,  69]],

       [[ 29,  54,  51],
        [ 28,  53,  50],
        [ 27,  53,  50],
        ...,
        [ 37, 113,  66],
        [ 35, 108,  65],
        [ 35, 107,  65]],

       [[ 28,  54,  51],
        [ 27,  53,  50],
        [ 26,  52,  49],
        ...,
        [ 37, 116,  64],
        [ 33, 110,  64],
        [ 34, 109,  66]]], dtype=uint8)]"
Image_1596.jpg,702,302,498,476,1920,1080,1200,778,498,daskShared_local/images/Image_1596.jpg,1596,"[array([[[ 47,  65,  55],
        [ 45,  65,  53],
        [ 42,  64,  51],
        ...,
        [ 34,  62,  63],
        [ 29,  59,  57],
        [ 46,  73,  71]],

       [[ 45,  65,  53],
        [ 44,  66,  53],
        [ 50,  73,  60],
        ...,
        [ 36,  62,  64],
        [ 32,  65,  63],
        [ 44,  80,  76]],

       [[ 45,  68,  55],
        [ 45,  69,  58],
        [ 50,  73,  62],
        ...,
        [ 33,  66,  65],
        [ 40,  81,  77],
        [ 25,  68,  63]],

       ...,

       [[ 28,  93, 146],
        [ 29,  96, 147],
        [ 28,  95, 147],
        ...,
        [ 27,  39,  37],
        [ 27,  39,  37],
        [ 28,  39,  38]],

       [[ 27,  93, 146],
        [ 27,  95, 142],
        [ 29,  97, 144],
        ...,
        [ 26,  38,  36],
        [ 25,  37,  35],
        [ 24,  38,  38]],

       [[ 28,  93, 146],
        [ 28,  94, 142],
        [ 29,  96, 144],
        ...,
        [ 20,  34,  31],
        [ 24,  39,  36],
        [ 23,  39,  37]]], dtype=uint8)]"
Image_1597.jpg,164,179,176,133,728,500,340,312,176,daskShared_local/images/Image_1597.jpg,1597,"[array([[[  2,  72, 219],
        [  2,  72, 219],
        [  1,  71, 219],
        ...,
        [  0,  78, 225],
        [  0,  79, 224],
        [  0,  79, 224]],

       [[  1,  71, 218],
        [  1,  71, 218],
        [  2,  70, 219],
        ...,
        [  0,  79, 226],
        [  1,  80, 225],
        [  0,  79, 224]],

       [[  1,  71, 218],
        [  2,  70, 219],
        [  2,  69, 219],
        ...,
        [  0,  79, 225],
        [  1,  80, 225],
        [  1,  80, 225]],

       ...,

       [[ 18, 133, 142],
        [ 19, 136, 144],
        [ 20, 137, 148],
        ...,
        [245, 243, 221],
        [227, 212, 173],
        [199, 154, 107]],

       [[ 28, 136, 146],
        [ 25, 138, 145],
        [ 20, 139, 146],
        ...,
        [235, 230, 208],
        [222, 202, 161],
        [212, 171, 107]],

       [[ 35, 143, 155],
        [ 26, 140, 147],
        [ 20, 140, 148],
        ...,
        [230, 208, 176],
        [235, 209, 152],
        [244, 216, 148]]], dtype=uint8)]"
Image_1598.jpg,786,333,172,122,1536,1024,958,455,172,daskShared_local/images/Image_1598.jpg,1598,"[array([[[  0,  17,  27],
        [  3,  20,  30],
        [  1,  19,  29],
        ...,
        [ 44, 124, 213],
        [ 44, 124, 213],
        [ 44, 124, 213]],

       [[  1,  19,  29],
        [  4,  22,  32],
        [  3,  21,  31],
        ...,
        [ 46, 124, 214],
        [ 46, 124, 214],
        [ 46, 124, 214]],

       [[  3,  21,  31],
        [  4,  22,  32],
        [  4,  23,  31],
        ...,
        [ 47, 124, 214],
        [ 47, 124, 214],
        [ 47, 124, 214]],

       ...,

       [[ 39, 112, 168],
        [ 28, 114, 194],
        [ 25, 114, 203],
        ...,
        [  9, 113, 200],
        [ 10, 114, 202],
        [ 11, 116, 204]],

       [[ 28, 112, 171],
        [ 17, 114, 195],
        [ 17, 114, 203],
        ...,
        [ 11, 112, 200],
        [ 12, 113, 201],
        [ 15, 116, 206]],

       [[ 20, 110, 174],
        [ 12, 114, 197],
        [ 13, 116, 205],
        ...,
        [ 13, 111, 200],
        [ 15, 113, 202],
        [ 18, 116, 207]]], dtype=uint8)]"
Image_1599.jpg,1803,2570,521,408,2720,4080,2324,2978,521,daskShared_local/images/Image_1599.jpg,1599,"[array([[[ 72,  58,  47],
        [144, 126, 110],
        [184, 168, 149],
        ...,
        [  4, 130, 196],
        [  9, 134, 200],
        [  3, 125, 192]],

       [[162, 125, 102],
        [192, 151, 121],
        [177, 147, 113],
        ...,
        [  2, 125, 192],
        [  6, 127, 195],
        [  6, 126, 196]],

       [[225, 186, 151],
        [232, 188, 148],
        [208, 173, 135],
        ...,
        [  5, 123, 192],
        [  4, 120, 191],
        [  4, 120, 193]],

       ...,

       [[  1, 112, 186],
        [  2, 112, 186],
        [  6, 115, 189],
        ...,
        [  2, 112, 186],
        [  5, 115, 189],
        [  4, 115, 189]],

       [[  8, 119, 193],
        [  6, 117, 191],
        [  5, 111, 185],
        ...,
        [  6, 118, 192],
        [  7, 117, 191],
        [  4, 115, 189]],

       [[  2, 112, 186],
        [  6, 116, 190],
        [  3, 113, 187],
        ...,
        [  6, 118, 192],
        [  4, 113, 187],
        [  1, 110, 184]]], dtype=uint8)]"
Image_16.jpg,450,236,161,158,900,586,611,394,161,daskShared_local/images/Image_16.jpg,16,"[array([[[191, 231, 231],
        [192, 233, 237],
        [192, 233, 244],
        ...,
        [ 91, 201, 224],
        [ 91, 201, 224],
        [ 92, 202, 225]],

       [[181, 228, 231],
        [181, 225, 231],
        [183, 223, 232],
        ...,
        [ 90, 201, 225],
        [ 90, 201, 225],
        [ 90, 202, 226]],

       [[179, 228, 238],
        [182, 228, 238],
        [186, 228, 237],
        ...,
        [ 87, 200, 224],
        [ 88, 201, 225],
        [ 88, 201, 225]],

       ...,

       [[  0,  49,  41],
        [  0,  48,  40],
        [  7,  57,  51],
        ...,
        [  1, 163, 209],
        [  1, 163, 209],
        [  1, 163, 209]],

       [[  0,  61,  50],
        [  0,  42,  38],
        [  2,  38,  37],
        ...,
        [  1, 163, 209],
        [  1, 163, 209],
        [  1, 163, 209]],

       [[  0,  70,  59],
        [  0,  42,  39],
        [  1,  29,  31],
        ...,
        [  1, 163, 209],
        [  1, 163, 209],
        [  1, 163, 209]]], dtype=uint8)]"
Image_160.jpg,696,671,391,229,2793,2090,1087,900,391,daskShared_local/images/Image_160.jpg,160,"[array([[[  7,  71, 197],
        [  7,  71, 197],
        [  7,  71, 197],
        ...,
        [  3,  67, 190],
        [  3,  67, 190],
        [  3,  67, 190]],

       [[  5,  69, 192],
        [  5,  69, 192],
        [  5,  69, 192],
        ...,
        [  3,  68, 186],
        [  3,  68, 186],
        [  3,  68, 186]],

       [[  5,  69, 192],
        [  5,  69, 192],
        [  5,  69, 192],
        ...,
        [  3,  68, 186],
        [  3,  68, 186],
        [  3,  68, 186]],

       ...,

       [[  3,  50, 154],
        [  3,  50, 154],
        [  3,  50, 154],
        ...,
        [123,  97,  33],
        [191, 168, 103],
        [202, 182, 118]],

       [[  3,  50, 154],
        [  3,  50, 154],
        [  3,  50, 154],
        ...,
        [111,  90,  32],
        [168, 149,  89],
        [178, 161, 101]],

       [[  3,  50, 154],
        [  3,  50, 154],
        [  3,  50, 154],
        ...,
        [131, 113,  57],
        [177, 160, 101],
        [196, 180, 120]]], dtype=uint8)]"
Image_1600.jpg,80,87,115,125,637,450,195,212,125,daskShared_local/images/Image_1600.jpg,1600,"[array([[[  1, 172, 254],
        [  1, 172, 254],
        [  1, 172, 254],
        ...,
        [  1, 172, 254],
        [  1, 171, 254],
        [  2, 171, 255]],

       [[  1, 171, 254],
        [  1, 171, 254],
        [  1, 171, 254],
        ...,
        [  1, 171, 254],
        [  1, 171, 254],
        [  1, 170, 254]],

       [[  1, 170, 253],
        [  1, 170, 253],
        [  1, 170, 253],
        ...,
        [  1, 170, 253],
        [  0, 169, 254],
        [  0, 169, 254]],

       ...,

       [[  0, 155, 243],
        [  0, 156, 244],
        [  0, 160, 245],
        ...,
        [104, 128, 107],
        [106, 131, 112],
        [108, 133, 114]],

       [[  0, 155, 244],
        [  0, 156, 244],
        [  0, 159, 244],
        ...,
        [ 89, 121,  99],
        [ 95, 127, 106],
        [ 98, 131, 110]],

       [[  0, 155, 244],
        [  0, 156, 244],
        [  0, 159, 244],
        ...,
        [ 82, 118,  95],
        [ 90, 126, 103],
        [ 94, 130, 108]]], dtype=uint8)]"
Image_1601.jpg,286,131,101,111,775,518,387,242,111,daskShared_local/images/Image_1601.jpg,1601,"[array([[[ 90, 167, 187],
        [ 90, 167, 187],
        [ 90, 167, 187],
        ...,
        [ 92, 162, 178],
        [ 92, 162, 178],
        [ 92, 162, 178]],

       [[ 89, 166, 186],
        [ 89, 166, 186],
        [ 89, 166, 186],
        ...,
        [ 92, 162, 178],
        [ 91, 161, 177],
        [ 91, 161, 177]],

       [[ 87, 164, 184],
        [ 86, 163, 183],
        [ 85, 162, 182],
        ...,
        [ 90, 162, 177],
        [ 87, 159, 174],
        [ 87, 159, 174]],

       ...,

       [[193, 169, 148],
        [196, 172, 151],
        [208, 185, 166],
        ...,
        [ 64,  41,  33],
        [ 53,  34,  16],
        [ 50,  33,  12]],

       [[173, 149, 127],
        [180, 156, 135],
        [214, 191, 171],
        ...,
        [ 63,  38,  28],
        [ 60,  40,  21],
        [ 59,  40,  19]],

       [[169, 144, 122],
        [177, 153, 131],
        [215, 193, 172],
        ...,
        [ 63,  37,  27],
        [ 61,  41,  22],
        [ 61,  41,  21]]], dtype=uint8)]"
Image_1602.jpg,586,316,191,142,1440,960,777,458,191,daskShared_local/images/Image_1602.jpg,1602,"[array([[[  2, 148, 208],
        [  3, 149, 209],
        [  1, 147, 207],
        ...,
        [  0, 146, 215],
        [  0, 146, 215],
        [  0, 147, 216]],

       [[  3, 149, 209],
        [  4, 150, 210],
        [  4, 150, 210],
        ...,
        [  0, 145, 214],
        [  0, 144, 213],
        [  0, 147, 216]],

       [[  2, 148, 208],
        [  3, 149, 209],
        [  4, 150, 210],
        ...,
        [  1, 145, 215],
        [  0, 144, 214],
        [  1, 148, 217]],

       ...,

       [[ 64,  42,  27],
        [ 56,  32,  18],
        [ 64,  39,  25],
        ...,
        [  6,  76, 115],
        [  0,  77, 112],
        [  0,  74, 110]],

       [[108,  97,  70],
        [109,  97,  71],
        [106,  93,  66],
        ...,
        [  2,  78, 114],
        [  5,  77, 115],
        [  2,  78, 114]],

       [[127, 129,  90],
        [137, 139, 100],
        [149, 149, 113],
        ...,
        [  1,  77, 111],
        [ 10,  76, 116],
        [  0,  74, 111]]], dtype=uint8)]"
Image_1603.jpg,449,152,140,104,1024,512,589,256,140,daskShared_local/images/Image_1603.jpg,1603,"[array([[[  0, 132, 189],
        [  0, 132, 189],
        [  0, 132, 189],
        ...,
        [  2, 173, 216],
        [  3, 174, 217],
        [  3, 174, 217]],

       [[  0, 132, 189],
        [  0, 132, 189],
        [  0, 132, 189],
        ...,
        [  3, 174, 217],
        [  4, 175, 218],
        [  5, 176, 219]],

       [[  0, 132, 189],
        [  0, 132, 189],
        [  0, 132, 189],
        ...,
        [  4, 174, 217],
        [  5, 176, 219],
        [  6, 177, 220]],

       ...,

       [[128,  98,  55],
        [118,  90,  47],
        [115,  91,  49],
        ...,
        [  1, 145, 198],
        [  1, 145, 198],
        [  1, 145, 198]],

       [[129,  98,  51],
        [126,  98,  51],
        [137, 113,  68],
        ...,
        [  1, 145, 198],
        [  1, 145, 198],
        [  1, 145, 198]],

       [[126,  96,  49],
        [129, 101,  56],
        [150, 127,  83],
        ...,
        [  1, 145, 198],
        [  1, 145, 198],
        [  1, 145, 198]]], dtype=uint8)]"
Image_1604.jpg,107,78,95,59,475,264,202,137,95,daskShared_local/images/Image_1604.jpg,1604,"[array([[[22, 39, 54],
        [22, 39, 54],
        [23, 40, 56],
        ...,
        [27, 48, 73],
        [33, 53, 79],
        [32, 53, 79]],

       [[22, 39, 54],
        [22, 39, 54],
        [23, 40, 56],
        ...,
        [27, 48, 73],
        [33, 54, 80],
        [32, 53, 79]],

       [[23, 40, 55],
        [22, 40, 55],
        [24, 41, 57],
        ...,
        [27, 47, 72],
        [32, 52, 77],
        [31, 52, 77]],

       ...,

       [[12, 21, 30],
        [12, 21, 30],
        [13, 22, 31],
        ...,
        [44, 56, 59],
        [46, 57, 61],
        [45, 57, 61]],

       [[12, 21, 30],
        [12, 21, 30],
        [12, 21, 30],
        ...,
        [42, 53, 57],
        [46, 57, 61],
        [45, 57, 61]],

       [[12, 21, 30],
        [12, 21, 30],
        [12, 21, 30],
        ...,
        [42, 53, 57],
        [46, 57, 61],
        [45, 57, 61]]], dtype=uint8)]"
Image_1605.jpg,578,175,186,174,1000,665,764,349,186,daskShared_local/images/Image_1605.jpg,1605,"[array([[[ 32, 132, 200],
        [ 40, 134, 201],
        [ 41, 135, 199],
        ...,
        [ 26, 130, 196],
        [ 32, 132, 197],
        [ 21, 128, 196]],

       [[ 41, 134, 201],
        [ 26, 131, 199],
        [ 26, 132, 200],
        ...,
        [ 19, 129, 196],
        [ 28, 130, 198],
        [ 12, 129, 195]],

       [[ 42, 134, 199],
        [ 42, 134, 200],
        [ 36, 134, 199],
        ...,
        [ 24, 130, 196],
        [ 26, 129, 196],
        [ 23, 130, 198]],

       ...,

       [[ 16,  96, 113],
        [ 11,  96, 117],
        [ 12,  97, 119],
        ...,
        [  2,  78,  88],
        [  2,  76,  85],
        [  2,  78,  86]],

       [[  8,  81,  90],
        [ 11,  85,  98],
        [  5,  83,  99],
        ...,
        [  5,  78,  84],
        [  1,  74,  81],
        [  1,  71,  79]],

       [[  3,  64,  69],
        [ 15,  70,  74],
        [ 22,  79,  88],
        ...,
        [  9,  80,  87],
        [  5,  78,  85],
        [  6,  74,  83]]], dtype=uint8)]"
Image_1606.jpg,791,539,1211,1466,3072,2304,2002,2005,1466,daskShared_local/images/Image_1606.jpg,1606,"[array([[[ 88,  84,  70],
        [ 78,  70,  59],
        [ 73,  64,  56],
        ...,
        [ 96,  71,  78],
        [116,  91, 102],
        [142, 115, 127]],

       [[ 86,  81,  69],
        [ 80,  73,  63],
        [ 76,  67,  61],
        ...,
        [ 70,  47,  55],
        [ 81,  57,  71],
        [104,  81,  98]],

       [[ 82,  76,  66],
        [ 80,  71,  66],
        [ 78,  68,  66],
        ...,
        [ 63,  43,  47],
        [ 68,  46,  54],
        [ 79,  57,  69]],

       ...,

       [[  6, 113, 119],
        [  5, 112, 118],
        [  5, 112, 119],
        ...,
        [ 11,  98, 113],
        [  9,  97, 109],
        [ 10,  95, 110]],

       [[  6, 113, 119],
        [  6, 113, 119],
        [  6, 113, 119],
        ...,
        [ 12,  98, 111],
        [  6,  95, 107],
        [ 10,  94, 112]],

       [[  6, 111, 121],
        [  5, 112, 121],
        [  7, 114, 122],
        ...,
        [ 10,  95, 108],
        [  7,  94, 111],
        [ 14, 100, 118]]], dtype=uint8)]"
Image_1607.jpg,195,333,342,203,1024,768,537,536,342,daskShared_local/images/Image_1607.jpg,1607,"[array([[[161, 232, 243],
        [141, 212, 231],
        [134, 206, 220],
        ...,
        [ 40,  75,  97],
        [ 41,  73,  94],
        [ 60,  91, 112]],

       [[ 99, 157, 179],
        [140, 200, 230],
        [135, 199, 219],
        ...,
        [ 41,  79, 100],
        [ 84, 120, 139],
        [ 70, 102, 123]],

       [[ 51,  97, 131],
        [ 68, 117, 161],
        [116, 170, 201],
        ...,
        [ 58, 100, 119],
        [ 76, 114, 133],
        [ 70, 105, 125]],

       ...,

       [[132, 197, 195],
        [146, 221, 213],
        [142, 222, 209],
        ...,
        [131, 197, 216],
        [130, 185, 213],
        [154, 196, 222]],

       [[137, 203, 198],
        [141, 212, 201],
        [141, 214, 198],
        ...,
        [137, 201, 224],
        [131, 184, 216],
        [120, 161, 189]],

       [[130, 195, 188],
        [132, 196, 183],
        [139, 200, 184],
        ...,
        [ 88, 148, 174],
        [121, 172, 205],
        [126, 165, 197]]], dtype=uint8)]"
Image_1608.jpg,498,142,214,158,800,600,712,300,214,daskShared_local/images/Image_1608.jpg,1608,"[array([[[  0,  28,  56],
        [  3,  41,  64],
        [  8,  45,  65],
        ...,
        [  7,  11,  17],
        [  8,   8,  16],
        [ 12,  11,  19]],

       [[  0,  30,  58],
        [  5,  40,  64],
        [  5,  39,  62],
        ...,
        [  7,   8,  14],
        [  5,   6,  11],
        [  8,   7,  13]],

       [[  2,  31,  59],
        [  5,  36,  62],
        [  2,  32,  56],
        ...,
        [  7,   7,  13],
        [  4,   3,   9],
        [  6,   5,  11]],

       ...,

       [[213, 191, 136],
        [203, 187, 143],
        [196, 187, 152],
        ...,
        [ 29,  29,  27],
        [ 31,  31,  29],
        [ 23,  22,  17]],

       [[206, 182, 123],
        [200, 185, 138],
        [194, 186, 149],
        ...,
        [ 31,  31,  28],
        [ 30,  29,  29],
        [ 28,  27,  25]],

       [[204, 178, 118],
        [199, 184, 134],
        [194, 183, 146],
        ...,
        [ 31,  31,  30],
        [ 30,  28,  31],
        [ 37,  35,  38]]], dtype=uint8)]"
Image_1609.jpg,107,111,398,273,800,533,505,384,398,daskShared_local/images/Image_1609.jpg,1609,"[array([[[ 19,  27,  78],
        [ 31,  42,  96],
        [ 11,  22,  75],
        ...,
        [  8,  17,  71],
        [  6,  18,  71],
        [  6,  19,  72]],

       [[  3,  11,  58],
        [  9,  19,  68],
        [ 29,  42,  94],
        ...,
        [  6,  18,  71],
        [  5,  18,  71],
        [  6,  19,  72]],

       [[  5,  12,  58],
        [  2,   8,  55],
        [  6,  16,  62],
        ...,
        [  5,  18,  71],
        [  6,  19,  71],
        [  7,  19,  72]],

       ...,

       [[ 10,  17,  61],
        [  6,  13,  57],
        [  6,  13,  57],
        ...,
        [ 73,  60,  16],
        [ 95,  83,  37],
        [ 83,  73,  29]],

       [[  8,  15,  58],
        [  7,  14,  58],
        [  7,  15,  59],
        ...,
        [ 89,  77,  32],
        [106,  96,  55],
        [ 95,  87,  48]],

       [[  9,  16,  59],
        [  9,  16,  60],
        [  7,  16,  59],
        ...,
        [ 92,  82,  38],
        [ 96,  89,  49],
        [ 89,  83,  44]]], dtype=uint8)]"
Image_161.png,393,189,304,274,900,600,697,463,304,daskShared_local/images/Image_161.png,161,"[array([[[135, 135, 131],
        [120, 126, 127],
        [106, 116, 119],
        ...,
        [ 21, 149, 178],
        [ 25, 149, 180],
        [ 29, 150, 179]],

       [[125, 121, 113],
        [130, 127, 127],
        [125, 125, 123],
        ...,
        [ 23, 150, 180],
        [ 22, 152, 180],
        [ 26, 151, 181]],

       [[115, 109, 103],
        [129, 125, 121],
        [128, 119, 113],
        ...,
        [ 17, 151, 177],
        [ 23, 149, 182],
        [ 20, 150, 178]],

       ...,

       [[ 69, 115,  80],
        [ 74, 115,  87],
        [ 78, 114,  80],
        ...,
        [ 82, 155, 134],
        [ 92, 160, 131],
        [ 88, 161, 143]],

       [[ 72, 119,  77],
        [ 69, 118,  84],
        [ 59, 115,  80],
        ...,
        [ 84, 153, 135],
        [ 80, 158, 137],
        [ 82, 159, 141]],

       [[ 48, 107,  90],
        [ 41,  89,  84],
        [ 27,  75,  71],
        ...,
        [ 81, 153, 139],
        [ 79, 157, 139],
        [ 82, 151, 136]]], dtype=uint8)]"
Image_1610.jpg,124,394,413,265,1715,1286,537,659,413,daskShared_local/images/Image_1610.jpg,1610,"[array([[[143, 157, 150],
        [137, 153, 147],
        [135, 150, 143],
        ...,
        [ 98,  94,  71],
        [118, 138,  93],
        [125, 149, 112]],

       [[142, 156, 149],
        [140, 155, 149],
        [136, 154, 147],
        ...,
        [125, 129,  88],
        [136, 150, 118],
        [139, 154, 131]],

       [[140, 157, 149],
        [135, 156, 148],
        [134, 156, 149],
        ...,
        [141, 149, 115],
        [154, 155, 138],
        [156, 159, 142]],

       ...,

       [[186, 196, 193],
        [188, 197, 202],
        [188, 196, 207],
        ...,
        [206, 215, 217],
        [204, 213, 215],
        [202, 211, 212]],

       [[185, 196, 198],
        [183, 194, 201],
        [180, 196, 206],
        ...,
        [202, 212, 218],
        [206, 211, 215],
        [204, 207, 214]],

       [[183, 190, 198],
        [182, 190, 198],
        [176, 185, 211],
        ...,
        [203, 204, 222],
        [203, 208, 218],
        [206, 211, 216]]], dtype=uint8)]"
Image_1611.jpg,317,294,157,98,1280,720,474,392,157,daskShared_local/images/Image_1611.jpg,1611,"[array([[[  1,  61, 134],
        [  1,  60, 135],
        [  1,  60, 136],
        ...,
        [  0,  62, 139],
        [  0,  62, 139],
        [  0,  62, 139]],

       [[  1,  61, 134],
        [  1,  60, 135],
        [  1,  60, 136],
        ...,
        [  0,  62, 139],
        [  0,  62, 139],
        [  0,  62, 139]],

       [[  1,  60, 134],
        [  1,  60, 135],
        [  1,  60, 136],
        ...,
        [  0,  62, 139],
        [  0,  62, 139],
        [  0,  62, 139]],

       ...,

       [[ 47, 121, 139],
        [ 47, 121, 139],
        [ 47, 121, 139],
        ...,
        [ 30,  48,  46],
        [ 27,  46,  38],
        [ 27,  48,  36]],

       [[ 49, 122, 138],
        [ 49, 122, 138],
        [ 49, 122, 138],
        ...,
        [ 39,  55,  53],
        [ 29,  46,  38],
        [ 26,  45,  33]],

       [[ 50, 123, 138],
        [ 50, 123, 138],
        [ 50, 123, 138],
        ...,
        [ 53,  68,  66],
        [ 40,  56,  49],
        [ 34,  52,  40]]], dtype=uint8)]"
Image_1612.jpg,328,13,632,535,1190,595,960,548,632,daskShared_local/images/Image_1612.jpg,1612,"[array([[[199, 225, 238],
        [197, 224, 239],
        [196, 223, 237],
        ...,
        [201, 214, 207],
        [201, 213, 207],
        [201, 212, 206]],

       [[195, 222, 236],
        [193, 222, 237],
        [191, 220, 236],
        ...,
        [201, 214, 207],
        [201, 212, 205],
        [201, 212, 206]],

       [[204, 228, 238],
        [197, 222, 233],
        [193, 219, 233],
        ...,
        [201, 214, 206],
        [201, 213, 204],
        [200, 212, 206]],

       ...,

       [[190,  47, 102],
        [191,  58, 110],
        [190,  52, 104],
        ...,
        [160, 154, 137],
        [182, 187, 174],
        [184, 194, 182]],

       [[183,  36,  89],
        [193,  57, 109],
        [204,  58, 113],
        ...,
        [184, 190, 180],
        [185, 193, 186],
        [181, 192, 183]],

       [[161,  26,  74],
        [184,  47,  99],
        [200,  52, 107],
        ...,
        [185, 196, 186],
        [182, 193, 186],
        [179, 190, 182]]], dtype=uint8)]"
Image_1613.jpg,1627,520,919,732,4100,2660,2546,1252,919,daskShared_local/images/Image_1613.jpg,1613,"[array([[[189, 176, 161],
        [189, 176, 161],
        [188, 175, 161],
        ...,
        [131, 124, 110],
        [131, 124, 108],
        [127, 120, 104]],

       [[191, 178, 163],
        [193, 180, 168],
        [193, 181, 167],
        ...,
        [130, 123, 106],
        [130, 123, 107],
        [129, 122, 105]],

       [[189, 176, 160],
        [192, 179, 170],
        [191, 179, 166],
        ...,
        [133, 126, 110],
        [132, 125, 110],
        [129, 121, 105]],

       ...,

       [[173, 162, 146],
        [174, 160, 144],
        [176, 163, 150],
        ...,
        [123, 101,  67],
        [118,  95,  55],
        [122, 100,  58]],

       [[169, 156, 142],
        [173, 159, 144],
        [172, 158, 147],
        ...,
        [131, 115,  85],
        [120, 101,  60],
        [120, 100,  61]],

       [[174, 161, 148],
        [173, 159, 146],
        [174, 161, 149],
        ...,
        [129, 109,  74],
        [122, 103,  67],
        [121, 101,  67]]], dtype=uint8)]"
Image_1614.jpg,316,122,217,198,770,422,533,320,217,daskShared_local/images/Image_1614.jpg,1614,"[array([[[205, 152, 142],
        [231, 177, 166],
        [247, 193, 189],
        ...,
        [ 29, 127, 214],
        [ 31, 127, 216],
        [ 32, 123, 216]],

       [[193, 150, 139],
        [225, 182, 163],
        [237, 192, 174],
        ...,
        [ 44, 142, 228],
        [ 44, 139, 228],
        [ 39, 130, 221]],

       [[203, 161, 133],
        [220, 179, 137],
        [221, 178, 132],
        ...,
        [ 57, 157, 241],
        [ 54, 150, 237],
        [ 44, 135, 226]],

       ...,

       [[ 50,  72,  49],
        [ 55,  77,  54],
        [ 51,  73,  52],
        ...,
        [  2,  14,  33],
        [  2,  18,  38],
        [  3,  20,  40]],

       [[ 55,  77,  54],
        [ 57,  80,  58],
        [ 54,  77,  57],
        ...,
        [  8,  22,  41],
        [  2,  19,  39],
        [  4,  22,  42]],

       [[ 56,  78,  55],
        [ 57,  81,  59],
        [ 55,  78,  58],
        ...,
        [  3,  17,  36],
        [  1,  15,  35],
        [  0,  14,  33]]], dtype=uint8)]"
Image_1615.jpg,430,200,211,194,900,600,641,394,211,daskShared_local/images/Image_1615.jpg,1615,"[array([[[  4, 135, 239],
        [  4, 134, 238],
        [  9, 130, 234],
        ...,
        [  1,  90, 206],
        [  1,  90, 206],
        [  1,  92, 207]],

       [[  3, 134, 238],
        [  3, 134, 237],
        [  7, 130, 233],
        ...,
        [  1,  90, 206],
        [  2,  91, 207],
        [  1,  92, 207]],

       [[  2, 133, 237],
        [  3, 132, 236],
        [  6, 129, 233],
        ...,
        [  2,  91, 207],
        [  2,  91, 207],
        [  1,  92, 207]],

       ...,

       [[176, 165, 125],
        [172, 161, 117],
        [170, 148,  72],
        ...,
        [  2,  57, 165],
        [  0,  55, 169],
        [  0,  53, 166]],

       [[183, 171, 122],
        [198, 185, 133],
        [211, 189, 116],
        ...,
        [  0,  52, 164],
        [  1,  57, 173],
        [  0,  52, 166]],

       [[154, 144,  84],
        [195, 184, 123],
        [203, 180, 118],
        ...,
        [  0,  51, 165],
        [  0,  56, 174],
        [  0,  52, 166]]], dtype=uint8)]"
Image_1616.jpg,106,109,140,121,500,375,246,230,140,daskShared_local/images/Image_1616.jpg,1616,"[array([[[ 92, 157, 174],
        [ 88, 153, 171],
        [ 81, 145, 163],
        ...,
        [ 23,  73, 106],
        [ 23,  73, 106],
        [ 23,  73, 106]],

       [[ 87, 151, 168],
        [ 83, 147, 165],
        [ 76, 140, 158],
        ...,
        [ 25,  75, 107],
        [ 24,  74, 106],
        [ 24,  75, 106]],

       [[ 87, 150, 165],
        [ 83, 146, 162],
        [ 78, 141, 157],
        ...,
        [ 28,  80, 109],
        [ 27,  78, 107],
        [ 26,  78, 107]],

       ...,

       [[ 31, 129, 154],
        [ 32, 130, 155],
        [ 34, 132, 157],
        ...,
        [230, 230, 229],
        [231, 231, 230],
        [230, 230, 229]],

       [[ 28, 125, 150],
        [ 29, 126, 151],
        [ 31, 128, 153],
        ...,
        [227, 226, 224],
        [226, 226, 224],
        [226, 225, 223]],

       [[ 27, 123, 148],
        [ 28, 124, 149],
        [ 30, 126, 151],
        ...,
        [224, 223, 221],
        [224, 223, 221],
        [223, 222, 220]]], dtype=uint8)]"
Image_1617.jpg,328,277,253,222,750,740,581,499,253,daskShared_local/images/Image_1617.jpg,1617,"[array([[[ 63, 231, 248],
        [ 69, 229, 249],
        [ 73, 226, 247],
        ...,
        [ 10, 196, 217],
        [ 11, 194, 215],
        [ 11, 191, 214]],

       [[ 51, 235, 248],
        [ 55, 231, 247],
        [ 58, 224, 243],
        ...,
        [  7, 196, 215],
        [ 10, 194, 214],
        [ 11, 192, 213]],

       [[ 19, 217, 229],
        [ 24, 213, 228],
        [ 30, 210, 227],
        ...,
        [  7, 195, 213],
        [ 10, 195, 213],
        [ 12, 194, 213]],

       ...,

       [[120, 156, 107],
        [119, 153, 109],
        [125, 155, 116],
        ...,
        [136, 183, 190],
        [135, 182, 188],
        [137, 185, 192]],

       [[137, 164, 123],
        [132, 158, 118],
        [130, 156, 116],
        ...,
        [136, 188, 178],
        [133, 185, 177],
        [134, 186, 180]],

       [[144, 181, 135],
        [140, 177, 132],
        [134, 169, 126],
        ...,
        [140, 189, 183],
        [139, 189, 184],
        [134, 184, 180]]], dtype=uint8)]"
Image_1618.jpg,625,436,216,204,1024,672,841,640,216,daskShared_local/images/Image_1618.jpg,1618,"[array([[[105, 104, 112],
        [112, 112, 121],
        [117, 117, 128],
        ...,
        [ 84, 100, 105],
        [ 87, 101, 102],
        [ 88, 100,  98]],

       [[ 93,  95, 100],
        [103, 104, 113],
        [113, 116, 126],
        ...,
        [ 80,  94,  98],
        [ 84,  97,  99],
        [108, 119, 116]],

       [[ 88,  97, 104],
        [ 96, 103, 111],
        [109, 112, 121],
        ...,
        [ 84,  92,  94],
        [ 82,  87,  90],
        [117, 121, 122]],

       ...,

       [[ 37,  84, 139],
        [ 36,  83, 139],
        [ 36,  82, 138],
        ...,
        [  9, 113, 224],
        [  8, 114, 224],
        [  9, 115, 225]],

       [[ 34,  83, 142],
        [ 36,  85, 144],
        [ 37,  86, 145],
        ...,
        [ 10, 114, 225],
        [ 10, 115, 226],
        [ 12, 117, 227]],

       [[ 29,  79, 142],
        [ 34,  83, 146],
        [ 37,  87, 149],
        ...,
        [ 11, 115, 226],
        [ 12, 117, 226],
        [ 16, 121, 230]]], dtype=uint8)]"
Image_1619.jpg,311,109,220,326,1000,667,531,435,326,daskShared_local/images/Image_1619.jpg,1619,"[array([[[216, 208, 204],
        [179, 183, 189],
        [125, 141, 156],
        ...,
        [182, 166, 151],
        [180, 164, 149],
        [170, 154, 139]],

       [[ 69,  94, 119],
        [ 46,  89, 125],
        [ 34,  90, 140],
        ...,
        [213, 195, 181],
        [229, 211, 197],
        [226, 208, 194]],

       [[ 46,  90, 138],
        [ 51,  87, 136],
        [ 72, 102, 139],
        ...,
        [232, 220, 205],
        [236, 221, 203],
        [239, 223, 204]],

       ...,

       [[ 44, 124, 175],
        [ 42, 123, 173],
        [ 40, 123, 173],
        ...,
        [ 32,  26,  16],
        [ 28,  24,  14],
        [ 29,  26,  16]],

       [[ 34, 116, 172],
        [ 33, 115, 171],
        [ 33, 115, 171],
        ...,
        [ 66,  58,  47],
        [ 49,  41,  30],
        [ 35,  27,  16]],

       [[ 29, 111, 167],
        [ 29, 111, 167],
        [ 29, 111, 167],
        ...,
        [ 36,  29,  19],
        [ 30,  23,  13],
        [ 25,  19,   8]]], dtype=uint8)]"
Image_162.jpg,309,213,193,186,1000,600,502,399,193,daskShared_local/images/Image_162.jpg,162,"[array([[[  1, 146, 193],
        [  1, 146, 193],
        [  1, 146, 193],
        ...,
        [  1, 158, 201],
        [  1, 158, 201],
        [  1, 158, 201]],

       [[  1, 146, 193],
        [  1, 146, 193],
        [  1, 146, 193],
        ...,
        [  1, 158, 201],
        [  1, 158, 201],
        [  1, 158, 201]],

       [[  1, 146, 193],
        [  1, 146, 193],
        [  1, 146, 193],
        ...,
        [  1, 158, 201],
        [  1, 158, 201],
        [  1, 158, 201]],

       ...,

       [[ 63,  50,   6],
        [ 19,  25,   9],
        [ 23,  41,  46],
        ...,
        [233, 208, 151],
        [222, 194, 131],
        [218, 187, 119]],

       [[ 66,  50,  14],
        [ 25,  24,  23],
        [ 15,  24,  47],
        ...,
        [234, 205, 144],
        [227, 198, 131],
        [227, 195, 122]],

       [[ 75,  56,  19],
        [ 37,  26,  29],
        [ 18,  17,  46],
        ...,
        [233, 204, 137],
        [233, 201, 128],
        [233, 197, 119]]], dtype=uint8)]"
Image_1620.jpg,384,6,97,69,530,180,481,75,97,daskShared_local/images/Image_1620.jpg,1620,"[array([[[  3,  21,  72],
        [  3,  21,  72],
        [  1,  23,  75],
        ...,
        [ 28,  50,  95],
        [ 16,  37,  80],
        [ 16,  37,  81]],

       [[  3,  21,  74],
        [  3,  21,  74],
        [  1,  23,  77],
        ...,
        [ 31,  53,  96],
        [ 16,  36,  79],
        [ 16,  36,  80]],

       [[  1,  20,  63],
        [  1,  20,  63],
        [  1,  22,  67],
        ...,
        [ 19,  42,  89],
        [ 16,  40,  84],
        [ 16,  40,  84]],

       ...,

       [[ 48,  43,  34],
        [ 46,  42,  33],
        [ 79,  69,  49],
        ...,
        [ 77,  69,  66],
        [ 69,  61,  68],
        [ 70,  61,  68]],

       [[ 97,  92,  60],
        [ 95,  89,  58],
        [154, 145, 103],
        ...,
        [ 76,  70,  70],
        [ 60,  52,  65],
        [ 61,  53,  65]],

       [[ 86,  81,  54],
        [ 84,  79,  52],
        [137, 128,  91],
        ...,
        [ 76,  70,  69],
        [ 62,  54,  66],
        [ 63,  55,  66]]], dtype=uint8)]"
Image_1621.jpg,762,268,351,297,1200,906,1113,565,351,daskShared_local/images/Image_1621.jpg,1621,"[array([[[ 91,  85,  98],
        [ 65,  58,  73],
        [ 58,  50,  66],
        ...,
        [ 20,  51,  73],
        [ 19,  49,  71],
        [ 16,  46,  70]],

       [[ 91,  87, 102],
        [ 88,  84, 102],
        [ 55,  50,  71],
        ...,
        [ 19,  52,  75],
        [ 18,  50,  73],
        [ 16,  48,  71]],

       [[ 76,  73,  91],
        [ 81,  79, 100],
        [ 75,  73,  97],
        ...,
        [ 16,  52,  74],
        [ 15,  50,  72],
        [ 19,  53,  76]],

       ...,

       [[ 85, 134, 156],
        [ 90, 144, 164],
        [ 61, 117, 136],
        ...,
        [ 17,  58,  78],
        [ 17,  55,  74],
        [ 18,  54,  73]],

       [[ 96, 147, 168],
        [ 95, 146, 166],
        [ 64, 113, 133],
        ...,
        [ 16,  54,  75],
        [ 16,  52,  71],
        [ 19,  52,  72]],

       [[112, 164, 185],
        [ 98, 147, 167],
        [ 78, 124, 143],
        ...,
        [ 17,  55,  75],
        [ 19,  53,  73],
        [ 21,  52,  73]]], dtype=uint8)]"
Image_1622.jpg,291,132,146,120,800,505,437,252,146,daskShared_local/images/Image_1622.jpg,1622,"[array([[[ 26,  73,  78],
        [ 37,  85,  91],
        [ 53, 102, 108],
        ...,
        [  1,  20,  34],
        [  1,  21,  34],
        [  0,  21,  34]],

       [[ 23,  73,  80],
        [ 31,  82,  90],
        [ 44,  95, 104],
        ...,
        [  0,  20,  33],
        [  0,  21,  33],
        [  0,  22,  33]],

       [[ 22,  75,  84],
        [ 25,  80,  89],
        [ 34,  88,  99],
        ...,
        [  3,  24,  34],
        [  3,  25,  35],
        [  2,  25,  35]],

       ...,

       [[ 80,  78,  55],
        [ 71,  70,  47],
        [ 68,  69,  46],
        ...,
        [241, 217, 186],
        [230, 205, 174],
        [217, 192, 161]],

       [[ 82,  80,  56],
        [ 75,  74,  50],
        [ 71,  71,  48],
        ...,
        [234, 210, 179],
        [222, 197, 166],
        [212, 188, 156]],

       [[ 86,  82,  58],
        [ 80,  77,  54],
        [ 76,  74,  52],
        ...,
        [226, 203, 172],
        [218, 194, 162],
        [215, 192, 159]]], dtype=uint8)]"
Image_1623.jpg,430,218,122,210,900,600,552,428,210,daskShared_local/images/Image_1623.jpg,1623,"[array([[[  5, 106, 162],
        [  5, 106, 162],
        [  5, 106, 162],
        ...,
        [  4, 118, 168],
        [  4, 118, 168],
        [  4, 118, 168]],

       [[  5, 106, 162],
        [  5, 106, 162],
        [  5, 106, 162],
        ...,
        [  4, 118, 168],
        [  4, 118, 168],
        [  4, 118, 168]],

       [[  5, 106, 162],
        [  5, 106, 162],
        [  5, 106, 162],
        ...,
        [  4, 118, 168],
        [  5, 119, 169],
        [  5, 119, 169]],

       ...,

       [[ 66,  57,  18],
        [ 73,  60,  25],
        [ 94,  81,  47],
        ...,
        [  3,  86, 126],
        [  3,  86, 126],
        [  3,  86, 126]],

       [[111, 101,  63],
        [ 77,  64,  29],
        [ 67,  54,  21],
        ...,
        [  5,  87, 127],
        [  5,  87, 127],
        [  5,  87, 127]],

       [[ 81,  71,  35],
        [ 71,  58,  25],
        [ 58,  45,  13],
        ...,
        [  5,  87, 127],
        [  5,  87, 127],
        [  5,  87, 127]]], dtype=uint8)]"
Image_1624.jpg,765,160,235,181,1050,700,1000,341,235,daskShared_local/images/Image_1624.jpg,1624,"[array([[[  0, 132, 113],
        [  3, 103,  88],
        [  6, 121, 105],
        ...,
        [ 21,  44,  50],
        [ 22,  41,  48],
        [ 27,  37,  46]],

       [[  3, 140, 132],
        [  5, 131, 121],
        [  3, 138, 123],
        ...,
        [ 22,  43,  52],
        [ 32,  53,  67],
        [ 31,  44,  59]],

       [[  7, 159, 155],
        [ 14, 167, 161],
        [ 15, 169, 160],
        ...,
        [ 28,  40,  52],
        [ 39,  53,  68],
        [ 31,  42,  58]],

       ...,

       [[ 37,  49,  53],
        [ 37,  48,  52],
        [ 33,  45,  49],
        ...,
        [ 56,  47,  55],
        [ 37,  33,  42],
        [ 29,  27,  37]],

       [[ 33,  44,  48],
        [ 34,  45,  49],
        [ 31,  42,  46],
        ...,
        [ 48,  40,  48],
        [ 37,  32,  41],
        [ 32,  29,  39]],

       [[ 30,  41,  43],
        [ 36,  47,  49],
        [ 35,  46,  49],
        ...,
        [ 41,  41,  46],
        [ 33,  33,  40],
        [ 30,  30,  38]]], dtype=uint8)]"
Image_1625.jpg,355,107,316,278,1024,670,671,385,316,daskShared_local/images/Image_1625.jpg,1625,"[array([[[  0,  69, 116],
        [  1,  69, 116],
        [  2,  71, 115],
        ...,
        [  3,  14,  26],
        [  4,  17,  26],
        [  6,  19,  28]],

       [[  1,  68, 117],
        [  4,  70, 118],
        [  6,  75, 118],
        ...,
        [  4,  15,  27],
        [  6,  19,  28],
        [  3,  16,  25]],

       [[  3,  69, 119],
        [  5,  71, 118],
        [  5,  71, 115],
        ...,
        [  4,  16,  28],
        [  4,  17,  26],
        [  5,  18,  27]],

       ...,

       [[ 19,  34,  19],
        [ 21,  32,  12],
        [ 18,  40,   7],
        ...,
        [ 10,  21,  25],
        [ 11,  21,  25],
        [  8,  17,  22]],

       [[ 10,  34,   6],
        [ 14,  40,  13],
        [ 36,  74,  39],
        ...,
        [ 10,  21,  25],
        [  9,  20,  24],
        [  6,  17,  23]],

       [[ 12,  46,  11],
        [ 34,  74,  33],
        [ 68, 120,  66],
        ...,
        [ 10,  24,  27],
        [ 10,  23,  28],
        [  6,  19,  25]]], dtype=uint8)]"
Image_1626.jpg,271,331,167,110,900,599,438,441,167,daskShared_local/images/Image_1626.jpg,1626,"[array([[[ 69, 138, 215],
        [ 66, 139, 214],
        [ 65, 139, 214],
        ...,
        [253, 254, 240],
        [243, 246, 227],
        [221, 225, 203]],

       [[ 70, 137, 215],
        [ 68, 137, 214],
        [ 68, 137, 214],
        ...,
        [246, 246, 222],
        [225, 222, 196],
        [198, 196, 169]],

       [[ 70, 137, 215],
        [ 69, 136, 214],
        [ 69, 136, 214],
        ...,
        [238, 235, 210],
        [231, 227, 200],
        [210, 206, 178]],

       ...,

       [[ 43,  82, 159],
        [ 44,  83, 160],
        [ 44,  83, 160],
        ...,
        [ 46,  87, 166],
        [ 46,  87, 166],
        [ 46,  87, 166]],

       [[ 43,  82, 159],
        [ 44,  83, 160],
        [ 44,  83, 160],
        ...,
        [ 46,  87, 166],
        [ 46,  87, 166],
        [ 46,  87, 166]],

       [[ 42,  81, 158],
        [ 43,  82, 159],
        [ 43,  82, 159],
        ...,
        [ 46,  87, 166],
        [ 46,  87, 166],
        [ 46,  87, 166]]], dtype=uint8)]"
Image_1627.jpg,283,167,258,236,1000,541,541,403,258,daskShared_local/images/Image_1627.jpg,1627,"[array([[[ 41, 139, 177],
        [ 51, 131, 169],
        [ 59, 124, 161],
        ...,
        [ 19,  75,  96],
        [ 25,  72,  91],
        [ 30,  69,  89]],

       [[ 35, 142, 180],
        [ 45, 134, 171],
        [ 55, 128, 165],
        ...,
        [ 16,  78, 100],
        [ 21,  75,  96],
        [ 26,  76,  97]],

       [[ 30, 144, 180],
        [ 39, 135, 171],
        [ 51, 132, 167],
        ...,
        [  6,  86, 106],
        [ 15,  86, 104],
        [ 24,  93, 111]],

       ...,

       [[  0,  50,  67],
        [  0,  45,  61],
        [  0,  44,  58],
        ...,
        [105, 134, 165],
        [ 78, 110, 138],
        [116, 151, 174]],

       [[  0,  48,  65],
        [  1,  47,  63],
        [  0,  46,  61],
        ...,
        [ 84, 118, 152],
        [ 88, 122, 152],
        [105, 138, 164]],

       [[  0,  44,  63],
        [  2,  48,  66],
        [  1,  48,  65],
        ...,
        [ 70, 106, 134],
        [ 88, 120, 147],
        [ 91, 120, 145]]], dtype=uint8)]"
Image_1628.jpg,391,183,150,128,770,578,541,311,150,daskShared_local/images/Image_1628.jpg,1628,"[array([[[102, 108, 109],
        [ 92,  98, 100],
        [ 80,  86,  89],
        ...,
        [ 78,  79,  81],
        [ 76,  77,  78],
        [ 74,  74,  75]],

       [[ 96, 101, 103],
        [ 91,  96, 100],
        [ 81,  87,  92],
        ...,
        [ 77,  79,  81],
        [ 75,  76,  77],
        [ 71,  72,  73]],

       [[ 90,  94,  99],
        [ 89,  93,  99],
        [ 81,  87,  94],
        ...,
        [ 76,  79,  81],
        [ 72,  74,  77],
        [ 68,  70,  72]],

       ...,

       [[101, 107, 110],
        [ 95, 100, 104],
        [ 95, 100, 104],
        ...,
        [ 73,  78,  77],
        [ 70,  72,  73],
        [ 73,  73,  75]],

       [[107, 111, 112],
        [106, 110, 111],
        [105, 109, 110],
        ...,
        [ 54,  57,  58],
        [ 51,  50,  52],
        [ 46,  43,  46]],

       [[103, 107, 108],
        [111, 115, 116],
        [113, 117, 118],
        ...,
        [ 47,  50,  50],
        [ 41,  40,  43],
        [ 31,  29,  32]]], dtype=uint8)]"
Image_1629.jpg,296,369,174,147,1024,683,470,516,174,daskShared_local/images/Image_1629.jpg,1629,"[array([[[122, 142, 151],
        [122, 143, 153],
        [133, 155, 166],
        ...,
        [ 71,  68,  64],
        [ 82,  76,  72],
        [ 92,  81,  77]],

       [[129, 146, 148],
        [128, 146, 151],
        [138, 158, 166],
        ...,
        [ 75,  73,  69],
        [ 86,  78,  75],
        [ 95,  85,  79]],

       [[139, 152, 146],
        [131, 147, 145],
        [136, 155, 159],
        ...,
        [ 68,  64,  61],
        [ 76,  70,  64],
        [ 87,  78,  71]],

       ...,

       [[  0, 106, 130],
        [  0, 107, 130],
        [  0, 107, 131],
        ...,
        [  0, 113, 139],
        [  0, 113, 139],
        [  0, 113, 139]],

       [[  0, 106, 132],
        [  0, 106, 132],
        [  0, 106, 132],
        ...,
        [  0, 113, 139],
        [  0, 113, 139],
        [  0, 113, 139]],

       [[  0, 106, 132],
        [  0, 106, 132],
        [  0, 106, 132],
        ...,
        [  0, 113, 139],
        [  0, 113, 139],
        [  0, 113, 139]]], dtype=uint8)]"
Image_163.jpg,426,152,255,257,1200,822,681,409,257,daskShared_local/images/Image_163.jpg,163,"[array([[[  0, 148, 174],
        [  1, 149, 175],
        [  1, 149, 175],
        ...,
        [  0, 160, 188],
        [  0, 161, 189],
        [  0, 164, 191]],

       [[  0, 149, 174],
        [  0, 150, 175],
        [  0, 150, 175],
        ...,
        [  0, 161, 189],
        [  0, 161, 189],
        [  0, 164, 191]],

       [[  0, 150, 175],
        [  0, 150, 175],
        [  0, 150, 175],
        ...,
        [  2, 163, 191],
        [  1, 162, 190],
        [  0, 164, 191]],

       ...,

       [[ 77,  98,  62],
        [ 71,  90,  49],
        [ 71,  90,  45],
        ...,
        [100,  71,  29],
        [109,  74,  23],
        [116,  76,   5]],

       [[ 95, 121,  76],
        [ 85, 109,  61],
        [ 75, 100,  51],
        ...,
        [ 82,  63,  30],
        [ 93,  68,  28],
        [106,  75,  15]],

       [[ 91, 117,  66],
        [ 93, 118,  63],
        [ 89, 114,  58],
        ...,
        [ 90,  78,  52],
        [101,  83,  53],
        [115,  91,  45]]], dtype=uint8)]"
Image_1630.jpg,196,209,491,281,1599,1065,687,490,491,daskShared_local/images/Image_1630.jpg,1630,"[array([[[  4,   0,   1],
        [  4,   0,   1],
        [  4,   0,   1],
        ...,
        [  4,   0,   1],
        [  4,   0,   1],
        [  4,   0,   1]],

       [[  4,   0,   1],
        [  4,   0,   1],
        [  4,   0,   1],
        ...,
        [  4,   0,   1],
        [  4,   0,   1],
        [  4,   0,   1]],

       [[  4,   0,   1],
        [  4,   0,   1],
        [  4,   0,   1],
        ...,
        [  4,   0,   1],
        [  4,   0,   1],
        [  4,   0,   1]],

       ...,

       [[  3,   1,   2],
        [  3,   1,   2],
        [  3,   1,   2],
        ...,
        [106, 139, 126],
        [130, 157, 119],
        [170, 202, 197]],

       [[  3,   1,   2],
        [  3,   1,   2],
        [  3,   1,   2],
        ...,
        [145, 182, 164],
        [159, 196, 152],
        [167, 217, 169]],

       [[  4,   2,   3],
        [  4,   2,   3],
        [  3,   1,   2],
        ...,
        [132, 182, 152],
        [163, 223, 182],
        [191, 235, 205]]], dtype=uint8)]"
Image_1631.JPG,295,413,1507,1499,2560,1920,1802,1912,1507,daskShared_local/images/Image_1631.JPG,1631,"[array([[[ 90,  76,  36],
        [ 91,  76,  34],
        [ 84,  77,  37],
        ...,
        [155, 143, 106],
        [146, 132,  96],
        [141, 128,  97]],

       [[ 90,  72,  31],
        [ 90,  73,  28],
        [ 90,  76,  32],
        ...,
        [149, 135, 104],
        [141, 127,  92],
        [136, 124,  82]],

       [[ 81,  68,  30],
        [ 82,  69,  25],
        [ 86,  72,  27],
        ...,
        [158, 139, 113],
        [141, 123,  88],
        [123, 107,  68]],

       ...,

       [[ 85,  95,  52],
        [105, 113,  80],
        [ 91, 103,  56],
        ...,
        [ 89, 100,  29],
        [ 90,  98,  31],
        [ 87,  95,  34]],

       [[ 80,  87,  49],
        [ 95, 102,  67],
        [ 85,  96,  45],
        ...,
        [ 85,  98,  32],
        [ 88,  96,  29],
        [ 86,  96,  33]],

       [[ 82,  87,  39],
        [ 81,  92,  42],
        [ 78,  91,  33],
        ...,
        [ 85,  97,  30],
        [ 84,  95,  29],
        [ 84,  94,  31]]], dtype=uint8)]"
Image_1632.jpg,288,394,214,211,1024,768,502,605,214,daskShared_local/images/Image_1632.jpg,1632,"[array([[[ 81,  72,  65],
        [100,  86,  82],
        [ 89,  73,  65],
        ...,
        [150, 122,  62],
        [ 97,  65,  20],
        [100,  66,  37]],

       [[ 63,  49,  38],
        [ 76,  59,  50],
        [ 68,  49,  41],
        ...,
        [151, 128,  62],
        [ 93,  66,  16],
        [104,  73,  33]],

       [[ 68,  50,  38],
        [ 65,  48,  36],
        [ 80,  62,  50],
        ...,
        [133, 112,  57],
        [ 75,  51,   9],
        [ 94,  67,  28]],

       ...,

       [[231, 204, 163],
        [221, 197, 157],
        [233, 212, 177],
        ...,
        [196, 167, 130],
        [193, 162, 123],
        [196, 166, 128]],

       [[232, 204, 167],
        [219, 191, 157],
        [236, 210, 180],
        ...,
        [198, 167, 126],
        [197, 164, 123],
        [202, 170, 132]],

       [[223, 199, 165],
        [226, 200, 167],
        [236, 211, 178],
        ...,
        [199, 165, 120],
        [207, 174, 132],
        [205, 173, 134]]], dtype=uint8)]"
Image_1633.jpg,551,216,294,252,986,653,845,468,294,daskShared_local/images/Image_1633.jpg,1633,"[array([[[122, 131, 112],
        [117, 125, 109],
        [ 99, 110,  94],
        ...,
        [ 60, 117,  98],
        [ 60, 117,  98],
        [ 60, 117,  98]],

       [[ 83,  90,  74],
        [103, 111,  97],
        [116, 125, 112],
        ...,
        [ 60, 117,  98],
        [ 60, 117,  98],
        [ 60, 117,  98]],

       [[107, 113,  97],
        [101, 107,  95],
        [102, 108,  96],
        ...,
        [ 60, 117,  98],
        [ 60, 117,  98],
        [ 60, 117,  98]],

       ...,

       [[ 78,  97,  41],
        [ 73,  93,  33],
        [ 71,  92,  30],
        ...,
        [ 51,  76,  44],
        [ 51,  76,  44],
        [ 51,  76,  45]],

       [[ 68,  86,  24],
        [ 66,  86,  20],
        [ 67,  87,  20],
        ...,
        [ 52,  78,  43],
        [ 52,  77,  45],
        [ 52,  77,  45]],

       [[ 66,  86,  13],
        [ 68,  88,  12],
        [ 72,  92,  15],
        ...,
        [ 55,  81,  46],
        [ 54,  80,  45],
        [ 53,  78,  46]]], dtype=uint8)]"
Image_1634.jpg,669,244,341,300,2121,1063,1010,544,341,daskShared_local/images/Image_1634.jpg,1634,"[array([[[105, 153, 168],
        [107, 154, 170],
        [102, 151, 166],
        ...,
        [144, 152, 148],
        [142, 150, 146],
        [136, 146, 148]],

       [[ 85, 132, 148],
        [ 92, 139, 155],
        [ 96, 145, 160],
        ...,
        [140, 142, 136],
        [142, 145, 138],
        [137, 143, 139]],

       [[ 63, 110, 126],
        [ 70, 117, 133],
        [ 68, 117, 132],
        ...,
        [141, 139, 132],
        [129, 127, 120],
        [141, 141, 132]],

       ...,

       [[ 54, 105, 124],
        [ 51, 102, 121],
        [ 54, 105, 124],
        ...,
        [173, 171, 156],
        [167, 165, 148],
        [161, 155, 140]],

       [[ 53, 104, 123],
        [ 51, 102, 121],
        [ 55, 106, 125],
        ...,
        [166, 164, 149],
        [156, 154, 138],
        [176, 170, 156]],

       [[ 52, 103, 122],
        [ 53, 104, 123],
        [ 52, 103, 122],
        ...,
        [167, 165, 151],
        [171, 169, 154],
        [170, 165, 153]]], dtype=uint8)]"
Image_1635.jpg,1070,1193,963,861,3840,2160,2033,2054,963,daskShared_local/images/Image_1635.jpg,1635,"[array([[[195, 195, 159],
        [149, 140, 106],
        [114, 103,  83],
        ...,
        [ 57,  51,  44],
        [ 34,  31,  26],
        [ 59,  53,  47]],

       [[208, 211, 178],
        [179, 167, 133],
        [ 95,  85,  72],
        ...,
        [ 61,  54,  51],
        [ 26,  26,  19],
        [ 48,  42,  32]],

       [[201, 206, 185],
        [207, 203, 170],
        [151, 138, 110],
        ...,
        [ 50,  43,  43],
        [ 30,  27,  22],
        [ 66,  58,  47]],

       ...,

       [[  4,  23,  29],
        [  4,  23,  29],
        [  5,  24,  30],
        ...,
        [  2,  16,  22],
        [  2,  13,  22],
        [  3,  13,  22]],

       [[  6,  25,  31],
        [  5,  24,  30],
        [  5,  24,  30],
        ...,
        [  1,  15,  19],
        [  2,  14,  21],
        [  5,  14,  24]],

       [[  6,  24,  30],
        [  5,  24,  30],
        [  5,  23,  30],
        ...,
        [  1,  13,  19],
        [  1,  11,  20],
        [  2,  12,  21]]], dtype=uint8)]"
Image_1636.jpg,70,135,118,110,525,340,188,245,118,daskShared_local/images/Image_1636.jpg,1636,"[array([[[ 35,  84, 100],
        [ 34,  84,  99],
        [ 34,  83,  98],
        ...,
        [161, 172, 129],
        [166, 174, 132],
        [167, 175, 133]],

       [[ 34,  84,  99],
        [ 34,  83,  99],
        [ 33,  83,  99],
        ...,
        [169, 180, 137],
        [171, 179, 137],
        [172, 179, 137]],

       [[ 31,  82,  99],
        [ 31,  82,  99],
        [ 32,  83, 100],
        ...,
        [193, 204, 161],
        [186, 195, 151],
        [184, 192, 148]],

       ...,

       [[ 37,  67,  55],
        [ 39,  69,  57],
        [ 45,  75,  63],
        ...,
        [ 72,  86,  69],
        [ 44,  58,  41],
        [ 35,  49,  32]],

       [[ 70,  98,  85],
        [ 66,  94,  82],
        [ 55,  84,  70],
        ...,
        [ 73,  87,  70],
        [ 51,  64,  47],
        [ 44,  57,  40]],

       [[ 81, 108,  95],
        [ 75, 103,  90],
        [ 58,  86,  73],
        ...,
        [ 73,  87,  70],
        [ 53,  66,  49],
        [ 46,  60,  43]]], dtype=uint8)]"
Image_1637.jpg,555,185,103,77,1000,700,658,262,103,daskShared_local/images/Image_1637.jpg,1637,"[array([[[  3, 157, 229],
        [  3, 157, 229],
        [  3, 157, 229],
        ...,
        [  0, 157, 226],
        [  0, 157, 226],
        [  0, 157, 226]],

       [[  3, 157, 229],
        [  3, 157, 229],
        [  3, 157, 229],
        ...,
        [  0, 157, 226],
        [  0, 157, 226],
        [  0, 157, 226]],

       [[  2, 156, 228],
        [  2, 156, 228],
        [  2, 156, 228],
        ...,
        [  0, 156, 225],
        [  0, 156, 225],
        [  0, 156, 225]],

       ...,

       [[ 43, 102, 116],
        [ 45, 103, 117],
        [ 65, 120, 134],
        ...,
        [  0, 150, 221],
        [  1, 150, 221],
        [  1, 150, 221]],

       [[ 22,  84, 104],
        [ 24,  85, 105],
        [ 41, 100, 116],
        ...,
        [  0, 149, 220],
        [  0, 149, 220],
        [  0, 149, 220]],

       [[ 20,  83, 103],
        [ 22,  84, 104],
        [ 40,  98, 115],
        ...,
        [  0, 148, 220],
        [  0, 148, 220],
        [  0, 148, 220]]], dtype=uint8)]"
Image_1638.jpg,391,0,1144,1004,1920,1080,1535,1004,1144,daskShared_local/images/Image_1638.jpg,1638,"[array([[[  1, 121, 152],
        [  1, 120, 152],
        [  1, 120, 152],
        ...,
        [ 76,  97,  77],
        [ 88, 109,  94],
        [ 92, 111,  93]],

       [[  1, 121, 153],
        [  1, 121, 153],
        [  1, 122, 152],
        ...,
        [100, 117,  99],
        [109, 122, 104],
        [133, 140, 106]],

       [[  0, 122, 153],
        [  0, 122, 153],
        [  1, 122, 153],
        ...,
        [120, 127, 105],
        [146, 144, 112],
        [157, 152, 113]],

       ...,

       [[139, 135,  67],
        [134, 126,  57],
        [134, 122,  55],
        ...,
        [ 34,  28,  18],
        [ 33,  28,  19],
        [ 32,  28,  19]],

       [[123, 123,  69],
        [136, 133,  77],
        [145, 140,  78],
        ...,
        [ 31,  27,  20],
        [ 30,  27,  20],
        [ 29,  27,  21]],

       [[115, 118,  72],
        [112, 113,  69],
        [120, 119,  75],
        ...,
        [ 28,  27,  20],
        [ 27,  27,  20],
        [ 25,  26,  20]]], dtype=uint8)]"
Image_1639.jpg,279,92,189,162,732,420,468,254,189,daskShared_local/images/Image_1639.jpg,1639,"[array([[[  0, 166, 216],
        [  2, 163, 215],
        [  0, 164, 215],
        ...,
        [  2, 181, 222],
        [  0, 180, 220],
        [  0, 181, 224]],

       [[  0, 163, 214],
        [  1, 162, 214],
        [  1, 162, 214],
        ...,
        [  4, 184, 224],
        [  0, 186, 222],
        [  0, 179, 217]],

       [[  0, 162, 213],
        [  1, 162, 214],
        [  1, 162, 214],
        ...,
        [  1, 186, 221],
        [  0, 190, 223],
        [  0, 187, 220]],

       ...,

       [[131, 141,  73],
        [110, 112,  47],
        [138, 140,  74],
        ...,
        [ 89,  84,  37],
        [106,  93,  38],
        [121, 102,  31]],

       [[156, 165, 102],
        [112, 114,  48],
        [122, 123,  55],
        ...,
        [ 83,  77,  39],
        [ 90,  75,  32],
        [104,  83,  30]],

       [[170, 176, 116],
        [124, 126,  60],
        [107, 107,  38],
        ...,
        [ 81,  75,  43],
        [ 81,  68,  33],
        [ 98,  79,  37]]], dtype=uint8)]"
Image_164.jpg,517,244,321,222,1200,900,838,466,321,daskShared_local/images/Image_164.jpg,164,"[array([[[ 63, 177, 193],
        [ 44, 170, 187],
        [ 13, 153, 165],
        ...,
        [ 77, 186, 202],
        [ 83, 189, 210],
        [ 77, 188, 209]],

       [[ 60, 182, 196],
        [ 66, 180, 191],
        [ 56, 170, 188],
        ...,
        [ 87, 189, 202],
        [ 96, 193, 203],
        [ 92, 191, 211]],

       [[ 53, 180, 194],
        [ 65, 182, 197],
        [ 87, 187, 201],
        ...,
        [ 65, 181, 192],
        [ 84, 184, 198],
        [ 76, 186, 198]],

       ...,

       [[219, 237, 240],
        [212, 234, 240],
        [207, 232, 237],
        ...,
        [143, 204, 216],
        [159, 211, 224],
        [157, 212, 223]],

       [[217, 237, 241],
        [205, 230, 237],
        [184, 222, 228],
        ...,
        [159, 213, 228],
        [167, 216, 228],
        [160, 212, 226]],

       [[220, 239, 243],
        [213, 233, 239],
        [205, 232, 235],
        ...,
        [132, 204, 218],
        [146, 208, 223],
        [150, 209, 223]]], dtype=uint8)]"
Image_1640.jpg,429,364,227,224,1024,683,656,588,227,daskShared_local/images/Image_1640.jpg,1640,"[array([[[ 56,  50,  42],
        [ 63,  63,  59],
        [109, 111, 109],
        ...,
        [ 79,  57,  43],
        [ 77,  55,  41],
        [ 59,  40,  26]],

       [[ 57,  53,  44],
        [103, 102,  97],
        [169, 169, 165],
        ...,
        [ 72,  52,  39],
        [ 65,  47,  35],
        [ 66,  51,  38]],

       [[137, 132, 119],
        [172, 169, 162],
        [112, 106,  97],
        ...,
        [ 71,  53,  42],
        [ 62,  47,  37],
        [ 55,  43,  34]],

       ...,

       [[227, 196, 155],
        [237, 205, 165],
        [237, 204, 165],
        ...,
        [227, 183, 155],
        [217, 164, 136],
        [235, 200, 161]],

       [[248, 234, 207],
        [245, 226, 197],
        [212, 197, 163],
        ...,
        [240, 205, 178],
        [248, 206, 178],
        [247, 221, 182]],

       [[252, 236, 219],
        [232, 222, 200],
        [243, 239, 210],
        ...,
        [216, 184, 146],
        [241, 203, 165],
        [254, 240, 192]]], dtype=uint8)]"
Image_1641.jpg,545,95,292,265,1024,770,837,360,292,daskShared_local/images/Image_1641.jpg,1641,"[array([[[  2, 114, 188],
        [  0, 112, 186],
        [  0, 112, 186],
        ...,
        [ 37,  34,  37],
        [ 39,  37,  42],
        [ 32,  31,  36]],

       [[  2, 114, 188],
        [  1, 113, 187],
        [  0, 112, 186],
        ...,
        [ 35,  32,  35],
        [ 36,  35,  38],
        [ 32,  31,  36]],

       [[  4, 115, 190],
        [  3, 114, 188],
        [  2, 114, 188],
        ...,
        [ 32,  30,  33],
        [ 33,  33,  36],
        [ 33,  34,  38]],

       ...,

       [[115, 138, 118],
        [145, 169, 153],
        [120, 147, 132],
        ...,
        [ 33,  33,  33],
        [ 33,  33,  33],
        [ 32,  32,  32]],

       [[ 89, 109,  91],
        [130, 153, 137],
        [148, 175, 160],
        ...,
        [ 33,  33,  34],
        [ 33,  33,  34],
        [ 33,  33,  34]],

       [[ 64,  80,  63],
        [111, 133, 116],
        [132, 160, 145],
        ...,
        [ 34,  34,  36],
        [ 34,  34,  36],
        [ 34,  34,  36]]], dtype=uint8)]"
Image_1642.jpg,2210,270,635,497,3033,1757,2845,767,635,daskShared_local/images/Image_1642.jpg,1642,"[array([[[  0,  53, 217],
        [  0,  53, 217],
        [  0,  53, 217],
        ...,
        [  0,  53, 217],
        [  0,  53, 217],
        [  0,  53, 217]],

       [[  0,  53, 217],
        [  0,  53, 217],
        [  0,  53, 217],
        ...,
        [  0,  53, 217],
        [  0,  53, 217],
        [  0,  53, 217]],

       [[  0,  53, 217],
        [  0,  53, 217],
        [  0,  53, 217],
        ...,
        [  0,  53, 217],
        [  0,  53, 217],
        [  0,  53, 217]],

       ...,

       [[ 96, 102,  56],
        [ 81,  86,  44],
        [ 68,  73,  36],
        ...,
        [  0,  53, 217],
        [  0,  53, 217],
        [  0,  53, 217]],

       [[ 95, 100,  55],
        [ 76,  80,  41],
        [ 61,  65,  32],
        ...,
        [  0,  53, 217],
        [  0,  53, 217],
        [  0,  53, 217]],

       [[ 95,  98,  54],
        [ 73,  77,  39],
        [ 58,  62,  32],
        ...,
        [  0,  53, 217],
        [  0,  53, 217],
        [  0,  53, 217]]], dtype=uint8)]"
Image_1643.jpg,521,374,180,165,1024,678,701,539,180,daskShared_local/images/Image_1643.jpg,1643,"[array([[[115,  89,  82],
        [147, 124, 118],
        [158, 143, 136],
        ...,
        [124,  92,  89],
        [131,  97,  74],
        [138, 105,  70]],

       [[129, 116, 112],
        [132, 119, 115],
        [143, 128, 127],
        ...,
        [136, 107,  84],
        [140, 109,  71],
        [183, 152, 102]],

       [[125, 115, 113],
        [ 99,  84,  90],
        [114,  94, 106],
        ...,
        [141, 121,  95],
        [182, 164, 132],
        [201, 185, 144]],

       ...,

       [[248, 242, 217],
        [244, 237, 209],
        [245, 232, 199],
        ...,
        [247, 228, 180],
        [237, 218, 171],
        [243, 226, 180]],

       [[246, 243, 220],
        [243, 238, 214],
        [250, 240, 212],
        ...,
        [242, 220, 168],
        [239, 217, 166],
        [239, 218, 166]],

       [[240, 227, 193],
        [241, 228, 195],
        [247, 235, 204],
        ...,
        [239, 216, 156],
        [236, 212, 153],
        [231, 205, 146]]], dtype=uint8)]"
Image_1644.jpg,467,118,114,85,685,360,581,203,114,daskShared_local/images/Image_1644.jpg,1644,"[array([[[  0, 107, 152],
        [  0, 107, 153],
        [  1, 109, 154],
        ...,
        [  0, 101, 145],
        [  0, 101, 145],
        [  0, 101, 145]],

       [[  0, 107, 152],
        [  0, 107, 152],
        [  1, 109, 153],
        ...,
        [  0, 101, 145],
        [  0, 101, 145],
        [  0, 101, 145]],

       [[  0, 108, 151],
        [  0, 108, 151],
        [  0, 108, 151],
        ...,
        [  0, 101, 145],
        [  0, 101, 145],
        [  0, 101, 145]],

       ...,

       [[  1,  85, 121],
        [  1,  85, 121],
        [  1,  85, 121],
        ...,
        [  0,  82, 116],
        [  0,  82, 115],
        [  0,  82, 114]],

       [[  1,  85, 121],
        [  1,  85, 121],
        [  1,  85, 121],
        ...,
        [  0,  82, 116],
        [  0,  82, 115],
        [  0,  82, 114]],

       [[  1,  85, 121],
        [  1,  85, 121],
        [  1,  85, 121],
        ...,
        [  0,  82, 116],
        [  0,  82, 115],
        [  0,  82, 114]]], dtype=uint8)]"
Image_1645.jpg,327,261,133,127,1000,667,460,388,133,daskShared_local/images/Image_1645.jpg,1645,"[array([[[ 10, 208, 227],
        [ 29, 209, 228],
        [ 52, 212, 229],
        ...,
        [ 99, 215, 235],
        [102, 216, 235],
        [102, 217, 236]],

       [[ 11, 209, 228],
        [ 24, 210, 228],
        [ 40, 212, 228],
        ...,
        [ 89, 215, 235],
        [ 93, 216, 235],
        [ 93, 216, 235]],

       [[ 10, 210, 228],
        [ 14, 211, 227],
        [ 18, 212, 227],
        ...,
        [ 75, 215, 234],
        [ 76, 215, 234],
        [ 75, 215, 235]],

       ...,

       [[184, 126,  10],
        [170, 115,   8],
        [152,  99,   5],
        ...,
        [ 12, 211, 232],
        [ 18, 210, 232],
        [ 23, 210, 231]],

       [[173, 115,   7],
        [169, 114,   6],
        [163, 109,   3],
        ...,
        [ 75, 214, 232],
        [ 96, 216, 233],
        [107, 217, 234]],

       [[161, 105,   3],
        [166, 111,   2],
        [171, 117,   1],
        ...,
        [118, 216, 232],
        [149, 220, 235],
        [164, 223, 236]]], dtype=uint8)]"
Image_1646.jpg,576,51,176,163,930,500,752,214,176,daskShared_local/images/Image_1646.jpg,1646,"[array([[[  8, 146, 209],
        [ 11, 149, 212],
        [ 15, 153, 216],
        ...,
        [ 10, 148, 210],
        [ 11, 149, 211],
        [ 12, 150, 212]],

       [[  7, 145, 208],
        [  9, 147, 210],
        [ 11, 149, 212],
        ...,
        [  9, 147, 209],
        [  9, 147, 209],
        [ 10, 148, 210]],

       [[  9, 147, 210],
        [ 10, 148, 211],
        [ 10, 148, 211],
        ...,
        [  5, 143, 205],
        [  6, 144, 206],
        [  6, 144, 206]],

       ...,

       [[206, 203, 202],
        [201, 198, 197],
        [213, 210, 209],
        ...,
        [  6, 134, 199],
        [  5, 133, 198],
        [  5, 133, 198]],

       [[224, 223, 221],
        [217, 216, 214],
        [235, 234, 232],
        ...,
        [  5, 133, 198],
        [  5, 133, 198],
        [  5, 133, 198]],

       [[243, 242, 240],
        [235, 234, 232],
        [246, 245, 243],
        ...,
        [  6, 134, 199],
        [  6, 134, 199],
        [  6, 134, 199]]], dtype=uint8)]"
Image_1647.jpg,1288,635,332,238,2106,1578,1620,873,332,daskShared_local/images/Image_1647.jpg,1647,"[array([[[ 23, 146, 150],
        [ 25, 146, 150],
        [ 26, 145, 151],
        ...,
        [ 16, 147, 143],
        [ 21, 148, 146],
        [ 19, 143, 141]],

       [[ 25, 146, 144],
        [ 26, 146, 147],
        [ 27, 147, 150],
        ...,
        [ 15, 146, 144],
        [ 18, 144, 141],
        [ 20, 145, 142]],

       [[ 20, 149, 145],
        [ 20, 147, 143],
        [ 25, 149, 146],
        ...,
        [ 17, 144, 145],
        [ 17, 144, 142],
        [ 17, 143, 142]],

       ...,

       [[ 30, 151, 147],
        [ 32, 152, 145],
        [ 31, 151, 144],
        ...,
        [ 28, 162, 156],
        [ 28, 164, 157],
        [ 28, 163, 153]],

       [[ 31, 151, 144],
        [ 31, 151, 142],
        [ 33, 153, 146],
        ...,
        [ 27, 164, 157],
        [ 28, 165, 158],
        [ 28, 162, 157]],

       [[ 33, 152, 143],
        [ 33, 152, 146],
        [ 35, 156, 150],
        ...,
        [ 29, 163, 157],
        [ 29, 163, 157],
        [ 31, 163, 156]]], dtype=uint8)]"
Image_1648.jpg,961,264,202,147,1600,1280,1163,411,202,daskShared_local/images/Image_1648.jpg,1648,"[array([[[ 13,  82,  61],
        [ 21,  82,  67],
        [ 27,  84,  77],
        ...,
        [ 30, 160, 116],
        [ 22, 152, 108],
        [ 17, 146, 105]],

       [[ 30,  94,  80],
        [ 26,  82,  82],
        [ 24,  77,  84],
        ...,
        [ 22, 154, 104],
        [ 23, 155, 106],
        [ 23, 154, 110]],

       [[ 22,  84,  77],
        [ 12,  66,  72],
        [  5,  55,  68],
        ...,
        [ 33, 166, 112],
        [ 31, 165, 115],
        [ 26, 162, 115]],

       ...,

       [[232, 229, 159],
        [165, 166, 111],
        [130, 132,  94],
        ...,
        [ 36, 154, 136],
        [ 40, 152, 131],
        [ 30, 139, 108]],

       [[197, 191, 105],
        [146, 144,  72],
        [132, 129,  85],
        ...,
        [ 39, 152, 133],
        [ 37, 145, 122],
        [ 27, 132, 101]],

       [[160, 150,  55],
        [122, 114,  32],
        [118, 108,  59],
        ...,
        [ 41, 150, 129],
        [ 32, 139, 114],
        [ 31, 135, 102]]], dtype=uint8)]"
Image_1649.jpg,366,172,478,417,1280,854,844,589,478,daskShared_local/images/Image_1649.jpg,1649,"[array([[[115, 149, 175],
        [115, 149, 177],
        [116, 150, 178],
        ...,
        [ 18, 209, 244],
        [ 17, 208, 243],
        [ 19, 210, 245]],

       [[115, 150, 178],
        [118, 149, 178],
        [118, 149, 178],
        ...,
        [ 20, 209, 238],
        [ 20, 210, 239],
        [ 21, 211, 241]],

       [[117, 152, 180],
        [119, 150, 179],
        [115, 146, 175],
        ...,
        [ 17, 210, 241],
        [ 19, 211, 241],
        [ 18, 210, 241]],

       ...,

       [[ 86, 186, 213],
        [ 68, 179, 208],
        [ 47, 171, 201],
        ...,
        [ 12, 193, 238],
        [ 15, 196, 241],
        [ 11, 192, 237]],

       [[ 78, 181, 209],
        [ 63, 176, 201],
        [ 55, 177, 204],
        ...,
        [ 16, 197, 242],
        [ 16, 197, 242],
        [ 16, 197, 242]],

       [[ 70, 183, 212],
        [ 62, 181, 208],
        [ 51, 177, 206],
        ...,
        [ 14, 195, 240],
        [ 14, 195, 240],
        [ 14, 195, 240]]], dtype=uint8)]"
Image_165.jpg,355,101,152,194,728,486,507,295,194,daskShared_local/images/Image_165.jpg,165,"[array([[[  1,  62, 251],
        [  3,  63, 255],
        [  3,  63, 255],
        ...,
        [  2, 101, 254],
        [  0, 103, 254],
        [  1, 105, 254]],

       [[  0,  65, 253],
        [  0,  65, 251],
        [  1,  64, 253],
        ...,
        [  0, 101, 255],
        [  3, 102, 255],
        [  0, 103, 254]],

       [[  1,  64, 255],
        [  3,  62, 252],
        [  2,  62, 254],
        ...,
        [  0, 102, 255],
        [  1, 102, 254],
        [  2, 103, 255]],

       ...,

       [[196, 154, 112],
        [189, 148, 111],
        [131, 100,  82],
        ...,
        [ 75,  80,  51],
        [ 80,  84,  57],
        [ 72,  79,  39]],

       [[200, 155, 117],
        [114,  91,  67],
        [ 80,  59,  50],
        ...,
        [ 84,  87,  78],
        [ 74,  83,  74],
        [ 74,  78,  64]],

       [[176, 128,  96],
        [ 91,  72,  59],
        [ 73,  56,  49],
        ...,
        [ 97,  98,  86],
        [ 90,  91,  83],
        [ 85,  86,  80]]], dtype=uint8)]"
Image_1650.jpg,59,120,200,171,600,350,259,291,200,daskShared_local/images/Image_1650.jpg,1650,"[array([[[ 28,  52,  38],
        [ 27,  51,  37],
        [ 25,  52,  37],
        ...,
        [107,  94,  78],
        [101,  87,  84],
        [ 80,  69,  77]],

       [[ 28,  50,  37],
        [ 27,  51,  37],
        [ 27,  51,  37],
        ...,
        [ 98,  78,  51],
        [ 93,  76,  60],
        [ 63,  52,  50]],

       [[ 27,  49,  36],
        [ 27,  49,  36],
        [ 27,  51,  37],
        ...,
        [102,  75,  49],
        [105,  82,  64],
        [ 83,  69,  60]],

       ...,

       [[148, 147, 119],
        [148, 138, 111],
        [150, 136, 109],
        ...,
        [145, 132,  88],
        [151, 132,  90],
        [170, 144, 107]],

       [[149, 134, 111],
        [150, 136, 110],
        [147, 130, 102],
        ...,
        [105,  61,  47],
        [113,  73,  52],
        [117,  77,  51]],

       [[143, 131, 107],
        [153, 141, 115],
        [160, 145, 116],
        ...,
        [105,  58,  42],
        [103,  58,  35],
        [100,  56,  29]]], dtype=uint8)]"
Image_1651.jpg,129,93,156,116,500,333,285,209,156,daskShared_local/images/Image_1651.jpg,1651,"[array([[[ 27,  42,  61],
        [ 27,  42,  61],
        [ 27,  42,  61],
        ...,
        [ 26,  44,  66],
        [ 26,  44,  66],
        [ 26,  44,  66]],

       [[ 27,  42,  61],
        [ 27,  42,  61],
        [ 27,  42,  61],
        ...,
        [ 26,  44,  66],
        [ 26,  44,  66],
        [ 26,  44,  66]],

       [[ 27,  42,  61],
        [ 27,  42,  61],
        [ 27,  42,  61],
        ...,
        [ 26,  44,  66],
        [ 26,  44,  66],
        [ 26,  44,  66]],

       ...,

       [[ 23,  41,  55],
        [ 24,  42,  56],
        [ 24,  42,  56],
        ...,
        [114, 130, 123],
        [115, 131, 123],
        [115, 131, 124]],

       [[ 23,  41,  55],
        [ 24,  42,  56],
        [ 25,  43,  57],
        ...,
        [116, 133, 125],
        [116, 133, 125],
        [116, 133, 125]],

       [[ 24,  42,  56],
        [ 25,  43,  57],
        [ 25,  43,  57],
        ...,
        [117, 134, 126],
        [117, 134, 126],
        [116, 133, 125]]], dtype=uint8)]"
Image_1652.jpg,394,175,97,82,800,600,491,257,97,daskShared_local/images/Image_1652.jpg,1652,"[array([[[ 74, 109, 132],
        [ 74, 109, 132],
        [ 73, 112, 132],
        ...,
        [ 55, 122, 176],
        [ 56, 120, 183],
        [ 56, 120, 183]],

       [[ 74, 109, 132],
        [ 74, 109, 132],
        [ 74, 112, 132],
        ...,
        [ 55, 122, 176],
        [ 56, 120, 183],
        [ 56, 120, 183]],

       [[ 64, 106, 127],
        [ 64, 106, 127],
        [ 64, 108, 128],
        ...,
        [ 55, 122, 177],
        [ 56, 121, 182],
        [ 56, 121, 181]],

       ...,

       [[130, 135, 163],
        [130, 135, 163],
        [127, 133, 167],
        ...,
        [ 17, 132, 247],
        [ 16, 132, 247],
        [ 16, 132, 247]],

       [[154, 154, 159],
        [154, 154, 159],
        [150, 150, 162],
        ...,
        [ 20, 133, 244],
        [ 20, 134, 245],
        [ 20, 134, 245]],

       [[153, 153, 159],
        [153, 153, 159],
        [149, 149, 162],
        ...,
        [ 20, 133, 244],
        [ 20, 134, 245],
        [ 20, 134, 245]]], dtype=uint8)]"
Image_1653.jpg,869,521,232,210,1920,1200,1101,731,232,daskShared_local/images/Image_1653.jpg,1653,"[array([[[  1, 119, 119],
        [  0, 118, 118],
        [  1, 117, 117],
        ...,
        [  2, 125, 125],
        [  0, 124, 122],
        [  0, 123, 120]],

       [[  0, 116, 117],
        [  0, 116, 116],
        [  0, 116, 116],
        ...,
        [  1, 124, 123],
        [  1, 125, 122],
        [  0, 125, 122]],

       [[  2, 115, 118],
        [  3, 117, 117],
        [  3, 116, 117],
        ...,
        [  0, 125, 121],
        [  0, 125, 121],
        [  0, 124, 120]],

       ...,

       [[ 87,  74,  40],
        [119, 107,  72],
        [117, 106,  71],
        ...,
        [ 96,  73,  64],
        [ 67,  46,  39],
        [ 40,  22,  14]],

       [[ 79,  66,  32],
        [110,  97,  63],
        [121, 108,  74],
        ...,
        [ 64,  44,  36],
        [ 48,  27,  20],
        [ 48,  28,  21]],

       [[ 82,  67,  36],
        [ 98,  83,  51],
        [113,  99,  66],
        ...,
        [ 44,  25,  18],
        [ 41,  21,  14],
        [ 57,  37,  30]]], dtype=uint8)]"
Image_1654.jpg,165,7,121,108,498,272,286,115,121,daskShared_local/images/Image_1654.jpg,1654,"[array([[[  1,  26,  57],
        [  1,  26,  57],
        [  2,  27,  57],
        ...,
        [  3,  34,  55],
        [  3,  34,  55],
        [  3,  34,  55]],

       [[  1,  25,  56],
        [  1,  26,  56],
        [  1,  26,  57],
        ...,
        [  3,  34,  55],
        [  3,  34,  55],
        [  3,  34,  55]],

       [[  0,  24,  54],
        [  0,  24,  54],
        [  0,  25,  55],
        ...,
        [  2,  33,  54],
        [  2,  33,  54],
        [  2,  33,  54]],

       ...,

       [[109, 120, 102],
        [115, 125, 107],
        [130, 139, 120],
        ...,
        [177, 182, 132],
        [189, 194, 148],
        [193, 199, 154]],

       [[149, 161, 148],
        [151, 162, 149],
        [155, 166, 152],
        ...,
        [177, 181, 125],
        [188, 193, 141],
        [193, 198, 147]],

       [[164, 177, 166],
        [164, 177, 165],
        [165, 176, 164],
        ...,
        [177, 180, 123],
        [188, 193, 139],
        [193, 198, 145]]], dtype=uint8)]"
Image_1655.JPG,507,412,493,284,1600,1467,1000,696,493,daskShared_local/images/Image_1655.JPG,1655,"[array([[[ 65,  84,  88],
        [ 59,  74,  73],
        [ 50,  64,  64],
        ...,
        [106, 109,  91],
        [ 99, 103,  87],
        [ 99, 105,  93]],

       [[ 73,  95,  95],
        [ 61,  79,  73],
        [ 53,  66,  64],
        ...,
        [101, 103,  92],
        [ 92,  95,  85],
        [ 98, 103,  96]],

       [[ 78, 101,  98],
        [ 67,  84,  74],
        [ 63,  75,  72],
        ...,
        [ 97, 103,  84],
        [102, 105,  86],
        [120, 124, 105]],

       ...,

       [[213, 216, 173],
        [213, 216, 174],
        [217, 221, 180],
        ...,
        [221, 224, 218],
        [205, 208, 200],
        [203, 207, 196]],

       [[204, 208, 169],
        [208, 213, 175],
        [218, 220, 179],
        ...,
        [214, 216, 206],
        [222, 225, 210],
        [238, 242, 220]],

       [[197, 202, 167],
        [214, 219, 183],
        [229, 228, 188],
        ...,
        [231, 231, 216],
        [241, 243, 222],
        [237, 240, 213]]], dtype=uint8)]"
Image_1656.jpg,677,287,286,316,1600,900,963,603,316,daskShared_local/images/Image_1656.jpg,1656,"[array([[[  0, 116, 200],
        [  0, 116, 200],
        [  0, 116, 200],
        ...,
        [  2, 118, 205],
        [  2, 118, 205],
        [  0, 120, 203]],

       [[  0, 116, 199],
        [  0, 116, 199],
        [  0, 116, 199],
        ...,
        [  1, 117, 204],
        [  1, 117, 204],
        [  0, 119, 203]],

       [[  0, 116, 199],
        [  0, 116, 199],
        [  0, 116, 199],
        ...,
        [  1, 117, 204],
        [  1, 117, 204],
        [  0, 118, 202]],

       ...,

       [[180, 171, 127],
        [203, 194, 153],
        [201, 193, 153],
        ...,
        [179, 179, 157],
        [ 99, 100,  76],
        [139, 142,  99]],

       [[209, 201, 156],
        [203, 194, 152],
        [202, 194, 155],
        ...,
        [178, 178, 146],
        [166, 168, 135],
        [100, 107,  68]],

       [[171, 162, 120],
        [175, 166, 127],
        [165, 157, 119],
        ...,
        [148, 149, 111],
        [156, 159, 121],
        [ 76,  87,  54]]], dtype=uint8)]"
Image_1657.jpg,74,73,90,85,300,260,164,158,90,daskShared_local/images/Image_1657.jpg,1657,"[array([[[  3, 228, 253],
        [  3, 228, 253],
        [  3, 228, 253],
        ...,
        [ 19, 200, 229],
        [ 31, 200, 230],
        [ 29, 200, 230]],

       [[  3, 228, 253],
        [  3, 227, 253],
        [  3, 228, 253],
        ...,
        [ 13, 198, 231],
        [ 21, 197, 230],
        [ 20, 197, 230]],

       [[  2, 228, 253],
        [  2, 228, 253],
        [  2, 228, 253],
        ...,
        [ 43, 207, 224],
        [ 69, 211, 232],
        [ 64, 211, 231]],

       ...,

       [[  1, 186, 240],
        [  1, 186, 240],
        [  1, 186, 240],
        ...,
        [  7,  21,  22],
        [  6,  23,  24],
        [  6,  23,  24]],

       [[  1, 186, 240],
        [  1, 186, 240],
        [  2, 185, 241],
        ...,
        [  8,  28,  29],
        [  4,  27,  28],
        [  5,  27,  28]],

       [[  1, 186, 240],
        [  1, 186, 240],
        [  1, 186, 241],
        ...,
        [  7,  26,  27],
        [  5,  26,  27],
        [  5,  26,  27]]], dtype=uint8)]"
Image_1658.jpg,326,273,100,70,800,600,426,343,100,daskShared_local/images/Image_1658.jpg,1658,"[array([[[  0, 159, 254],
        [  0, 159, 254],
        [  1, 160, 254],
        ...,
        [  0, 163, 255],
        [  0, 163, 255],
        [  0, 163, 255]],

       [[  0, 159, 254],
        [  0, 159, 254],
        [  1, 160, 254],
        ...,
        [  0, 163, 255],
        [  0, 163, 255],
        [  0, 163, 255]],

       [[  1, 159, 255],
        [  1, 159, 255],
        [  1, 159, 255],
        ...,
        [  0, 163, 255],
        [  0, 163, 255],
        [  0, 163, 255]],

       ...,

       [[ 87, 137,  96],
        [ 87, 137,  96],
        [ 78, 128,  88],
        ...,
        [ 31,  43,  29],
        [ 38,  50,  36],
        [ 38,  50,  36]],

       [[103, 152, 119],
        [103, 152, 118],
        [ 90, 139, 105],
        ...,
        [ 35,  47,  33],
        [ 38,  50,  36],
        [ 39,  51,  37]],

       [[103, 152, 119],
        [103, 152, 119],
        [ 90, 139, 105],
        ...,
        [ 35,  47,  33],
        [ 39,  51,  37],
        [ 39,  51,  37]]], dtype=uint8)]"
Image_1659.jpg,296,227,302,271,1000,664,598,498,302,daskShared_local/images/Image_1659.jpg,1659,"[array([[[188, 192, 195],
        [188, 192, 195],
        [186, 190, 193],
        ...,
        [173, 163, 154],
        [164, 154, 144],
        [160, 150, 138]],

       [[185, 189, 192],
        [185, 189, 192],
        [183, 187, 190],
        ...,
        [164, 154, 144],
        [163, 153, 142],
        [177, 166, 153]],

       [[183, 187, 190],
        [183, 187, 190],
        [181, 185, 188],
        ...,
        [150, 140, 130],
        [162, 151, 139],
        [179, 167, 153]],

       ...,

       [[153, 110,  62],
        [149, 115,  68],
        [147, 118,  75],
        ...,
        [160, 137, 105],
        [161, 138, 107],
        [161, 140, 110]],

       [[162, 123,  77],
        [147, 115,  69],
        [146, 117,  75],
        ...,
        [158, 135, 104],
        [157, 135, 105],
        [158, 137, 107]],

       [[149, 121,  81],
        [144, 116,  77],
        [148, 120,  84],
        ...,
        [154, 133, 109],
        [152, 131, 107],
        [150, 130, 106]]], dtype=uint8)]"
Image_166.jpg,695,281,455,496,1920,1080,1150,777,496,daskShared_local/images/Image_166.jpg,166,"[array([[[  0, 119, 203],
        [  1, 120, 204],
        [  0, 119, 203],
        ...,
        [  1, 116, 199],
        [  1, 116, 199],
        [  1, 116, 199]],

       [[  0, 118, 202],
        [  0, 119, 203],
        [  0, 119, 203],
        ...,
        [  1, 116, 199],
        [  1, 116, 199],
        [  1, 116, 199]],

       [[  0, 118, 202],
        [  0, 119, 203],
        [  0, 119, 203],
        ...,
        [  2, 117, 200],
        [  2, 117, 200],
        [  1, 116, 199]],

       ...,

       [[ 83,  90,  58],
        [153, 159, 128],
        [152, 155, 121],
        ...,
        [140, 131,  90],
        [145, 134,  95],
        [156, 152, 111]],

       [[ 84,  93,  75],
        [103, 112,  88],
        [115, 121,  89],
        ...,
        [153, 141, 104],
        [151, 138, 102],
        [153, 144, 103]],

       [[ 95, 105,  90],
        [ 78,  89,  66],
        [ 92,  99,  70],
        ...,
        [139, 128,  94],
        [151, 138, 105],
        [159, 147, 111]]], dtype=uint8)]"
Image_1660.jpg,319,155,165,179,1200,735,484,334,179,daskShared_local/images/Image_1660.jpg,1660,"[array([[[109, 182, 199],
        [108, 181, 198],
        [109, 182, 199],
        ...,
        [ 17,  47,  78],
        [ 12,  47,  74],
        [  8,  44,  70]],

       [[106, 179, 196],
        [106, 179, 196],
        [107, 180, 197],
        ...,
        [ 19,  50,  83],
        [ 15,  50,  80],
        [ 14,  49,  78]],

       [[105, 180, 195],
        [104, 180, 194],
        [105, 180, 195],
        ...,
        [ 15,  50,  80],
        [ 14,  51,  80],
        [ 17,  56,  83]],

       ...,

       [[157, 199, 197],
        [162, 204, 202],
        [165, 208, 203],
        ...,
        [ 75,  59,  19],
        [ 60,  41,  14],
        [ 64,  43,  13]],

       [[160, 202, 198],
        [163, 205, 201],
        [166, 208, 200],
        ...,
        [146, 136,  85],
        [131, 118,  64],
        [133, 117,  62]],

       [[156, 198, 194],
        [158, 201, 194],
        [160, 203, 194],
        ...,
        [163, 157, 115],
        [163, 154, 107],
        [160, 146,  97]]], dtype=uint8)]"
Image_1661.jpg,329,223,795,618,1500,1125,1124,841,795,daskShared_local/images/Image_1661.jpg,1661,"[array([[[ 96, 170, 166],
        [ 96, 170, 167],
        [ 95, 171, 166],
        ...,
        [111, 125, 137],
        [112, 125, 139],
        [112, 129, 143]],

       [[ 94, 170, 168],
        [ 96, 170, 168],
        [ 97, 171, 169],
        ...,
        [110, 127, 137],
        [115, 131, 144],
        [116, 133, 149]],

       [[ 95, 169, 168],
        [ 95, 170, 169],
        [ 96, 171, 170],
        ...,
        [117, 128, 140],
        [122, 138, 144],
        [121, 136, 149]],

       ...,

       [[ 89, 169, 214],
        [ 91, 162, 192],
        [ 86, 150, 170],
        ...,
        [102, 143, 148],
        [ 97, 142, 147],
        [ 94, 138, 144]],

       [[ 85, 168, 219],
        [ 90, 168, 205],
        [ 85, 153, 177],
        ...,
        [104, 144, 149],
        [101, 142, 148],
        [ 95, 138, 144]],

       [[ 82, 166, 212],
        [ 88, 170, 214],
        [ 84, 159, 189],
        ...,
        [104, 144, 151],
        [ 99, 142, 148],
        [ 93, 138, 144]]], dtype=uint8)]"
Image_1662.jpg,436,213,189,174,1024,683,625,387,189,daskShared_local/images/Image_1662.jpg,1662,"[array([[[186, 148,   6],
        [154, 120,   0],
        [133, 107,   0],
        ...,
        [152, 105,  17],
        [110,  63,   0],
        [102,  60,   0]],

       [[186, 147,  15],
        [162, 128,   2],
        [136, 109,   0],
        ...,
        [135,  86,   7],
        [130,  82,   4],
        [109,  68,   0]],

       [[192, 150,   2],
        [185, 148,  14],
        [148, 119,  13],
        ...,
        [102,  67,   7],
        [105,  67,  15],
        [ 82,  34,   0]],

       ...,

       [[  4, 196, 209],
        [  4, 196, 207],
        [  3, 195, 206],
        ...,
        [  1, 151, 168],
        [  1, 151, 168],
        [  2, 152, 167]],

       [[  5, 195, 207],
        [  5, 195, 207],
        [  3, 195, 206],
        ...,
        [  0, 152, 166],
        [  0, 151, 165],
        [  1, 153, 167]],

       [[  5, 196, 206],
        [  5, 196, 206],
        [  5, 196, 206],
        ...,
        [  0, 152, 166],
        [  0, 151, 165],
        [  0, 153, 167]]], dtype=uint8)]"
Image_1663.jpg,389,107,180,172,800,600,569,279,180,daskShared_local/images/Image_1663.jpg,1663,"[array([[[245, 248, 229],
        [244, 251, 228],
        [246, 254, 226],
        ...,
        [ 73, 147, 117],
        [ 75, 152, 117],
        [ 73, 155, 115]],

       [[245, 250, 221],
        [243, 250, 218],
        [246, 253, 218],
        ...,
        [ 66, 139, 109],
        [ 74, 150, 116],
        [ 75, 156, 117]],

       [[248, 252, 220],
        [244, 250, 215],
        [245, 250, 213],
        ...,
        [ 52, 126,  95],
        [ 64, 139, 106],
        [ 74, 152, 113]],

       ...,

       [[227, 129,  27],
        [226, 128,  27],
        [222, 124,  25],
        ...,
        [ 43,  48,  36],
        [ 43,  45,  35],
        [ 48,  47,  39]],

       [[225, 127,  26],
        [223, 126,  27],
        [220, 123,  26],
        ...,
        [ 41,  41,  37],
        [ 36,  34,  31],
        [ 48,  43,  41]],

       [[222, 124,  23],
        [219, 122,  24],
        [216, 121,  25],
        ...,
        [ 33,  30,  31],
        [ 28,  22,  24],
        [ 36,  28,  32]]], dtype=uint8)]"
Image_1664.jpg,133,37,137,143,425,282,270,180,143,daskShared_local/images/Image_1664.jpg,1664,"[array([[[  0,  80, 129],
        [  0,  82, 131],
        [  0,  82, 132],
        ...,
        [  0, 128, 174],
        [  0, 132, 175],
        [  0, 134, 176]],

       [[  1,  80, 129],
        [  0,  81, 129],
        [  0,  82, 130],
        ...,
        [  0, 125, 171],
        [  0, 127, 172],
        [  1, 128, 173]],

       [[  1,  79, 128],
        [  0,  79, 128],
        [  0,  80, 128],
        ...,
        [  0, 120, 167],
        [  0, 121, 168],
        [  1, 122, 169]],

       ...,

       [[ 14,   4,   2],
        [ 15,   7,   3],
        [ 18,  11,   6],
        ...,
        [ 23,  52,  58],
        [ 24,  48,  48],
        [ 30,  50,  46]],

       [[ 18,   8,   4],
        [ 19,  10,   4],
        [ 21,  14,   6],
        ...,
        [ 81,  95,  87],
        [ 85,  95,  81],
        [ 96, 102,  83]],

       [[ 21,  11,   5],
        [ 22,  13,   5],
        [ 24,  16,   7],
        ...,
        [136, 139, 117],
        [143, 143, 116],
        [155, 152, 120]]], dtype=uint8)]"
Image_1665.jpg,325,36,129,82,623,200,454,118,129,daskShared_local/images/Image_1665.jpg,1665,"[array([[[  0, 163, 252],
        [  0, 163, 252],
        [  0, 163, 252],
        ...,
        [  2, 130, 255],
        [  2, 130, 255],
        [  2, 130, 255]],

       [[  0, 163, 252],
        [  0, 163, 252],
        [  0, 163, 252],
        ...,
        [  2, 130, 255],
        [  2, 130, 255],
        [  2, 130, 255]],

       [[  0, 163, 252],
        [  0, 163, 252],
        [  0, 163, 252],
        ...,
        [  2, 130, 255],
        [  2, 130, 255],
        [  2, 130, 255]],

       ...,

       [[ 95, 125,  85],
        [ 94, 125,  85],
        [ 95, 126,  86],
        ...,
        [  3, 103, 255],
        [  4, 103, 254],
        [  4, 103, 254]],

       [[ 88, 119,  76],
        [ 88, 119,  76],
        [ 90, 121,  77],
        ...,
        [  3, 103, 255],
        [  5, 102, 255],
        [  5, 102, 255]],

       [[ 84, 115,  71],
        [ 84, 116,  71],
        [ 86, 118,  72],
        ...,
        [  3, 102, 255],
        [  5, 102, 255],
        [  5, 101, 255]]], dtype=uint8)]"
Image_1666.jpg,71,180,221,160,600,600,292,340,221,daskShared_local/images/Image_1666.jpg,1666,"[array([[[163, 181, 169],
        [158, 173, 163],
        [155, 164, 153],
        ...,
        [155, 169, 151],
        [146, 162, 148],
        [139, 155, 142]],

       [[171, 189, 171],
        [166, 183, 170],
        [162, 175, 164],
        ...,
        [153, 170, 146],
        [142, 161, 145],
        [131, 150, 138]],

       [[171, 188, 173],
        [168, 185, 175],
        [161, 176, 166],
        ...,
        [150, 168, 139],
        [143, 168, 147],
        [133, 155, 143]],

       ...,

       [[168, 162, 127],
        [166, 159, 127],
        [162, 158, 120],
        ...,
        [129, 112,  75],
        [130, 112,  73],
        [130, 111,  74]],

       [[155, 154, 120],
        [150, 148, 120],
        [146, 144, 114],
        ...,
        [126, 110,  71],
        [128, 110,  72],
        [130, 112,  74]],

       [[133, 137, 110],
        [127, 131, 110],
        [120, 122, 107],
        ...,
        [128, 110,  74],
        [129, 111,  73],
        [129, 111,  71]]], dtype=uint8)]"
Image_1667.jpg,421,351,310,245,1536,1024,731,596,310,daskShared_local/images/Image_1667.jpg,1667,"[array([[[ 17, 141, 250],
        [ 18, 142, 249],
        [ 12, 136, 244],
        ...,
        [ 13, 170, 241],
        [ 14, 170, 243],
        [ 13, 169, 244]],

       [[ 14, 143, 245],
        [ 17, 146, 248],
        [ 16, 143, 247],
        ...,
        [ 17, 173, 247],
        [ 21, 174, 250],
        [ 18, 174, 249]],

       [[ 12, 141, 243],
        [ 14, 143, 245],
        [ 12, 140, 242],
        ...,
        [ 12, 168, 243],
        [ 14, 170, 245],
        [ 16, 172, 246]],

       ...,

       [[  9,  61, 209],
        [  9,  61, 208],
        [ 17,  69, 215],
        ...,
        [ 22,  57,  45],
        [ 13,  47,  34],
        [ 17,  46,  34]],

       [[  9,  61, 209],
        [  8,  60, 206],
        [  7,  59, 205],
        ...,
        [ 21,  67,  65],
        [ 18,  60,  59],
        [ 13,  57,  55]],

       [[  9,  61, 208],
        [  9,  61, 207],
        [ 12,  63, 209],
        ...,
        [ 22,  77,  72],
        [  5,  64,  56],
        [ 22,  84,  75]]], dtype=uint8)]"
Image_1668.jpg,296,174,224,199,1000,664,520,373,224,daskShared_local/images/Image_1668.jpg,1668,"[array([[[  1,  80, 146],
        [  0,  80, 145],
        [  0,  78, 146],
        ...,
        [  0,  99, 166],
        [  0,  97, 165],
        [  1, 100, 167]],

       [[  0,  80, 145],
        [  0,  78, 145],
        [  0,  77, 145],
        ...,
        [  0,  98, 166],
        [  0,  96, 165],
        [  0,  99, 166]],

       [[  1,  79, 147],
        [  1,  78, 146],
        [  0,  78, 145],
        ...,
        [  0,  97, 166],
        [  0,  96, 165],
        [  1,  97, 166]],

       ...,

       [[ 33,  42,  41],
        [ 33,  53,  49],
        [ 36,  54,  48],
        ...,
        [135, 104,  77],
        [118,  86,  62],
        [162, 141, 116]],

       [[ 24,  27,  25],
        [ 22,  33,  34],
        [ 28,  42,  38],
        ...,
        [144, 120,  91],
        [116,  83,  51],
        [134, 102,  66]],

       [[ 18,  18,  14],
        [ 14,  22,  25],
        [ 25,  35,  37],
        ...,
        [156, 130,  96],
        [120,  90,  56],
        [129, 103,  64]]], dtype=uint8)]"
Image_1669.jpg,614,219,378,429,1600,1070,992,648,429,daskShared_local/images/Image_1669.jpg,1669,"[array([[[ 22,  75, 145],
        [ 23,  74, 145],
        [ 24,  74, 145],
        ...,
        [ 28,  69, 133],
        [ 28,  69, 133],
        [ 28,  69, 133]],

       [[ 22,  75, 145],
        [ 23,  74, 145],
        [ 24,  74, 145],
        ...,
        [ 28,  69, 133],
        [ 28,  69, 133],
        [ 28,  69, 133]],

       [[ 26,  73, 145],
        [ 25,  74, 143],
        [ 24,  75, 142],
        ...,
        [ 28,  69, 133],
        [ 28,  69, 133],
        [ 28,  69, 133]],

       ...,

       [[145, 149, 140],
        [150, 157, 145],
        [144, 153, 142],
        ...,
        [155, 136, 108],
        [176, 157, 120],
        [178, 158, 125]],

       [[141, 143, 129],
        [124, 126, 113],
        [114, 115, 103],
        ...,
        [140, 123,  93],
        [171, 152, 112],
        [166, 142, 109]],

       [[126, 113,  86],
        [123, 114,  92],
        [115, 108,  88],
        ...,
        [111,  91,  52],
        [152, 127,  78],
        [164, 131,  91]]], dtype=uint8)]"
Image_167.jpg,36,85,217,156,800,600,253,241,217,daskShared_local/images/Image_167.jpg,167,"[array([[[  0, 154, 203],
        [  9, 159, 210],
        [  8, 155, 209],
        ...,
        [ 17, 175, 222],
        [ 20, 177, 225],
        [ 22, 179, 224]],

       [[  0, 154, 204],
        [  3, 154, 205],
        [  4, 151, 205],
        ...,
        [ 11, 172, 218],
        [ 19, 177, 224],
        [ 20, 178, 223]],

       [[  1, 155, 205],
        [  0, 154, 206],
        [  5, 154, 207],
        ...,
        [ 13, 173, 219],
        [ 19, 177, 224],
        [ 20, 179, 221]],

       ...,

       [[ 72, 146, 124],
        [ 73, 144, 122],
        [ 75, 139, 120],
        ...,
        [104,  87,  66],
        [107,  89,  67],
        [117, 102,  77]],

       [[ 69, 143, 120],
        [ 70, 142, 122],
        [ 70, 136, 118],
        ...,
        [114,  94,  72],
        [106,  86,  64],
        [112,  91,  70]],

       [[ 67, 139, 119],
        [ 65, 135, 117],
        [ 67, 134, 117],
        ...,
        [103,  83,  61],
        [108,  86,  67],
        [111,  88,  70]]], dtype=uint8)]"
Image_1670.jpg,441,216,182,200,1200,630,623,416,200,daskShared_local/images/Image_1670.jpg,1670,"[array([[[ 35, 109, 172],
        [ 33, 107, 172],
        [ 30, 104, 169],
        ...,
        [ 39,  70,  72],
        [ 48,  78,  80],
        [ 34,  62,  65]],

       [[ 29, 100, 164],
        [ 27,  98, 162],
        [ 25,  96, 162],
        ...,
        [ 44,  74,  76],
        [ 46,  74,  77],
        [ 58,  83,  87]],

       [[ 22,  93, 155],
        [ 20,  91, 153],
        [ 20,  91, 155],
        ...,
        [ 32,  60,  63],
        [ 36,  61,  65],
        [ 53,  74,  79]],

       ...,

       [[ 25,  67,  89],
        [ 31,  73,  95],
        [ 27,  70,  89],
        ...,
        [ 46,  61,  56],
        [ 67,  84,  78],
        [ 88, 107, 101]],

       [[ 29,  65,  89],
        [ 31,  69,  92],
        [ 25,  63,  86],
        ...,
        [ 72,  89,  83],
        [ 88, 107, 101],
        [ 94, 113, 107]],

       [[ 35,  69,  96],
        [ 33,  67,  94],
        [ 21,  57,  81],
        ...,
        [ 81,  98,  92],
        [ 89, 108, 102],
        [ 73,  94,  87]]], dtype=uint8)]"
Image_1671.jpg,368,137,241,191,869,574,609,328,241,daskShared_local/images/Image_1671.jpg,1671,"[array([[[ 39, 162, 224],
        [ 42, 159, 221],
        [ 47, 162, 223],
        ...,
        [ 84, 166, 242],
        [ 85, 167, 243],
        [ 76, 166, 238]],

       [[ 70, 174, 242],
        [ 75, 177, 243],
        [ 78, 182, 246],
        ...,
        [ 83, 165, 241],
        [ 83, 165, 241],
        [ 79, 168, 240]],

       [[ 72, 171, 240],
        [ 71, 176, 241],
        [ 79, 185, 248],
        ...,
        [ 83, 165, 241],
        [ 83, 165, 241],
        [ 81, 168, 240]],

       ...,

       [[ 11,  29,  21],
        [  7,  14,  10],
        [  8,   9,   7],
        ...,
        [  0, 106, 180],
        [  0, 106, 180],
        [  2, 104, 179]],

       [[  7,   9,   6],
        [  8,  10,   8],
        [  5,   6,   5],
        ...,
        [  0, 105, 179],
        [  0, 105, 179],
        [  2, 104, 179]],

       [[  1,  16,  12],
        [  8,  36,  28],
        [  6,  22,  17],
        ...,
        [  2, 104, 179],
        [  2, 104, 179],
        [  2, 104, 179]]], dtype=uint8)]"
Image_1672.jpg,1864,624,1227,1163,4752,3168,3091,1787,1227,daskShared_local/images/Image_1672.jpg,1672,"[array([[[ 66,  70,  51],
        [ 67,  69,  52],
        [ 69,  69,  47],
        ...,
        [ 55, 128, 151],
        [ 55, 127, 151],
        [ 56, 128, 151]],

       [[ 68,  67,  44],
        [ 69,  68,  45],
        [ 69,  67,  41],
        ...,
        [ 53, 125, 149],
        [ 53, 124, 149],
        [ 54, 125, 149]],

       [[ 67,  61,  37],
        [ 67,  61,  36],
        [ 68,  63,  34],
        ...,
        [ 49, 121, 148],
        [ 50, 121, 149],
        [ 51, 122, 149]],

       ...,

       [[ 41, 122, 150],
        [ 45, 122, 150],
        [ 33, 112, 144],
        ...,
        [143, 131, 108],
        [100,  86,  75],
        [108,  90,  68]],

       [[ 54, 136, 156],
        [ 52, 133, 153],
        [ 49, 129, 152],
        ...,
        [141, 127, 107],
        [126, 111,  89],
        [165, 152, 111]],

       [[ 59, 141, 155],
        [ 58, 139, 153],
        [ 58, 139, 155],
        ...,
        [158, 144, 113],
        [176, 165, 130],
        [200, 196, 161]]], dtype=uint8)]"
Image_1673.jpg,1735,533,1359,1612,4631,3087,3094,2145,1612,daskShared_local/images/Image_1673.jpg,1673,"[array([[[ 20,  94, 241],
        [ 20,  94, 241],
        [ 20,  94, 241],
        ...,
        [  1,  60, 197],
        [  1,  60, 196],
        [  1,  60, 196]],

       [[ 20,  93, 240],
        [ 20,  94, 240],
        [ 20,  94, 240],
        ...,
        [  0,  59, 196],
        [  0,  59, 195],
        [  0,  59, 195]],

       [[ 21,  93, 240],
        [ 21,  93, 240],
        [ 21,  93, 240],
        ...,
        [  0,  59, 195],
        [  0,  59, 195],
        [  0,  58, 194]],

       ...,

       [[ 30,  60,  68],
        [ 29,  43,  45],
        [ 27,  35,  41],
        ...,
        [ 35,  41,  24],
        [ 34,  39,  23],
        [ 28,  36,  16]],

       [[ 24,  33,  43],
        [ 25,  34,  41],
        [ 26,  33,  38],
        ...,
        [ 36,  41,  24],
        [ 36,  41,  23],
        [ 32,  39,  19]],

       [[ 23,  29,  36],
        [ 23,  30,  34],
        [ 25,  30,  34],
        ...,
        [ 40,  46,  26],
        [ 44,  50,  27],
        [ 41,  46,  27]]], dtype=uint8)]"
Image_1674.jpg,406,142,243,230,1024,686,649,372,243,daskShared_local/images/Image_1674.jpg,1674,"[array([[[ 36, 188, 237],
        [ 34, 188, 238],
        [ 32, 188, 239],
        ...,
        [  0, 159, 219],
        [  0, 159, 219],
        [  0, 156, 217]],

       [[ 33, 189, 237],
        [ 32, 189, 238],
        [ 32, 188, 239],
        ...,
        [  0, 159, 219],
        [  0, 159, 219],
        [  0, 156, 217]],

       [[ 28, 189, 236],
        [ 29, 188, 237],
        [ 32, 188, 239],
        ...,
        [  0, 157, 218],
        [  0, 157, 218],
        [  0, 156, 217]],

       ...,

       [[245, 237, 236],
        [232, 223, 219],
        [216, 205, 194],
        ...,
        [  6, 117, 182],
        [  8, 119, 184],
        [  8, 121, 186]],

       [[238, 227, 228],
        [237, 228, 230],
        [226, 223, 217],
        ...,
        [  7, 117, 180],
        [  9, 119, 182],
        [  7, 121, 184]],

       [[238, 228, 229],
        [234, 226, 228],
        [231, 228, 224],
        ...,
        [ 11, 119, 181],
        [  9, 117, 180],
        [  5, 118, 180]]], dtype=uint8)]"
Image_1675.jpg,433,235,179,170,900,586,612,405,179,daskShared_local/images/Image_1675.jpg,1675,"[array([[[178, 223, 194],
        [178, 226, 205],
        [171, 229, 219],
        ...,
        [101, 203, 225],
        [102, 204, 226],
        [103, 205, 227]],

       [[182, 227, 226],
        [185, 227, 230],
        [183, 224, 231],
        ...,
        [ 99, 203, 225],
        [100, 204, 226],
        [102, 204, 227]],

       [[182, 229, 238],
        [180, 227, 239],
        [176, 224, 237],
        ...,
        [ 97, 202, 224],
        [ 98, 203, 225],
        [100, 204, 226]],

       ...,

       [[ 61,  92,  60],
        [ 80, 108,  78],
        [103, 130,  96],
        ...,
        [  2, 171, 214],
        [  2, 172, 215],
        [  2, 172, 215]],

       [[ 38,  76,  38],
        [ 51,  86,  49],
        [ 83, 114,  77],
        ...,
        [  0, 172, 214],
        [  0, 172, 214],
        [  0, 172, 214]],

       [[ 47,  86,  51],
        [ 66, 102,  66],
        [ 86, 120,  85],
        ...,
        [  0, 173, 215],
        [  0, 173, 215],
        [  0, 173, 215]]], dtype=uint8)]"
Image_1676.jpg,518,245,320,209,1200,900,838,454,320,daskShared_local/images/Image_1676.jpg,1676,"[array([[[ 80, 184, 200],
        [ 72, 184, 199],
        [ 68, 178, 200],
        ...,
        [ 91, 190, 210],
        [ 66, 184, 201],
        [ 75, 186, 200]],

       [[ 73, 183, 197],
        [ 70, 183, 198],
        [ 59, 182, 199],
        ...,
        [ 91, 190, 209],
        [ 73, 185, 203],
        [ 71, 184, 198]],

       [[ 58, 179, 186],
        [ 49, 171, 175],
        [ 53, 171, 178],
        ...,
        [ 75, 187, 203],
        [ 83, 188, 203],
        [ 75, 186, 203]],

       ...,

       [[120, 162, 152],
        [109, 160, 154],
        [137, 188, 187],
        ...,
        [116, 192, 208],
        [126, 200, 209],
        [146, 207, 218]],

       [[164, 199, 198],
        [176, 210, 210],
        [188, 219, 223],
        ...,
        [130, 199, 212],
        [140, 203, 211],
        [161, 212, 226]],

       [[209, 233, 238],
        [221, 240, 243],
        [213, 235, 239],
        ...,
        [138, 199, 209],
        [152, 208, 212],
        [174, 217, 224]]], dtype=uint8)]"
Image_1677.jpg,731,432,497,375,2119,1414,1228,807,497,daskShared_local/images/Image_1677.jpg,1677,"[array([[[108, 172, 199],
        [104, 168, 195],
        [105, 166, 195],
        ...,
        [ 73, 137, 169],
        [ 69, 134, 166],
        [ 68, 133, 165]],

       [[107, 168, 196],
        [101, 163, 191],
        [102, 163, 192],
        ...,
        [ 74, 139, 171],
        [ 73, 138, 170],
        [ 71, 136, 168]],

       [[104, 163, 191],
        [ 99, 158, 186],
        [ 95, 154, 184],
        ...,
        [ 69, 134, 166],
        [ 72, 137, 169],
        [ 63, 128, 160]],

       ...,

       [[ 76, 172, 196],
        [ 75, 171, 195],
        [ 77, 173, 197],
        ...,
        [100,  79,  36],
        [119, 100,  55],
        [117,  98,  52]],

       [[ 74, 173, 197],
        [ 74, 172, 196],
        [ 75, 172, 197],
        ...,
        [121,  99,  48],
        [121, 101,  51],
        [117,  98,  49]],

       [[ 72, 172, 196],
        [ 71, 171, 195],
        [ 74, 172, 197],
        ...,
        [127, 105,  56],
        [134, 114,  67],
        [129, 111,  66]]], dtype=uint8)]"
Image_1678.png,243,35,81,83,589,295,324,118,83,daskShared_local/images/Image_1678.png,1678,"[array([[[  0, 168, 193],
        [  0, 167, 193],
        [  0, 169, 194],
        ...,
        [  0, 171, 187],
        [  0, 170, 187],
        [  0, 170, 187]],

       [[  0, 169, 194],
        [  0, 169, 194],
        [  0, 170, 194],
        ...,
        [  0, 171, 186],
        [  0, 169, 185],
        [  0, 170, 186]],

       [[  0, 166, 193],
        [  0, 165, 192],
        [  0, 168, 194],
        ...,
        [  0, 172, 189],
        [  0, 171, 189],
        [  0, 171, 189]],

       ...,

       [[ 40,  23,  24],
        [ 37,  22,  22],
        [ 45,  25,  25],
        ...,
        [ 87,  53,  51],
        [ 93,  63,  64],
        [ 91,  59,  59]],

       [[ 33,  21,  24],
        [ 30,  21,  23],
        [ 38,  22,  24],
        ...,
        [ 94,  68,  69],
        [138, 113, 113],
        [121,  96,  96]],

       [[ 36,  22,  24],
        [ 33,  21,  23],
        [ 41,  23,  25],
        ...,
        [ 91,  62,  62],
        [120,  94,  94],
        [109,  82,  82]]], dtype=uint8)]"
Image_1679.jpg,216,193,167,159,500,559,383,352,167,daskShared_local/images/Image_1679.jpg,1679,"[array([[[ 91, 175, 172],
        [ 91, 171, 169],
        [ 91, 169, 168],
        ...,
        [110, 205, 195],
        [115, 207, 198],
        [119, 210, 201]],

       [[105, 171, 164],
        [102, 165, 160],
        [ 99, 161, 159],
        ...,
        [104, 201, 189],
        [108, 204, 193],
        [112, 207, 196]],

       [[146, 189, 180],
        [141, 184, 175],
        [136, 179, 174],
        ...,
        [ 97, 195, 182],
        [ 99, 197, 186],
        [104, 201, 190]],

       ...,

       [[ 11,   6,   7],
        [  8,   3,   2],
        [ 11,   3,   1],
        ...,
        [  5, 179, 185],
        [  9, 172, 174],
        [ 12, 166, 165]],

       [[ 22,  16,  13],
        [ 14,   8,   3],
        [ 10,   3,   0],
        ...,
        [  2, 186, 200],
        [  3, 185, 198],
        [  4, 185, 195]],

       [[ 26,  18,   8],
        [ 19,  12,   2],
        [ 12,   4,   0],
        ...,
        [  0, 183, 199],
        [  0, 185, 198],
        [  0, 186, 197]]], dtype=uint8)]"
Image_168.jpg,475,131,264,317,1600,1019,739,448,317,daskShared_local/images/Image_168.jpg,168,"[array([[[ 26, 109, 213],
        [ 26, 109, 213],
        [ 26, 109, 213],
        ...,
        [ 28, 116, 213],
        [ 28, 116, 213],
        [ 28, 116, 213]],

       [[ 26, 109, 213],
        [ 26, 109, 213],
        [ 26, 109, 213],
        ...,
        [ 28, 116, 213],
        [ 28, 116, 213],
        [ 28, 116, 213]],

       [[ 26, 109, 213],
        [ 26, 109, 213],
        [ 26, 109, 213],
        ...,
        [ 28, 116, 213],
        [ 28, 116, 213],
        [ 28, 116, 213]],

       ...,

       [[220, 220, 219],
        [253, 253, 250],
        [252, 252, 247],
        ...,
        [163, 107, 107],
        [162,  98,  98],
        [110,  41,  40]],

       [[224, 224, 225],
        [249, 249, 249],
        [252, 253, 249],
        ...,
        [110,  45,  46],
        [119,  44,  45],
        [ 96,  14,  16]],

       [[237, 237, 239],
        [243, 243, 244],
        [249, 250, 246],
        ...,
        [ 76,   9,  10],
        [ 86,   6,   9],
        [ 88,   0,   2]]], dtype=uint8)]"
Image_1680.jpg,362,98,145,190,728,486,507,288,190,daskShared_local/images/Image_1680.jpg,1680,"[array([[[  1,  70, 253],
        [  2,  67, 255],
        [  1,  64, 253],
        ...,
        [  0, 106, 254],
        [  0, 106, 254],
        [  2, 108, 252]],

       [[  1,  66, 254],
        [  2,  65, 255],
        [  1,  64, 255],
        ...,
        [  0, 107, 255],
        [  0, 106, 254],
        [  1, 105, 254]],

       [[  1,  64, 255],
        [  1,  64, 253],
        [  0,  66, 252],
        ...,
        [  0, 106, 251],
        [  0, 104, 255],
        [  0, 106, 254]],

       ...,

       [[162, 120,  98],
        [162, 126, 102],
        [117,  91,  76],
        ...,
        [ 63,  63,  58],
        [ 64,  60,  55],
        [ 68,  64,  60]],

       [[175, 130, 107],
        [169, 127, 103],
        [170, 132, 106],
        ...,
        [ 61,  64,  56],
        [ 66,  64,  57],
        [ 68,  65,  58]],

       [[200, 158, 134],
        [195, 154, 133],
        [183, 146, 125],
        ...,
        [ 64,  73,  54],
        [ 73,  80,  64],
        [ 78,  80,  69]]], dtype=uint8)]"
Image_1681.jpg,280,163,176,166,800,533,456,329,176,daskShared_local/images/Image_1681.jpg,1681,"[array([[[254, 255, 255],
        [254, 255, 255],
        [254, 255, 254],
        ...,
        [ 89,  98, 116],
        [ 73,  82,  99],
        [ 43,  52,  69]],

       [[254, 255, 255],
        [254, 255, 255],
        [254, 255, 254],
        ...,
        [ 83,  93, 111],
        [ 75,  86, 104],
        [ 65,  75,  93]],

       [[255, 244, 227],
        [255, 242, 224],
        [255, 237, 219],
        ...,
        [ 86,  88, 110],
        [ 96,  98, 119],
        [ 94,  95, 116]],

       ...,

       [[139, 111,  99],
        [141, 113, 101],
        [145, 117, 105],
        ...,
        [ 80,  62,  52],
        [ 77,  59,  48],
        [ 73,  55,  45]],

       [[151, 123, 111],
        [155, 127, 115],
        [157, 129, 117],
        ...,
        [ 81,  63,  51],
        [ 85,  67,  54],
        [ 86,  68,  56]],

       [[170, 142, 130],
        [169, 141, 129],
        [161, 133, 121],
        ...,
        [ 97,  79,  65],
        [105,  87,  73],
        [111,  93,  79]]], dtype=uint8)]"
Image_1682.jpg,699,265,462,507,1920,1080,1161,772,507,daskShared_local/images/Image_1682.jpg,1682,"[array([[[  0, 119, 203],
        [  0, 119, 203],
        [  0, 119, 203],
        ...,
        [  2, 117, 200],
        [  2, 117, 200],
        [  2, 117, 200]],

       [[  0, 119, 203],
        [  0, 119, 203],
        [  0, 119, 203],
        ...,
        [  2, 117, 200],
        [  2, 117, 200],
        [  2, 117, 200]],

       [[  0, 119, 203],
        [  0, 118, 202],
        [  0, 118, 202],
        ...,
        [  2, 117, 200],
        [  2, 117, 200],
        [  2, 117, 200]],

       ...,

       [[ 95, 101,  71],
        [171, 173, 152],
        [162, 158, 136],
        ...,
        [194, 186, 149],
        [142, 135,  96],
        [108, 103,  62]],

       [[122, 128,  99],
        [173, 174, 149],
        [150, 146, 121],
        ...,
        [205, 199, 156],
        [189, 181, 141],
        [134, 126,  88]],

       [[148, 155, 123],
        [160, 163, 130],
        [161, 160, 123],
        ...,
        [185, 179, 133],
        [174, 166, 126],
        [152, 142, 106]]], dtype=uint8)]"
Image_1683.jpg,318,134,282,213,845,563,600,347,282,daskShared_local/images/Image_1683.jpg,1683,"[array([[[ 44, 184, 187],
        [ 50, 179, 182],
        [ 55, 177, 180],
        ...,
        [ 95, 198, 194],
        [ 91, 196, 192],
        [ 89, 195, 193]],

       [[ 37, 182, 189],
        [ 48, 180, 184],
        [ 58, 179, 183],
        ...,
        [102, 203, 199],
        [ 96, 199, 196],
        [ 91, 197, 194]],

       [[ 37, 184, 189],
        [ 49, 182, 186],
        [ 60, 183, 187],
        ...,
        [105, 206, 202],
        [ 99, 202, 198],
        [ 93, 199, 196]],

       ...,

       [[ 62, 108,  40],
        [ 66, 107,  42],
        [ 72, 112,  48],
        ...,
        [ 38, 191, 188],
        [ 32, 187, 183],
        [ 27, 186, 182]],

       [[ 48,  85,  20],
        [ 55,  85,  29],
        [ 64,  93,  40],
        ...,
        [ 49, 195, 191],
        [ 43, 192, 189],
        [ 40, 191, 188]],

       [[ 49,  84,  17],
        [ 50,  81,  22],
        [ 55,  85,  29],
        ...,
        [ 60, 199, 193],
        [ 58, 198, 193],
        [ 57, 199, 193]]], dtype=uint8)]"
Image_1684.jpg,311,210,190,204,1000,600,501,414,204,daskShared_local/images/Image_1684.jpg,1684,"[array([[[  1, 146, 193],
        [  1, 146, 193],
        [  1, 146, 193],
        ...,
        [  1, 158, 201],
        [  1, 158, 201],
        [  1, 158, 201]],

       [[  1, 146, 193],
        [  1, 146, 193],
        [  1, 146, 193],
        ...,
        [  1, 158, 201],
        [  1, 158, 201],
        [  1, 158, 201]],

       [[  1, 146, 193],
        [  1, 146, 193],
        [  1, 146, 193],
        ...,
        [  1, 158, 201],
        [  1, 158, 201],
        [  1, 158, 201]],

       ...,

       [[202, 154,  76],
        [222, 177,  99],
        [214, 180,  84],
        ...,
        [244, 223, 158],
        [245, 222, 155],
        [245, 221, 151]],

       [[219, 164, 111],
        [219, 176,  84],
        [179, 150,  54],
        ...,
        [244, 224, 163],
        [244, 223, 158],
        [245, 222, 155]],

       [[220, 170, 110],
        [189, 153,  60],
        [127, 101,  28],
        ...,
        [244, 225, 169],
        [243, 224, 165],
        [244, 222, 162]]], dtype=uint8)]"
Image_1685.jpg,35,82,254,176,800,600,289,258,254,daskShared_local/images/Image_1685.jpg,1685,"[array([[[  1, 154, 208],
        [  3, 154, 208],
        [  7, 155, 207],
        ...,
        [ 17, 178, 230],
        [ 17, 177, 230],
        [ 19, 179, 231]],

       [[  1, 155, 207],
        [  3, 154, 207],
        [  4, 151, 204],
        ...,
        [ 10, 174, 227],
        [ 15, 177, 231],
        [ 14, 175, 227]],

       [[  2, 155, 206],
        [  2, 153, 204],
        [  6, 153, 205],
        ...,
        [ 16, 177, 230],
        [ 17, 178, 231],
        [ 18, 176, 229]],

       ...,

       [[ 68, 127, 104],
        [ 66, 128, 103],
        [ 66, 126, 102],
        ...,
        [ 79,  34,  29],
        [ 75,  30,  27],
        [ 79,  39,  32]],

       [[ 66, 122, 103],
        [ 65, 121, 102],
        [ 66, 120, 104],
        ...,
        [ 84,  42,  37],
        [ 84,  41,  39],
        [ 90,  53,  50]],

       [[ 61, 114,  96],
        [ 61, 113,  98],
        [ 63, 113, 101],
        ...,
        [ 76,  34,  33],
        [ 79,  35,  38],
        [ 74,  38,  37]]], dtype=uint8)]"
Image_1686.png,354,183,342,287,900,600,696,470,342,daskShared_local/images/Image_1686.png,1686,"[array([[[107,  92,  80],
        [115,  96,  76],
        [125, 124, 115],
        ...,
        [ 41, 160, 186],
        [ 16, 148, 187],
        [ 20, 148, 181]],

       [[ 98,  87,  82],
        [ 97,  86,  78],
        [127, 111,  94],
        ...,
        [ 20, 148, 182],
        [  7, 154, 182],
        [ 12, 151, 183]],

       [[102,  86,  79],
        [104,  95,  85],
        [120, 108,  99],
        ...,
        [ 15, 149, 185],
        [ 16, 148, 185],
        [  9, 152, 181]],

       ...,

       [[ 84, 150, 136],
        [ 73, 150, 133],
        [ 75, 147, 132],
        ...,
        [106, 164, 155],
        [107, 165, 155],
        [110, 166, 159]],

       [[ 92, 161, 150],
        [ 86, 156, 143],
        [ 83, 155, 145],
        ...,
        [109, 175, 165],
        [102, 174, 167],
        [111, 168, 164]],

       [[ 88, 165, 153],
        [ 86, 160, 145],
        [ 88, 155, 148],
        ...,
        [109, 172, 168],
        [111, 176, 168],
        [110, 174, 168]]], dtype=uint8)]"
Image_1687.jpg,425,151,267,257,1200,822,692,408,267,daskShared_local/images/Image_1687.jpg,1687,"[array([[[  2, 147, 174],
        [  1, 146, 173],
        [  0, 145, 172],
        ...,
        [  1, 166, 194],
        [  1, 166, 194],
        [  1, 166, 194]],

       [[  1, 146, 173],
        [  1, 146, 173],
        [  0, 145, 172],
        ...,
        [  0, 164, 192],
        [  0, 164, 192],
        [  0, 164, 192]],

       [[  1, 146, 173],
        [  0, 145, 172],
        [  0, 145, 172],
        ...,
        [  0, 164, 192],
        [  0, 164, 192],
        [  0, 164, 192]],

       ...,

       [[ 79, 100,  51],
        [ 96, 117,  59],
        [101, 125,  63],
        ...,
        [170, 123,  52],
        [182, 140,  58],
        [238, 205, 127]],

       [[ 73,  86,  44],
        [ 81,  96,  44],
        [ 98, 116,  56],
        ...,
        [160, 115,  47],
        [166, 128,  49],
        [190, 163,  90]],

       [[ 73,  80,  46],
        [ 65,  74,  33],
        [ 77,  89,  39],
        ...,
        [143, 105,  50],
        [138, 104,  40],
        [122,  99,  38]]], dtype=uint8)]"
Image_1688.jpg,256,390,828,665,1512,1231,1084,1055,828,daskShared_local/images/Image_1688.jpg,1688,"[array([[[ 72,  86,  74],
        [ 76,  89,  78],
        [ 74,  87,  78],
        ...,
        [109, 136, 116],
        [ 88, 120,  97],
        [ 82, 116,  91]],

       [[ 72,  85,  77],
        [ 76,  88,  81],
        [ 77,  89,  83],
        ...,
        [112, 139, 120],
        [ 92, 123, 102],
        [ 83, 115,  92]],

       [[ 73,  86,  80],
        [ 78,  91,  86],
        [ 77,  91,  87],
        ...,
        [116, 142, 122],
        [ 96, 126, 104],
        [ 83, 115,  91]],

       ...,

       [[254, 237, 217],
        [254, 238, 215],
        [255, 240, 214],
        ...,
        [235, 207, 176],
        [234, 207, 173],
        [232, 207, 169]],

       [[254, 237, 215],
        [254, 237, 214],
        [254, 237, 215],
        ...,
        [217, 184, 140],
        [225, 195, 151],
        [233, 206, 163]],

       [[253, 236, 211],
        [252, 234, 212],
        [245, 227, 209],
        ...,
        [218, 189, 141],
        [226, 199, 152],
        [229, 203, 160]]], dtype=uint8)]"
Image_1689.jpg,467,130,276,309,1600,1019,743,439,309,daskShared_local/images/Image_1689.jpg,1689,"[array([[[ 26, 109, 213],
        [ 26, 109, 213],
        [ 26, 109, 213],
        ...,
        [ 28, 116, 213],
        [ 28, 116, 213],
        [ 28, 116, 213]],

       [[ 26, 109, 213],
        [ 26, 109, 213],
        [ 26, 109, 213],
        ...,
        [ 28, 116, 213],
        [ 28, 116, 213],
        [ 28, 116, 213]],

       [[ 26, 109, 213],
        [ 26, 109, 213],
        [ 26, 109, 213],
        ...,
        [ 28, 116, 213],
        [ 28, 116, 213],
        [ 28, 116, 213]],

       ...,

       [[199, 202, 183],
        [217, 220, 203],
        [234, 236, 222],
        ...,
        [ 42,  17,   3],
        [ 47,  30,  15],
        [ 71,  64,  50]],

       [[210, 213, 195],
        [234, 236, 222],
        [233, 235, 222],
        ...,
        [ 47,  22,   9],
        [ 62,  43,  30],
        [ 82,  69,  57]],

       [[237, 239, 225],
        [246, 248, 235],
        [238, 240, 228],
        ...,
        [ 46,  20,  10],
        [ 63,  41,  30],
        [ 75,  57,  47]]], dtype=uint8)]"
Image_169.jpg,254,386,845,625,1512,1231,1099,1011,845,daskShared_local/images/Image_169.jpg,169,"[array([[[ 76,  90,  83],
        [ 73,  87,  80],
        [ 73,  87,  80],
        ...,
        [ 83, 119,  84],
        [ 79, 116,  81],
        [ 76, 111,  78]],

       [[ 76,  87,  79],
        [ 74,  86,  78],
        [ 74,  86,  78],
        ...,
        [ 86, 121,  88],
        [ 80, 117,  83],
        [ 76, 112,  79]],

       [[ 77,  86,  79],
        [ 73,  84,  76],
        [ 74,  85,  76],
        ...,
        [ 94, 127,  95],
        [ 85, 121,  87],
        [ 79, 116,  82]],

       ...,

       [[254, 241, 215],
        [255, 241, 215],
        [255, 241, 215],
        ...,
        [237, 209, 169],
        [241, 214, 181],
        [245, 223, 198]],

       [[254, 241, 215],
        [255, 241, 215],
        [255, 241, 215],
        ...,
        [229, 199, 156],
        [226, 194, 152],
        [232, 201, 165]],

       [[255, 241, 215],
        [255, 241, 215],
        [255, 241, 215],
        ...,
        [242, 214, 172],
        [229, 196, 149],
        [223, 186, 140]]], dtype=uint8)]"
Image_1690.jpg,998,142,238,344,1686,1216,1236,486,344,daskShared_local/images/Image_1690.jpg,1690,"[array([[[126, 183, 213],
        [125, 182, 212],
        [124, 181, 211],
        ...,
        [161, 201, 226],
        [161, 201, 226],
        [161, 201, 226]],

       [[122, 181, 211],
        [125, 184, 214],
        [122, 181, 211],
        ...,
        [161, 201, 226],
        [161, 201, 226],
        [161, 201, 226]],

       [[122, 181, 211],
        [124, 183, 213],
        [121, 180, 210],
        ...,
        [161, 201, 226],
        [161, 201, 226],
        [162, 202, 227]],

       ...,

       [[173, 182, 181],
        [150, 157, 150],
        [151, 155, 142],
        ...,
        [ 79, 161, 198],
        [ 81, 163, 200],
        [ 80, 162, 199]],

       [[193, 205, 200],
        [179, 188, 180],
        [154, 160, 148],
        ...,
        [ 82, 164, 201],
        [ 80, 162, 199],
        [ 80, 162, 199]],

       [[187, 203, 194],
        [191, 203, 193],
        [185, 195, 182],
        ...,
        [ 82, 164, 201],
        [ 82, 164, 201],
        [ 80, 162, 199]]], dtype=uint8)]"
Image_1691.jpg,423,166,854,639,1500,1000,1277,805,854,daskShared_local/images/Image_1691.jpg,1691,"[array([[[  1,  60,  66],
        [  1,  60,  66],
        [  0,  59,  65],
        ...,
        [130, 124, 164],
        [132, 125, 165],
        [134, 128, 168]],

       [[  3,  58,  65],
        [  2,  58,  65],
        [  1,  59,  65],
        ...,
        [108, 105, 151],
        [104, 102, 147],
        [102, 101, 144]],

       [[  3,  58,  65],
        [  3,  58,  65],
        [  2,  57,  64],
        ...,
        [ 86,  89, 140],
        [ 78,  81, 131],
        [ 71,  76, 120]],

       ...,

       [[177, 185, 202],
        [188, 193, 206],
        [185, 191, 204],
        ...,
        [ 66, 103,  60],
        [ 65, 102,  59],
        [ 64, 103,  58]],

       [[164, 175, 199],
        [177, 186, 202],
        [178, 185, 203],
        ...,
        [ 65, 104,  61],
        [ 64, 103,  59],
        [ 63, 104,  60]],

       [[156, 169, 198],
        [170, 181, 202],
        [171, 179, 203],
        ...,
        [ 62, 104,  60],
        [ 62, 104,  60],
        [ 63, 104,  60]]], dtype=uint8)]"
Image_1692.jpg,357,126,230,191,1280,720,587,317,230,daskShared_local/images/Image_1692.jpg,1692,"[array([[[  9, 105, 192],
        [ 11, 107, 194],
        [ 14, 110, 197],
        ...,
        [ 27, 149, 223],
        [ 30, 152, 225],
        [ 28, 150, 223]],

       [[  9, 105, 192],
        [ 13, 109, 196],
        [ 14, 110, 197],
        ...,
        [ 19, 141, 216],
        [ 23, 145, 220],
        [ 25, 147, 222]],

       [[ 14, 110, 197],
        [ 17, 113, 200],
        [ 17, 113, 200],
        ...,
        [ 12, 134, 209],
        [ 15, 137, 212],
        [ 17, 139, 214]],

       ...,

       [[ 16,  81, 173],
        [ 12,  77, 169],
        [  9,  74, 166],
        ...,
        [ 14,  11,   5],
        [ 61,  56,  48],
        [161, 153, 135]],

       [[  9,  74, 166],
        [ 10,  75, 167],
        [ 13,  78, 170],
        ...,
        [ 31,  27,  24],
        [127, 120, 111],
        [190, 181, 168]],

       [[ 12,  76, 167],
        [ 10,  75, 165],
        [  9,  73, 164],
        ...,
        [ 91,  93,  80],
        [108, 109,  95],
        [ 76,  78,  64]]], dtype=uint8)]"
Image_1693.jpg,603,226,150,105,1000,667,753,331,150,daskShared_local/images/Image_1693.jpg,1693,"[array([[[  5, 150, 175],
        [  4, 145, 170],
        [  2, 136, 162],
        ...,
        [ 12,  82,  93],
        [ 13,  86,  97],
        [ 12,  89,  99]],

       [[  4, 152, 177],
        [  4, 149, 174],
        [  3, 142, 167],
        ...,
        [ 17,  89, 101],
        [ 21,  96, 108],
        [ 21, 101, 112]],

       [[  4, 154, 178],
        [  4, 153, 178],
        [  4, 149, 173],
        ...,
        [ 20,  94, 107],
        [ 27, 105, 117],
        [ 30, 112, 123]],

       ...,

       [[146, 154, 138],
        [129, 137, 121],
        [111, 120, 104],
        ...,
        [ 58,  94, 101],
        [ 61,  96, 103],
        [ 62,  96, 103]],

       [[144, 152, 137],
        [136, 143, 129],
        [119, 126, 111],
        ...,
        [ 55,  84,  91],
        [ 58,  86,  94],
        [ 58,  86,  93]],

       [[123, 131, 116],
        [132, 140, 125],
        [128, 136, 121],
        ...,
        [ 49,  76,  84],
        [ 52,  79,  86],
        [ 52,  78,  85]]], dtype=uint8)]"
Image_1694.jpg,448,280,169,171,850,567,617,451,171,daskShared_local/images/Image_1694.jpg,1694,"[array([[[100,  62,  45],
        [162, 111,  76],
        [170, 115,  89],
        ...,
        [ 48,  57,  86],
        [ 39,  53,  76],
        [ 29,  43,  54]],

       [[119,  70,  50],
        [155, 102,  78],
        [178, 129, 108],
        ...,
        [ 47,  62,  85],
        [ 31,  45,  66],
        [ 25,  38,  48]],

       [[156,  96,  67],
        [177, 126, 111],
        [216, 176, 161],
        ...,
        [ 45,  62,  83],
        [ 30,  47,  65],
        [ 27,  41,  49]],

       ...,

       [[  8, 123, 233],
        [  8, 124, 233],
        [  8, 124, 233],
        ...,
        [  8, 126, 232],
        [ 10, 128, 234],
        [  8, 126, 232]],

       [[  9, 123, 235],
        [  8, 123, 233],
        [  8, 124, 233],
        ...,
        [  9, 127, 233],
        [ 11, 129, 235],
        [  9, 127, 234]],

       [[ 10, 124, 236],
        [  8, 124, 235],
        [  8, 124, 235],
        ...,
        [ 10, 128, 235],
        [ 11, 129, 236],
        [  9, 127, 235]]], dtype=uint8)]"
Image_1695.jpg,2390,899,640,589,3840,2160,3030,1488,640,daskShared_local/images/Image_1695.jpg,1695,"[array([[[166, 141, 119],
        [138, 113,  91],
        [155, 130, 108],
        ...,
        [  2, 131, 180],
        [  1, 129, 178],
        [  1, 129, 177]],

       [[169, 144, 123],
        [189, 164, 142],
        [187, 163, 140],
        ...,
        [  3, 131, 180],
        [  2, 128, 178],
        [  2, 128, 178]],

       [[177, 152, 130],
        [213, 188, 166],
        [204, 179, 156],
        ...,
        [  3, 130, 179],
        [  2, 129, 177],
        [  4, 132, 179]],

       ...,

       [[  2, 153, 174],
        [  1, 151, 171],
        [  2, 150, 170],
        ...,
        [  0, 121, 164],
        [  1, 120, 163],
        [  1, 120, 163]],

       [[  3, 155, 176],
        [  2, 153, 174],
        [  2, 153, 172],
        ...,
        [  0, 121, 164],
        [  1, 120, 163],
        [  1, 121, 164]],

       [[  3, 155, 177],
        [  2, 155, 176],
        [  2, 154, 175],
        ...,
        [  0, 121, 164],
        [  0, 121, 164],
        [  0, 121, 164]]], dtype=uint8)]"
Image_1696.jpg,654,283,304,340,1600,1000,958,623,340,daskShared_local/images/Image_1696.jpg,1696,"[array([[[  0,  71, 164],
        [  0,  70, 165],
        [  0,  71, 162],
        ...,
        [  2,  69, 160],
        [  1,  68, 159],
        [  1,  68, 159]],

       [[  0,  71, 164],
        [  0,  70, 165],
        [  0,  71, 162],
        ...,
        [  2,  69, 160],
        [  1,  68, 159],
        [  1,  68, 159]],

       [[  0,  71, 164],
        [  0,  70, 165],
        [  0,  71, 162],
        ...,
        [  2,  69, 160],
        [  1,  68, 159],
        [  1,  68, 159]],

       ...,

       [[ 99, 105,  63],
        [123, 124,  93],
        [ 44,  48,  28],
        ...,
        [112, 108,  74],
        [115, 111,  74],
        [119, 113,  76]],

       [[119, 125,  86],
        [101, 105,  78],
        [ 32,  34,  21],
        ...,
        [196, 196, 161],
        [187, 188, 149],
        [184, 188, 148]],

       [[112, 118,  84],
        [ 64,  69,  47],
        [ 45,  46,  40],
        ...,
        [201, 204, 157],
        [185, 193, 138],
        [172, 186, 126]]], dtype=uint8)]"
Image_1697.png,355,59,200,143,600,600,555,202,200,daskShared_local/images/Image_1697.png,1697,"[array([[[  2, 102, 250],
        [  2, 102, 250],
        [  2, 102, 250],
        ...,
        [  0, 118, 254],
        [  0, 118, 254],
        [  0, 117, 253]],

       [[  1, 103, 250],
        [  0, 102, 249],
        [  0, 102, 249],
        ...,
        [  1, 119, 255],
        [  1, 119, 255],
        [  1, 119, 255]],

       [[  0, 102, 249],
        [  0, 102, 249],
        [  0, 102, 249],
        ...,
        [  1, 119, 255],
        [  1, 119, 255],
        [  1, 119, 255]],

       ...,

       [[ 84,  41,   5],
        [161, 116,  31],
        [243, 216, 153],
        ...,
        [248, 255, 211],
        [237, 242, 210],
        [235, 241, 203]],

       [[137,  83,  24],
        [145,  98,   6],
        [227, 195,  82],
        ...,
        [219, 218, 213],
        [230, 238, 179],
        [235, 246, 171]],

       [[139, 102,  60],
        [173, 144, 100],
        [208, 169,  99],
        ...,
        [140, 137, 133],
        [206, 220, 108],
        [233, 246, 138]]], dtype=uint8)]"
Image_1698.jpg,221,211,138,160,800,600,359,371,160,daskShared_local/images/Image_1698.jpg,1698,"[array([[[ 74, 189, 210],
        [ 74, 189, 210],
        [ 73, 188, 210],
        ...,
        [ 15, 164, 193],
        [ 16, 164, 194],
        [ 14, 163, 193]],

       [[ 73, 188, 211],
        [ 73, 188, 211],
        [ 72, 188, 210],
        ...,
        [ 15, 164, 193],
        [ 15, 164, 195],
        [ 14, 164, 193]],

       [[ 70, 187, 210],
        [ 70, 187, 210],
        [ 69, 187, 209],
        ...,
        [ 16, 164, 194],
        [ 14, 164, 195],
        [ 13, 163, 193]],

       ...,

       [[ 31, 117, 100],
        [ 27, 116,  99],
        [ 22, 114,  97],
        ...,
        [231, 197, 141],
        [229, 197, 134],
        [225, 199, 149]],

       [[ 29, 111,  96],
        [ 26, 110,  95],
        [ 22, 109,  93],
        ...,
        [232, 198, 136],
        [229, 195, 140],
        [224, 196, 146]],

       [[ 34, 113,  99],
        [ 34, 114, 100],
        [ 32, 115, 100],
        ...,
        [231, 198, 131],
        [229, 195, 142],
        [226, 196, 146]]], dtype=uint8)]"
Image_1699.jpg,619,316,188,149,1400,933,807,465,188,daskShared_local/images/Image_1699.jpg,1699,"[array([[[  1, 174, 230],
        [  1, 174, 230],
        [  1, 174, 230],
        ...,
        [  0, 207, 249],
        [  0, 207, 249],
        [  0, 207, 249]],

       [[  0, 173, 229],
        [  1, 174, 230],
        [  1, 174, 230],
        ...,
        [  0, 205, 247],
        [  0, 206, 248],
        [  0, 206, 248]],

       [[  1, 176, 231],
        [  0, 175, 230],
        [  0, 175, 230],
        ...,
        [  0, 205, 245],
        [  0, 206, 246],
        [  1, 207, 247]],

       ...,

       [[199, 194, 143],
        [134, 123,  65],
        [139, 124,  69],
        ...,
        [  0, 184, 236],
        [  0, 184, 236],
        [  0, 184, 236]],

       [[179, 179, 111],
        [139, 132,  55],
        [130, 118,  48],
        ...,
        [  0, 184, 236],
        [  0, 184, 236],
        [  0, 184, 236]],

       [[250, 246, 207],
        [224, 213, 163],
        [179, 164, 112],
        ...,
        [  0, 184, 236],
        [  0, 184, 236],
        [  0, 184, 236]]], dtype=uint8)]"
Image_17.jpg,1888,640,1205,1149,4752,3168,3093,1789,1205,daskShared_local/images/Image_17.jpg,17,"[array([[[ 75,  68,  40],
        [ 77,  71,  40],
        [ 73,  64,  37],
        ...,
        [ 43, 117, 149],
        [ 44, 118, 150],
        [ 45, 118, 150]],

       [[ 81,  73,  42],
        [ 78,  68,  41],
        [ 70,  60,  41],
        ...,
        [ 42, 117, 148],
        [ 42, 117, 149],
        [ 43, 117, 149]],

       [[ 79,  69,  36],
        [ 76,  65,  38],
        [ 71,  61,  38],
        ...,
        [ 46, 120, 150],
        [ 45, 119, 150],
        [ 45, 118, 149]],

       ...,

       [[ 25, 104, 142],
        [ 25, 106, 143],
        [ 23, 107, 143],
        ...,
        [123, 110,  93],
        [ 91,  75,  66],
        [107,  87,  65]],

       [[ 42, 123, 149],
        [ 43, 125, 151],
        [ 44, 124, 148],
        ...,
        [126, 113,  96],
        [122, 106,  82],
        [167, 153, 110]],

       [[ 58, 143, 159],
        [ 59, 144, 159],
        [ 59, 141, 157],
        ...,
        [146, 131, 104],
        [171, 161, 122],
        [200, 196, 159]]], dtype=uint8)]"
Image_170.jpg,657,293,298,321,1600,1000,955,614,321,daskShared_local/images/Image_170.jpg,170,"[array([[[  0,  69, 162],
        [  0,  69, 162],
        [  0,  69, 162],
        ...,
        [  1,  68, 159],
        [  1,  68, 159],
        [  1,  68, 159]],

       [[  0,  69, 162],
        [  0,  69, 162],
        [  0,  69, 162],
        ...,
        [  1,  68, 159],
        [  0,  67, 158],
        [  0,  67, 158]],

       [[  0,  69, 162],
        [  0,  69, 162],
        [  0,  69, 162],
        ...,
        [  1,  68, 159],
        [  1,  68, 159],
        [  1,  68, 159]],

       ...,

       [[ 89, 103,  71],
        [ 86,  92,  53],
        [148, 153, 105],
        ...,
        [ 95,  85,  48],
        [104,  98,  56],
        [114, 105,  60]],

       [[ 39,  53,  29],
        [ 86,  90,  60],
        [145, 149, 110],
        ...,
        [103,  90,  54],
        [103,  91,  53],
        [105,  92,  53]],

       [[ 28,  41,  25],
        [ 62,  64,  45],
        [ 89,  91,  62],
        ...,
        [103,  91,  56],
        [118, 102,  67],
        [120, 102,  67]]], dtype=uint8)]"
Image_1700.jpg,426,848,212,212,2015,1510,638,1060,212,daskShared_local/images/Image_1700.jpg,1700,"[array([[[137, 143, 155],
        [153, 160, 168],
        [203, 210, 215],
        ...,
        [ 70,  65,  62],
        [ 86,  81,  78],
        [ 93,  85,  83]],

       [[140, 147, 157],
        [176, 183, 191],
        [184, 192, 197],
        ...,
        [ 78,  73,  70],
        [ 84,  79,  76],
        [ 91,  83,  81]],

       [[153, 160, 169],
        [180, 187, 195],
        [143, 150, 156],
        ...,
        [ 60,  55,  52],
        [ 74,  69,  66],
        [ 93,  86,  83]],

       ...,

       [[193, 183, 173],
        [143, 133, 123],
        [114, 104,  94],
        ...,
        [164, 160, 157],
        [156, 152, 149],
        [164, 160, 157]],

       [[193, 183, 173],
        [192, 182, 172],
        [171, 161, 151],
        ...,
        [161, 157, 154],
        [147, 143, 140],
        [158, 154, 151]],

       [[207, 197, 187],
        [234, 224, 214],
        [224, 214, 204],
        ...,
        [169, 165, 162],
        [165, 161, 158],
        [170, 166, 163]]], dtype=uint8)]"
Image_1701.jpg,901,459,705,492,3008,2000,1606,951,705,daskShared_local/images/Image_1701.jpg,1701,"[array([[[148, 187, 194],
        [148, 187, 194],
        [148, 187, 194],
        ...,
        [135, 177, 193],
        [135, 177, 190],
        [135, 177, 189]],

       [[148, 187, 194],
        [148, 187, 194],
        [148, 187, 194],
        ...,
        [135, 177, 193],
        [135, 177, 190],
        [135, 177, 189]],

       [[148, 187, 194],
        [148, 187, 194],
        [148, 187, 194],
        ...,
        [135, 177, 193],
        [135, 177, 190],
        [135, 177, 189]],

       ...,

       [[118, 177, 183],
        [112, 171, 177],
        [111, 170, 176],
        ...,
        [ 61,  73,  85],
        [ 64,  72,  85],
        [ 59,  67,  80]],

       [[114, 173, 179],
        [111, 170, 176],
        [111, 170, 176],
        ...,
        [ 64,  76,  88],
        [ 70,  78,  91],
        [ 60,  68,  81]],

       [[113, 172, 178],
        [111, 170, 176],
        [111, 170, 176],
        ...,
        [ 70,  86,  94],
        [ 73,  87,  95],
        [ 71,  85,  93]]], dtype=uint8)]"
Image_1702.jpg,408,1014,824,592,4601,3200,1232,1606,824,daskShared_local/images/Image_1702.jpg,1702,"[array([[[ 28, 164, 238],
        [ 29, 167, 240],
        [ 27, 157, 234],
        ...,
        [ 47, 160, 241],
        [ 48, 161, 240],
        [ 42, 154, 234]],

       [[ 33, 165, 240],
        [ 29, 155, 231],
        [ 34, 164, 241],
        ...,
        [ 45, 155, 227],
        [ 47, 162, 236],
        [ 42, 163, 236]],

       [[ 31, 162, 236],
        [ 33, 160, 230],
        [ 34, 159, 232],
        ...,
        [ 52, 161, 223],
        [ 52, 162, 228],
        [ 50, 163, 229]],

       ...,

       [[ 25, 153, 217],
        [ 20, 149, 215],
        [ 28, 158, 223],
        ...,
        [ 41, 150, 204],
        [ 42, 152, 211],
        [ 40, 148, 205]],

       [[ 23, 151, 214],
        [ 22, 152, 214],
        [ 28, 161, 229],
        ...,
        [ 46, 151, 204],
        [ 45, 151, 207],
        [ 46, 155, 211]],

       [[ 21, 151, 217],
        [ 23, 155, 224],
        [ 26, 160, 230],
        ...,
        [ 50, 157, 211],
        [ 48, 154, 210],
        [ 49, 161, 216]]], dtype=uint8)]"
Image_1703.jpg,417,7,413,517,1280,720,830,524,517,daskShared_local/images/Image_1703.jpg,1703,"[array([[[159, 228, 238],
        [161, 226, 239],
        [160, 227, 240],
        ...,
        [ 70, 187, 215],
        [ 82, 188, 218],
        [ 84, 190, 219]],

       [[156, 226, 237],
        [156, 226, 238],
        [159, 227, 240],
        ...,
        [ 82, 189, 213],
        [ 88, 193, 217],
        [ 83, 192, 218]],

       [[153, 225, 239],
        [154, 225, 238],
        [157, 227, 239],
        ...,
        [ 55, 183, 208],
        [ 62, 186, 209],
        [ 58, 187, 211]],

       ...,

       [[119,  93,  55],
        [123,  95,  55],
        [116,  88,  47],
        ...,
        [  1,  71,  96],
        [  0,  70,  95],
        [  2,  69,  95]],

       [[122,  98,  57],
        [119,  93,  55],
        [110,  84,  45],
        ...,
        [  1,  70,  94],
        [  1,  70,  94],
        [  2,  69,  95]],

       [[125, 102,  62],
        [119,  94,  54],
        [101,  79,  38],
        ...,
        [  2,  70,  93],
        [  2,  70,  93],
        [  3,  69,  95]]], dtype=uint8)]"
Image_1704.jpg,684,188,205,140,1000,600,889,328,205,daskShared_local/images/Image_1704.jpg,1704,"[array([[[  6, 153, 205],
        [  7, 152, 205],
        [  7, 152, 205],
        ...,
        [  3, 143, 202],
        [  3, 143, 202],
        [  1, 141, 200]],

       [[  4, 151, 202],
        [  5, 151, 202],
        [  6, 152, 203],
        ...,
        [  3, 143, 202],
        [  3, 143, 202],
        [  1, 141, 200]],

       [[  3, 150, 201],
        [  4, 150, 201],
        [  4, 150, 201],
        ...,
        [  3, 143, 202],
        [  4, 144, 203],
        [  1, 141, 200]],

       ...,

       [[ 44,  32,   9],
        [ 71,  57,  28],
        [110,  97,  64],
        ...,
        [229, 223, 236],
        [232, 226, 241],
        [244, 238, 252]],

       [[108,  97,  72],
        [110,  99,  67],
        [104,  95,  56],
        ...,
        [233, 228, 247],
        [238, 233, 254],
        [228, 222, 249]],

       [[130, 120,  95],
        [134, 125,  91],
        [120, 111,  71],
        ...,
        [229, 223, 248],
        [234, 227, 255],
        [218, 210, 247]]], dtype=uint8)]"
Image_1705.jpg,385,337,320,222,1904,803,705,559,320,daskShared_local/images/Image_1705.jpg,1705,"[array([[[  0,  49, 105],
        [  2,  51, 107],
        [  3,  52, 108],
        ...,
        [ 45, 159, 155],
        [ 64, 166, 168],
        [101, 170, 173]],

       [[  0,  49, 105],
        [  2,  51, 107],
        [  3,  52, 108],
        ...,
        [ 53, 153, 154],
        [ 84, 173, 177],
        [137, 206, 209]],

       [[  0,  49, 105],
        [  2,  51, 107],
        [  3,  52, 108],
        ...,
        [ 94, 174, 179],
        [142, 212, 222],
        [184, 247, 251]],

       ...,

       [[  6,  40,  36],
        [  2,  23,  24],
        [  1,   8,  27],
        ...,
        [  1,  63,  73],
        [  2,  63,  74],
        [  3,  64,  86]],

       [[ 16,  90,  60],
        [  2,  59,  36],
        [  0,  29,  27],
        ...,
        [  0,  55,  67],
        [  0,  56,  69],
        [  2,  61,  84]],

       [[ 33, 134,  89],
        [ 23, 107,  69],
        [  4,  65,  47],
        ...,
        [  0,  51,  63],
        [  1,  52,  66],
        [  3,  61,  85]]], dtype=uint8)]"
Image_1706.jpg,210,36,206,171,900,521,416,207,206,daskShared_local/images/Image_1706.jpg,1706,"[array([[[ 16,  58, 170],
        [ 16,  58, 170],
        [ 16,  58, 170],
        ...,
        [ 32,  69, 184],
        [ 33,  70, 185],
        [ 33,  70, 185]],

       [[ 16,  58, 170],
        [ 16,  58, 170],
        [ 16,  58, 170],
        ...,
        [ 32,  69, 184],
        [ 33,  70, 185],
        [ 33,  70, 185]],

       [[ 16,  58, 170],
        [ 16,  58, 170],
        [ 16,  58, 170],
        ...,
        [ 32,  69, 184],
        [ 33,  70, 185],
        [ 33,  70, 185]],

       ...,

       [[  1,  51, 136],
        [  0,  50, 135],
        [  1,  51, 136],
        ...,
        [182, 198, 189],
        [196, 212, 202],
        [214, 230, 220]],

       [[  1,  51, 136],
        [  0,  50, 135],
        [  1,  51, 136],
        ...,
        [202, 218, 208],
        [210, 226, 216],
        [204, 220, 210]],

       [[  2,  52, 139],
        [  2,  52, 139],
        [  2,  52, 139],
        ...,
        [217, 234, 226],
        [207, 224, 216],
        [185, 202, 194]]], dtype=uint8)]"
Image_1707.jpg,105,260,170,114,900,600,275,374,170,daskShared_local/images/Image_1707.jpg,1707,"[array([[[  0,  78,  87],
        [  0,  79,  92],
        [  1,  85, 101],
        ...,
        [ 31, 127, 152],
        [ 69, 155, 182],
        [ 99, 175, 203]],

       [[  1,  79,  91],
        [  0,  80,  96],
        [  1,  86, 105],
        ...,
        [ 23, 116, 141],
        [ 56, 142, 167],
        [ 85, 160, 188]],

       [[  2,  78,  96],
        [  0,  80,  99],
        [  0,  87, 106],
        ...,
        [ 12, 102, 125],
        [ 36, 120, 144],
        [ 61, 137, 161]],

       ...,

       [[  1,  72,  81],
        [  2,  74,  83],
        [  3,  73,  83],
        ...,
        [ 19,  47,  39],
        [ 18,  44,  37],
        [ 18,  43,  37]],

       [[  1,  69,  78],
        [  1,  69,  78],
        [  2,  70,  79],
        ...,
        [ 19,  49,  40],
        [ 15,  45,  37],
        [ 14,  44,  36]],

       [[  0,  67,  76],
        [  0,  67,  76],
        [  0,  68,  77],
        ...,
        [ 18,  48,  40],
        [ 15,  45,  37],
        [ 15,  45,  37]]], dtype=uint8)]"
Image_1708.jpg,517,83,140,184,1200,630,657,267,184,daskShared_local/images/Image_1708.jpg,1708,"[array([[[  2, 155, 222],
        [  4, 156, 223],
        [  4, 156, 223],
        ...,
        [  3, 155, 222],
        [  3, 155, 222],
        [  3, 155, 222]],

       [[  2, 155, 222],
        [  4, 156, 223],
        [  4, 156, 223],
        ...,
        [  3, 155, 222],
        [  3, 155, 222],
        [  3, 155, 222]],

       [[  1, 154, 221],
        [  3, 155, 222],
        [  3, 155, 222],
        ...,
        [  2, 154, 221],
        [  2, 154, 221],
        [  2, 154, 221]],

       ...,

       [[ 32,  22,  28],
        [ 46,  31,  29],
        [ 44,  28,  27],
        ...,
        [ 27, 111, 148],
        [ 22, 106, 143],
        [ 10,  94, 131]],

       [[ 32,  23,  24],
        [ 47,  30,  30],
        [ 43,  26,  26],
        ...,
        [ 14,  98, 135],
        [  9,  93, 130],
        [  3,  87, 124]],

       [[ 31,  22,  19],
        [ 43,  26,  25],
        [ 38,  21,  21],
        ...,
        [  4,  86, 124],
        [  0,  82, 120],
        [  0,  80, 118]]], dtype=uint8)]"
Image_1709.jpg,1040,143,2542,2617,4608,3072,3582,2760,2617,daskShared_local/images/Image_1709.jpg,1709,"[array([[[ 36,  37,  34],
        [ 34,  34,  32],
        [ 31,  32,  29],
        ...,
        [155, 155, 127],
        [162, 159, 125],
        [168, 162, 121]],

       [[ 32,  32,  30],
        [ 31,  31,  30],
        [ 32,  32,  30],
        ...,
        [145, 147, 125],
        [154, 153, 123],
        [162, 158, 121]],

       [[ 29,  29,  27],
        [ 30,  30,  29],
        [ 32,  33,  32],
        ...,
        [133, 137, 122],
        [144, 145, 121],
        [151, 150, 121]],

       ...,

       [[ 98,  81,  53],
        [ 98,  81,  49],
        [ 99,  81,  50],
        ...,
        [162, 147,  87],
        [161, 142,  76],
        [165, 138,  74]],

       [[ 97,  78,  48],
        [ 97,  78,  45],
        [ 96,  79,  45],
        ...,
        [139, 126,  98],
        [138, 129, 104],
        [147, 136, 100]],

       [[ 95,  76,  47],
        [ 95,  76,  46],
        [ 94,  76,  43],
        ...,
        [131, 106,  66],
        [128, 109,  83],
        [134, 118,  86]]], dtype=uint8)]"
Image_171.jpg,625,185,493,432,2000,1000,1118,617,493,daskShared_local/images/Image_171.jpg,171,"[array([[[  1, 161, 209],
        [  1, 161, 209],
        [  1, 161, 209],
        ...,
        [  0, 154, 208],
        [  0, 154, 208],
        [  2, 153, 208]],

       [[  1, 161, 209],
        [  0, 160, 208],
        [  0, 160, 208],
        ...,
        [  0, 153, 207],
        [  0, 153, 207],
        [  1, 152, 207]],

       [[  2, 160, 208],
        [  1, 159, 207],
        [  1, 159, 207],
        ...,
        [  1, 152, 207],
        [  1, 152, 207],
        [  1, 152, 207]],

       ...,

       [[  1, 103, 143],
        [  1, 109, 147],
        [  1, 112, 149],
        ...,
        [  5,  90,  74],
        [  2,  73,  54],
        [  1,  73,  43]],

       [[  1, 101, 140],
        [  1, 105, 143],
        [  1, 106, 143],
        ...,
        [  1,  82,  60],
        [  3,  80,  56],
        [  1,  88,  59]],

       [[  1,  99, 138],
        [  2, 102, 140],
        [  0, 102, 140],
        ...,
        [  3,  88,  63],
        [  3,  93,  67],
        [  0,  94,  70]]], dtype=uint8)]"
Image_1710.jpg,362,23,152,133,550,380,514,156,152,daskShared_local/images/Image_1710.jpg,1710,"[array([[[ 75,  94, 150],
        [ 75,  94, 150],
        [ 75,  94, 150],
        ...,
        [ 69,  85, 144],
        [ 68,  83, 142],
        [ 69,  84, 143]],

       [[ 75,  94, 150],
        [ 75,  94, 150],
        [ 75,  94, 150],
        ...,
        [ 69,  84, 143],
        [ 68,  83, 142],
        [ 69,  84, 143]],

       [[ 75,  94, 150],
        [ 75,  94, 150],
        [ 75,  94, 150],
        ...,
        [ 70,  85, 144],
        [ 70,  85, 144],
        [ 70,  85, 144]],

       ...,

       [[202, 189, 149],
        [185, 172, 136],
        [177, 163, 134],
        ...,
        [ 65,  77, 139],
        [ 65,  76, 138],
        [ 65,  76, 138]],

       [[199, 184, 147],
        [198, 184, 151],
        [198, 184, 159],
        ...,
        [ 64,  76, 138],
        [ 65,  76, 138],
        [ 65,  76, 138]],

       [[181, 165, 130],
        [202, 187, 156],
        [216, 202, 179],
        ...,
        [ 63,  76, 137],
        [ 65,  76, 138],
        [ 65,  76, 138]]], dtype=uint8)]"
Image_1711.jpg,1230,1051,438,393,2592,1944,1668,1444,438,daskShared_local/images/Image_1711.jpg,1711,"[array([[[210, 192, 168],
        [248, 237, 213],
        [233, 223, 208],
        ...,
        [ 41, 117, 172],
        [ 41, 116, 170],
        [ 43, 117, 172]],

       [[253, 242, 220],
        [243, 234, 209],
        [157, 145, 131],
        ...,
        [ 40, 118, 172],
        [ 41, 119, 170],
        [ 42, 117, 171]],

       [[238, 227, 208],
        [151, 136, 113],
        [132, 115, 102],
        ...,
        [ 39, 119, 172],
        [ 44, 121, 171],
        [ 44, 120, 173]],

       ...,

       [[ 46, 121, 171],
        [ 41, 121, 172],
        [ 41, 121, 171],
        ...,
        [ 37, 121, 167],
        [ 39, 123, 168],
        [ 38, 120, 166]],

       [[ 47, 123, 173],
        [ 38, 118, 167],
        [ 39, 119, 168],
        ...,
        [ 37, 121, 167],
        [ 37, 120, 165],
        [ 38, 120, 166]],

       [[ 46, 122, 171],
        [ 40, 120, 169],
        [ 40, 120, 169],
        ...,
        [ 39, 122, 169],
        [ 37, 120, 165],
        [ 38, 121, 166]]], dtype=uint8)]"
Image_1712.jpg,124,158,360,279,1152,768,484,437,360,daskShared_local/images/Image_1712.jpg,1712,"[array([[[183, 234, 225],
        [187, 237, 228],
        [187, 235, 225],
        ...,
        [145, 220, 217],
        [141, 222, 217],
        [140, 220, 217]],

       [[186, 236, 224],
        [187, 237, 225],
        [186, 237, 225],
        ...,
        [141, 220, 217],
        [141, 220, 216],
        [141, 220, 216]],

       [[187, 237, 225],
        [187, 237, 225],
        [187, 237, 225],
        ...,
        [144, 223, 218],
        [147, 223, 219],
        [147, 223, 219]],

       ...,

       [[101, 184, 192],
        [101, 184, 192],
        [101, 179, 189],
        ...,
        [ 90, 122, 133],
        [101, 130, 140],
        [ 88, 116, 120]],

       [[101, 182, 191],
        [100, 181, 190],
        [ 99, 177, 187],
        ...,
        [ 89, 116, 128],
        [ 87, 121, 130],
        [ 91, 124, 127]],

       [[101, 181, 190],
        [100, 180, 189],
        [ 99, 178, 188],
        ...,
        [ 91, 119, 131],
        [ 80, 116, 126],
        [ 89, 124, 127]]], dtype=uint8)]"
Image_1713.jpg,507,84,312,439,1600,900,819,523,439,daskShared_local/images/Image_1713.jpg,1713,"[array([[[  0, 153, 210],
        [  0, 153, 210],
        [  0, 154, 208],
        ...,
        [152, 199, 241],
        [153, 199, 241],
        [155, 200, 242]],

       [[  0, 154, 208],
        [  0, 154, 208],
        [  0, 154, 208],
        ...,
        [152, 199, 241],
        [153, 199, 241],
        [154, 199, 241]],

       [[  0, 153, 207],
        [  0, 153, 207],
        [  0, 154, 208],
        ...,
        [152, 199, 241],
        [152, 199, 241],
        [153, 198, 240]],

       ...,

       [[  1, 139, 202],
        [  1, 139, 202],
        [  0, 140, 201],
        ...,
        [132, 127,  93],
        [ 96,  93,  75],
        [ 64,  68,  71]],

       [[  1, 139, 202],
        [  1, 139, 202],
        [  0, 140, 201],
        ...,
        [ 99,  97,  79],
        [ 82,  81,  71],
        [ 70,  69,  69]],

       [[  1, 139, 202],
        [  1, 139, 202],
        [  0, 140, 201],
        ...,
        [ 75,  72,  69],
        [ 79,  75,  70],
        [104,  95,  85]]], dtype=uint8)]"
Image_1714.jpg,968,388,204,198,2000,1000,1172,586,204,daskShared_local/images/Image_1714.jpg,1714,"[array([[[202, 182, 147],
        [203, 183, 148],
        [205, 185, 150],
        ...,
        [204, 182, 145],
        [206, 182, 144],
        [210, 187, 146]],

       [[202, 182, 147],
        [206, 186, 151],
        [208, 188, 153],
        ...,
        [205, 185, 150],
        [205, 183, 146],
        [207, 185, 146]],

       [[205, 183, 146],
        [209, 187, 150],
        [209, 189, 152],
        ...,
        [204, 186, 150],
        [203, 183, 148],
        [207, 187, 150]],

       ...,

       [[ 37,  38,  39],
        [ 35,  36,  35],
        [ 35,  36,  31],
        ...,
        [204, 180, 142],
        [206, 180, 141],
        [192, 168, 127]],

       [[ 37,  38,  40],
        [ 33,  34,  36],
        [ 35,  36,  35],
        ...,
        [206, 172, 128],
        [217, 183, 138],
        [215, 186, 142]],

       [[ 34,  35,  37],
        [ 33,  34,  36],
        [ 39,  40,  42],
        ...,
        [198, 148, 100],
        [209, 162, 110],
        [203, 163, 112]]], dtype=uint8)]"
Image_1715.jpg,581,83,232,172,1068,601,813,255,232,daskShared_local/images/Image_1715.jpg,1715,"[array([[[  0,  72, 255],
        [  0,  72, 255],
        [  0,  72, 255],
        ...,
        [  0,  84, 253],
        [  0,  85, 254],
        [  1,  86, 255]],

       [[  0,  72, 255],
        [  0,  72, 255],
        [  0,  72, 255],
        ...,
        [  0,  85, 253],
        [  0,  86, 254],
        [  0,  87, 255]],

       [[  0,  72, 255],
        [  0,  72, 255],
        [  0,  72, 255],
        ...,
        [  0,  86, 254],
        [  0,  86, 254],
        [  0,  87, 255]],

       ...,

       [[101,  92,  66],
        [124, 111,  73],
        [165, 144, 113],
        ...,
        [212, 223, 202],
        [217, 223, 201],
        [220, 225, 196]],

       [[ 89,  83,  62],
        [200, 190, 162],
        [116,  97,  79],
        ...,
        [212, 224, 198],
        [216, 224, 198],
        [219, 224, 195]],

       [[ 90,  84,  69],
        [183, 175, 157],
        [136, 120, 109],
        ...,
        [210, 225, 194],
        [214, 224, 195],
        [217, 224, 193]]], dtype=uint8)]"
Image_1716.jpg,416,152,239,176,1000,667,655,328,239,daskShared_local/images/Image_1716.jpg,1716,"[array([[[ 30, 173, 251],
        [ 31, 176, 252],
        [ 37, 179, 252],
        ...,
        [  0, 147, 227],
        [  0, 147, 227],
        [  0, 146, 226]],

       [[ 28, 174, 251],
        [ 30, 175, 251],
        [ 33, 177, 251],
        ...,
        [  0, 146, 226],
        [  0, 146, 226],
        [  0, 145, 226]],

       [[ 27, 173, 251],
        [ 31, 176, 251],
        [ 33, 177, 251],
        ...,
        [  1, 146, 226],
        [  0, 145, 225],
        [  1, 145, 226]],

       ...,

       [[197, 169, 103],
        [208, 185, 128],
        [210, 192, 148],
        ...,
        [  0,  61, 105],
        [  0,  62, 105],
        [  0,  62, 105]],

       [[193, 166,  98],
        [206, 186, 130],
        [211, 195, 155],
        ...,
        [  0,  62, 105],
        [  0,  62, 105],
        [  1,  62, 106]],

       [[198, 181, 121],
        [214, 198, 148],
        [202, 180, 135],
        ...,
        [  0,  61, 105],
        [  1,  61, 105],
        [  0,  61, 105]]], dtype=uint8)]"
Image_1717.jpg,428,152,709,611,1152,763,1137,763,709,daskShared_local/images/Image_1717.jpg,1717,"[array([[[  2, 181, 237],
        [  1, 180, 236],
        [  2, 181, 237],
        ...,
        [  0, 184, 238],
        [  0, 184, 236],
        [  0, 184, 236]],

       [[  2, 181, 237],
        [  1, 182, 237],
        [  1, 182, 237],
        ...,
        [  0, 184, 237],
        [  0, 184, 237],
        [  0, 184, 237]],

       [[  0, 183, 237],
        [  1, 182, 237],
        [  2, 181, 237],
        ...,
        [  0, 183, 237],
        [  0, 183, 237],
        [  0, 183, 237]],

       ...,

       [[152, 175, 148],
        [152, 176, 152],
        [154, 178, 156],
        ...,
        [161, 189, 193],
        [166, 185, 172],
        [158, 183, 178]],

       [[157, 179, 154],
        [157, 179, 156],
        [157, 180, 157],
        ...,
        [148, 170, 157],
        [157, 171, 133],
        [127, 166, 154]],

       [[159, 182, 159],
        [159, 182, 160],
        [159, 182, 159],
        ...,
        [173, 198, 183],
        [153, 184, 177],
        [141, 174, 161]]], dtype=uint8)]"
Image_1718.jpg,534,237,164,193,990,681,698,430,193,daskShared_local/images/Image_1718.jpg,1718,"[array([[[ 27,  21,   9],
        [ 29,  23,  11],
        [ 32,  26,  14],
        ...,
        [ 36,  33,  12],
        [ 44,  39,  17],
        [ 42,  34,  11]],

       [[ 28,  22,  10],
        [ 29,  23,  11],
        [ 32,  26,  14],
        ...,
        [ 33,  31,   8],
        [ 41,  37,  12],
        [ 47,  40,  12]],

       [[ 29,  23,  11],
        [ 31,  25,  13],
        [ 33,  27,  15],
        ...,
        [ 31,  29,   5],
        [ 40,  35,   9],
        [ 50,  43,  15]],

       ...,

       [[ 97,  90,  61],
        [ 74,  64,  33],
        [ 83,  74,  41],
        ...,
        [ 26,  34,  19],
        [ 31,  38,  23],
        [ 33,  40,  24]],

       [[110,  99,  69],
        [ 99,  86,  54],
        [116, 103,  68],
        ...,
        [ 36,  44,  29],
        [ 37,  44,  28],
        [ 32,  39,  23]],

       [[137, 122,  91],
        [142, 126,  93],
        [165, 149, 113],
        ...,
        [ 43,  52,  36],
        [ 37,  46,  29],
        [ 35,  42,  26]]], dtype=uint8)]"
Image_1719.jpg,497,165,97,73,660,438,594,238,97,daskShared_local/images/Image_1719.jpg,1719,"[array([[[ 11,  38,  77],
        [ 11,  38,  77],
        [ 12,  38,  76],
        ...,
        [  3,  14,  59],
        [  3,  14,  58],
        [  3,  14,  58]],

       [[ 11,  38,  77],
        [ 11,  38,  77],
        [ 12,  38,  76],
        ...,
        [  3,  14,  59],
        [  3,  15,  58],
        [  3,  15,  58]],

       [[ 16,  39,  79],
        [ 15,  39,  79],
        [ 17,  41,  80],
        ...,
        [  4,  15,  61],
        [  2,  11,  56],
        [  2,  12,  56]],

       ...,

       [[227, 178, 112],
        [227, 177, 111],
        [233, 197, 130],
        ...,
        [ 35,  34,  59],
        [ 33,  29,  57],
        [ 33,  30,  57]],

       [[216, 159,  99],
        [216, 160,  99],
        [208, 150,  92],
        ...,
        [ 39,  37,  60],
        [ 37,  33,  57],
        [ 37,  33,  57]],

       [[217, 160,  99],
        [217, 160,  99],
        [209, 152,  94],
        ...,
        [ 39,  37,  60],
        [ 37,  33,  57],
        [ 37,  33,  57]]], dtype=uint8)]"
Image_172.jpg,374,428,163,119,1200,800,537,547,163,daskShared_local/images/Image_172.jpg,172,"[array([[[121, 130,  73],
        [120, 129,  73],
        [118, 127,  71],
        ...,
        [245, 238, 198],
        [231, 223, 186],
        [199, 191, 155]],

       [[122, 131,  75],
        [121, 130,  74],
        [119, 128,  72],
        ...,
        [219, 210, 173],
        [193, 184, 149],
        [175, 165, 131]],

       [[120, 129,  74],
        [120, 129,  74],
        [119, 128,  73],
        ...,
        [192, 182, 148],
        [178, 167, 135],
        [164, 153, 122]],

       ...,

       [[ 47, 110,  89],
        [ 47, 110,  89],
        [ 47, 111,  90],
        ...,
        [ 58, 112,  92],
        [ 58, 112,  92],
        [ 59, 113,  93]],

       [[ 46, 111,  89],
        [ 46, 111,  89],
        [ 46, 111,  89],
        ...,
        [ 57, 112,  93],
        [ 57, 112,  93],
        [ 58, 113,  94]],

       [[ 45, 110,  88],
        [ 45, 110,  88],
        [ 45, 110,  88],
        ...,
        [ 57, 112,  93],
        [ 56, 111,  92],
        [ 55, 110,  91]]], dtype=uint8)]"
Image_1720.jpg,381,159,118,130,900,600,499,289,130,daskShared_local/images/Image_1720.jpg,1720,"[array([[[127, 118, 162],
        [127, 119, 164],
        [126, 122, 167],
        ...,
        [161, 147, 145],
        [152, 140, 139],
        [145, 135, 135]],

       [[115, 116, 165],
        [113, 117, 166],
        [110, 118, 168],
        ...,
        [166, 149, 148],
        [157, 142, 141],
        [150, 137, 137]],

       [[ 90, 114, 171],
        [ 86, 113, 171],
        [ 78, 110, 171],
        ...,
        [173, 153, 151],
        [165, 146, 145],
        [159, 141, 140]],

       ...,

       [[  0, 105, 191],
        [  0, 100, 188],
        [  0,  90, 179],
        ...,
        [132, 100, 115],
        [128,  95, 111],
        [125,  93, 109]],

       [[  0, 109, 196],
        [  0, 106, 193],
        [  0,  98, 186],
        ...,
        [130,  97, 112],
        [129,  97, 112],
        [130,  97, 113]],

       [[  1, 110, 196],
        [  0, 107, 194],
        [  0, 102, 189],
        ...,
        [129,  95, 111],
        [131,  98, 114],
        [133, 100, 116]]], dtype=uint8)]"
Image_1721.jpg,397,133,134,87,759,422,531,220,134,daskShared_local/images/Image_1721.jpg,1721,"[array([[[105, 174, 171],
        [100, 170, 167],
        [ 92, 163, 159],
        ...,
        [ 54, 149, 172],
        [ 65, 160, 182],
        [ 66, 161, 184]],

       [[106, 177, 173],
        [106, 177, 173],
        [105, 177, 173],
        ...,
        [ 69, 161, 184],
        [ 81, 174, 197],
        [ 82, 175, 198]],

       [[116, 185, 184],
        [120, 189, 188],
        [127, 196, 195],
        ...,
        [ 82, 172, 195],
        [ 97, 188, 210],
        [100, 191, 214]],

       ...,

       [[  3, 151, 187],
        [  3, 151, 187],
        [  3, 151, 187],
        ...,
        [  4, 124, 144],
        [  3, 124, 144],
        [  3, 125, 144]],

       [[  3, 151, 187],
        [  3, 151, 187],
        [  3, 151, 187],
        ...,
        [  8, 123, 144],
        [  5, 123, 143],
        [  5, 123, 143]],

       [[  3, 151, 187],
        [  3, 151, 187],
        [  3, 151, 187],
        ...,
        [  9, 122, 144],
        [  7, 122, 143],
        [  5, 122, 142]]], dtype=uint8)]"
Image_1722.jpg,472,156,237,276,981,650,709,432,276,daskShared_local/images/Image_1722.jpg,1722,"[array([[[244, 244, 244],
        [244, 244, 244],
        [244, 244, 244],
        ...,
        [243, 243, 243],
        [243, 243, 243],
        [243, 243, 243]],

       [[244, 244, 244],
        [244, 244, 244],
        [244, 244, 244],
        ...,
        [243, 243, 243],
        [243, 243, 243],
        [243, 243, 243]],

       [[244, 244, 244],
        [244, 244, 244],
        [244, 244, 244],
        ...,
        [243, 243, 243],
        [243, 243, 243],
        [243, 243, 243]],

       ...,

       [[ 26,  93, 172],
        [ 26,  93, 174],
        [ 27,  94, 173],
        ...,
        [ 22,  90, 171],
        [ 22,  90, 170],
        [ 22,  89, 168]],

       [[ 25,  92, 171],
        [ 25,  92, 173],
        [ 28,  95, 174],
        ...,
        [ 22,  90, 172],
        [ 24,  92, 173],
        [ 23,  90, 169]],

       [[ 25,  92, 171],
        [ 25,  92, 173],
        [ 31,  98, 177],
        ...,
        [ 23,  91, 174],
        [ 25,  93, 176],
        [ 25,  92, 173]]], dtype=uint8)]"
Image_1723.jpg,405,314,241,206,1500,1000,646,520,241,daskShared_local/images/Image_1723.jpg,1723,"[array([[[  0, 129, 152],
        [  1, 132, 156],
        [  3, 132, 156],
        ...,
        [  5, 112, 132],
        [  7, 114, 134],
        [  1, 108, 128]],

       [[  0, 131, 153],
        [  0, 132, 154],
        [  0, 131, 154],
        ...,
        [ 10, 122, 141],
        [ 10, 123, 141],
        [  4, 117, 135]],

       [[  0, 135, 156],
        [  0, 134, 156],
        [  0, 132, 154],
        ...,
        [  8, 128, 143],
        [  8, 127, 142],
        [  7, 126, 141]],

       ...,

       [[ 96, 138, 121],
        [ 76, 118, 103],
        [ 52,  93,  76],
        ...,
        [174, 173, 118],
        [193, 193, 139],
        [180, 181, 124]],

       [[ 85, 127, 112],
        [ 68, 111,  97],
        [ 49,  93,  78],
        ...,
        [150, 150,  94],
        [188, 189, 133],
        [193, 194, 138]],

       [[ 90, 132, 118],
        [ 72, 116, 102],
        [ 54,  98,  84],
        ...,
        [107, 106,  49],
        [153, 154,  97],
        [190, 191, 133]]], dtype=uint8)]"
Image_1724.jpg,1285,649,187,143,2304,1536,1472,792,187,daskShared_local/images/Image_1724.jpg,1724,"[array([[[ 13, 141, 196],
        [ 12, 141, 195],
        [ 17, 144, 199],
        ...,
        [  0, 107, 145],
        [  0, 107, 145],
        [  0, 107, 145]],

       [[ 31, 156, 208],
        [ 32, 156, 209],
        [ 36, 158, 211],
        ...,
        [  0, 111, 145],
        [  0, 111, 145],
        [  0, 111, 145]],

       [[ 37, 160, 207],
        [ 41, 162, 210],
        [ 45, 164, 213],
        ...,
        [  0, 113, 147],
        [  0, 114, 148],
        [  0, 114, 148]],

       ...,

       [[ 78, 120, 123],
        [106, 147, 143],
        [144, 182, 172],
        ...,
        [ 34,  25,  40],
        [ 37,  27,  41],
        [ 40,  31,  51]],

       [[130, 165, 158],
        [159, 192, 185],
        [165, 200, 194],
        ...,
        [ 21,  27,  35],
        [ 29,  27,  39],
        [ 38,  28,  45]],

       [[176, 211, 200],
        [175, 210, 205],
        [131, 169, 169],
        ...,
        [ 14,  26,  35],
        [ 21,  28,  40],
        [ 24,  21,  40]]], dtype=uint8)]"
Image_1725.jpg,189,99,376,276,1024,670,565,375,376,daskShared_local/images/Image_1725.jpg,1725,"[array([[[ 28,  36,  47],
        [ 31,  31,  48],
        [ 38,  31,  51],
        ...,
        [ 32,  69, 106],
        [ 22,  68,  99],
        [ 28,  76, 105]],

       [[ 28,  35,  50],
        [ 21,  27,  46],
        [ 30,  37,  57],
        ...,
        [ 28,  86, 123],
        [ 28,  86, 120],
        [ 20,  79, 110]],

       [[ 22,  27,  46],
        [ 23,  33,  53],
        [ 22,  41,  58],
        ...,
        [ 21,  95, 135],
        [ 21,  91, 128],
        [ 11,  78, 113]],

       ...,

       [[ 57, 158, 181],
        [ 69, 160, 177],
        [ 47, 156, 156],
        ...,
        [ 85, 125, 133],
        [ 64,  94, 102],
        [ 69,  81,  96]],

       [[ 54, 151, 167],
        [ 57, 142, 152],
        [ 48, 141, 135],
        ...,
        [ 54, 107, 109],
        [ 72,  96, 103],
        [ 92,  83, 100]],

       [[ 47, 152, 150],
        [ 49, 138, 135],
        [ 47, 130, 122],
        ...,
        [ 54, 111, 102],
        [ 67,  97,  87],
        [ 97,  95,  96]]], dtype=uint8)]"
Image_1726.jpg,253,219,127,142,775,518,380,361,142,daskShared_local/images/Image_1726.jpg,1726,"[array([[[185, 162, 150],
        [177, 151, 140],
        [169, 141, 130],
        ...,
        [127,  95,  57],
        [138, 106,  67],
        [144, 112,  73]],

       [[163, 138, 126],
        [157, 131, 119],
        [160, 132, 120],
        ...,
        [128,  94,  57],
        [138, 105,  66],
        [144, 111,  71]],

       [[144, 117, 104],
        [146, 119, 106],
        [161, 132, 120],
        ...,
        [134, 100,  61],
        [141, 107,  68],
        [146, 113,  72]],

       ...,

       [[171, 140,  94],
        [167, 136,  90],
        [171, 141,  96],
        ...,
        [221, 181, 145],
        [212, 172, 136],
        [198, 158, 122]],

       [[171, 140,  93],
        [162, 131,  85],
        [164, 133,  88],
        ...,
        [213, 173, 138],
        [207, 167, 131],
        [195, 154, 118]],

       [[168, 137,  90],
        [160, 129,  83],
        [158, 127,  82],
        ...,
        [204, 164, 128],
        [202, 160, 125],
        [191, 149, 114]]], dtype=uint8)]"
Image_1727.jpg,312,310,167,127,966,642,479,437,167,daskShared_local/images/Image_1727.jpg,1727,"[array([[[ 10,  90,  84],
        [ 15,  96,  90],
        [ 17, 101,  93],
        ...,
        [ 73,  94,  97],
        [ 26,  59,  55],
        [  3,  34,  28]],

       [[ 10,  89,  76],
        [ 12,  91,  77],
        [ 14,  95,  79],
        ...,
        [ 26,  38,  47],
        [ 16,  40,  42],
        [  8,  41,  35]],

       [[ 13,  88,  68],
        [ 11,  84,  63],
        [  9,  85,  62],
        ...,
        [  6,  20,  28],
        [ 12,  25,  33],
        [ 20,  38,  42]],

       ...,

       [[ 29, 192, 207],
        [ 32, 198, 212],
        [ 31, 200, 213],
        ...,
        [ 76, 238, 249],
        [ 80, 241, 252],
        [ 82, 243, 254]],

       [[ 28, 192, 205],
        [ 32, 198, 211],
        [ 33, 202, 214],
        ...,
        [ 76, 238, 250],
        [ 76, 239, 251],
        [ 78, 241, 252]],

       [[ 28, 197, 203],
        [ 31, 200, 207],
        [ 33, 203, 211],
        ...,
        [ 76, 237, 253],
        [ 72, 236, 250],
        [ 72, 237, 251]]], dtype=uint8)]"
Image_1728.jpg,734,342,179,182,1600,1000,913,524,182,daskShared_local/images/Image_1728.jpg,1728,"[array([[[  0,  81, 163],
        [  0,  81, 163],
        [  0,  81, 163],
        ...,
        [  1,  77, 161],
        [  1,  77, 161],
        [  1,  77, 161]],

       [[  0,  81, 163],
        [  0,  81, 163],
        [  0,  81, 163],
        ...,
        [  1,  77, 161],
        [  1,  77, 161],
        [  1,  77, 161]],

       [[  0,  79, 161],
        [  0,  79, 161],
        [  0,  79, 161],
        ...,
        [  1,  77, 161],
        [  1,  77, 161],
        [  1,  77, 161]],

       ...,

       [[187, 208, 197],
        [170, 192, 181],
        [ 74,  98,  86],
        ...,
        [215, 198, 165],
        [238, 218, 188],
        [238, 218, 188]],

       [[172, 188, 183],
        [153, 170, 164],
        [ 69,  84,  79],
        ...,
        [212, 191, 158],
        [235, 214, 182],
        [243, 222, 192]],

       [[132, 148, 145],
        [103, 115, 115],
        [ 78,  89,  89],
        ...,
        [185, 161, 124],
        [216, 192, 157],
        [236, 213, 182]]], dtype=uint8)]"
Image_1729.jpg,405,322,134,135,800,600,539,457,135,daskShared_local/images/Image_1729.jpg,1729,"[array([[[192, 198, 164],
        [185, 184, 153],
        [179, 167, 139],
        ...,
        [  3,  90, 100],
        [  4,  91, 101],
        [  5,  92, 102]],

       [[200, 205, 171],
        [195, 194, 163],
        [190, 179, 151],
        ...,
        [  4,  90, 100],
        [  5,  91, 101],
        [  5,  92, 102]],

       [[214, 212, 178],
        [213, 209, 177],
        [211, 201, 173],
        ...,
        [  5,  89, 100],
        [  5,  90, 101],
        [  5,  91, 101]],

       ...,

       [[ 29,  52,  52],
        [ 28,  51,  51],
        [ 26,  50,  50],
        ...,
        [ 38, 120,  80],
        [ 40, 126,  81],
        [ 41, 131,  83]],

       [[ 29,  52,  52],
        [ 29,  52,  52],
        [ 28,  52,  52],
        ...,
        [ 42, 124,  82],
        [ 36, 117,  76],
        [ 34, 116,  76]],

       [[ 30,  52,  53],
        [ 30,  53,  54],
        [ 30,  54,  54],
        ...,
        [ 47, 127,  83],
        [ 33, 109,  70],
        [ 28, 103,  67]]], dtype=uint8)]"
Image_173.jpg,1455,1128,376,341,2522,3332,1831,1469,376,daskShared_local/images/Image_173.jpg,173,"[array([[[225, 214, 200],
        [225, 210, 193],
        [226, 212, 197],
        ...,
        [ 15, 162, 166],
        [  3, 142, 147],
        [  2, 139, 144]],

       [[220, 207, 187],
        [221, 206, 187],
        [220, 207, 190],
        ...,
        [  4, 139, 146],
        [  1, 144, 146],
        [ 12, 163, 165]],

       [[210, 196, 174],
        [214, 201, 182],
        [209, 199, 181],
        ...,
        [  6, 133, 145],
        [  5, 157, 160],
        [  5, 172, 170]],

       ...,

       [[ 30,  77,  79],
        [ 22,  67,  71],
        [ 21,  62,  66],
        ...,
        [  2, 125, 202],
        [  0, 122, 199],
        [  0, 123, 200]],

       [[ 28,  78,  76],
        [ 23,  72,  73],
        [ 29,  75,  75],
        ...,
        [  1, 124, 201],
        [  1, 123, 200],
        [  0, 123, 200]],

       [[ 23,  76,  72],
        [ 14,  70,  64],
        [ 17,  69,  65],
        ...,
        [  0, 123, 200],
        [  2, 125, 202],
        [  1, 124, 201]]], dtype=uint8)]"
Image_1730.jpg,682,311,513,476,1920,1080,1195,787,513,daskShared_local/images/Image_1730.jpg,1730,"[array([[[ 44, 106, 151],
        [ 48, 107, 143],
        [ 26,  70,  91],
        ...,
        [ 39,  64,  66],
        [ 34,  58,  62],
        [ 36,  62,  64]],

       [[ 52, 109, 152],
        [ 45, 105, 143],
        [ 58, 108, 135],
        ...,
        [ 51,  75,  75],
        [ 47,  72,  73],
        [ 33,  64,  63]],

       [[ 54, 106, 137],
        [ 47, 103, 137],
        [ 62, 110, 137],
        ...,
        [ 58,  78,  79],
        [ 46,  76,  76],
        [ 30,  73,  69]],

       ...,

       [[ 29,  95, 145],
        [ 29,  94, 144],
        [ 29,  94, 144],
        ...,
        [ 24,  44,  42],
        [ 23,  39,  38],
        [ 24,  40,  37]],

       [[ 28,  94, 144],
        [ 29,  95, 145],
        [ 28,  94, 143],
        ...,
        [ 23,  43,  42],
        [ 24,  38,  39],
        [ 21,  40,  39]],

       [[ 29,  95, 145],
        [ 27,  93, 143],
        [ 27,  93, 143],
        ...,
        [ 23,  44,  42],
        [ 26,  41,  42],
        [ 24,  44,  43]]], dtype=uint8)]"
Image_1731.jpg,160,176,185,136,728,500,345,312,185,daskShared_local/images/Image_1731.jpg,1731,"[array([[[  2,  73, 227],
        [  2,  73, 225],
        [  1,  72, 223],
        ...,
        [  2,  82, 231],
        [  2,  82, 229],
        [  1,  83, 227]],

       [[  0,  72, 226],
        [  0,  73, 224],
        [  2,  73, 223],
        ...,
        [  0,  80, 227],
        [  0,  80, 227],
        [  1,  81, 228]],

       [[  1,  72, 224],
        [  0,  71, 222],
        [  2,  73, 223],
        ...,
        [  1,  81, 228],
        [  1,  81, 228],
        [  1,  81, 228]],

       ...,

       [[ 36, 156, 156],
        [ 21, 154, 150],
        [ 18, 150, 143],
        ...,
        [236, 212, 181],
        [239, 221, 204],
        [243, 244, 228]],

       [[ 29, 146, 155],
        [ 23, 145, 153],
        [ 24, 150, 149],
        ...,
        [240, 203, 140],
        [235, 198, 148],
        [236, 210, 197]],

       [[ 25, 142, 151],
        [ 28, 142, 150],
        [ 29, 139, 146],
        ...,
        [243, 216, 139],
        [246, 220, 137],
        [244, 217, 140]]], dtype=uint8)]"
Image_1732.jpg,797,335,159,118,1536,1024,956,453,159,daskShared_local/images/Image_1732.jpg,1732,"[array([[[ 17,  42,  54],
        [ 13,  38,  53],
        [ 11,  38,  56],
        ...,
        [ 47, 124, 214],
        [ 46, 123, 213],
        [ 46, 123, 213]],

       [[ 17,  42,  56],
        [ 14,  41,  57],
        [ 14,  42,  62],
        ...,
        [ 47, 124, 214],
        [ 47, 124, 214],
        [ 47, 124, 214]],

       [[ 12,  40,  55],
        [ 10,  41,  59],
        [ 13,  46,  69],
        ...,
        [ 47, 124, 214],
        [ 47, 124, 214],
        [ 47, 124, 214]],

       ...,

       [[ 16, 115, 201],
        [ 20, 117, 204],
        [ 21, 117, 204],
        ...,
        [  9, 114, 203],
        [ 10, 113, 202],
        [ 10, 113, 202]],

       [[ 19, 115, 202],
        [ 18, 115, 202],
        [ 17, 116, 202],
        ...,
        [  9, 114, 203],
        [  9, 114, 203],
        [  9, 114, 202]],

       [[ 18, 114, 201],
        [ 18, 114, 201],
        [ 17, 115, 201],
        ...,
        [ 13, 114, 204],
        [ 12, 114, 204],
        [ 12, 113, 203]]], dtype=uint8)]"
Image_1733.jpg,1803,2578,486,399,2720,4080,2289,2977,486,daskShared_local/images/Image_1733.jpg,1733,"[array([[[190, 181, 161],
        [207, 200, 184],
        [200, 199, 193],
        ...,
        [  7, 124, 198],
        [  3, 118, 192],
        [  3, 115, 189]],

       [[169, 161, 135],
        [197, 187, 159],
        [205, 198, 181],
        ...,
        [  3, 122, 195],
        [  4, 121, 195],
        [  6, 121, 196]],

       [[118, 109,  86],
        [152, 138, 106],
        [189, 176, 147],
        ...,
        [  3, 121, 194],
        [  4, 119, 194],
        [  7, 121, 196]],

       ...,

       [[  7, 118, 192],
        [  5, 115, 189],
        [  3, 114, 188],
        ...,
        [  7, 117, 193],
        [  4, 112, 188],
        [  9, 120, 196]],

       [[  5, 115, 189],
        [  3, 114, 188],
        [  7, 118, 192],
        ...,
        [  1, 108, 184],
        [  7, 118, 194],
        [  3, 113, 189]],

       [[  4, 114, 188],
        [  3, 114, 188],
        [  7, 118, 192],
        ...,
        [  3, 114, 190],
        [  3, 114, 190],
        [  5, 115, 191]]], dtype=uint8)]"
Image_1734.jpg,78,87,120,126,637,450,198,213,126,daskShared_local/images/Image_1734.jpg,1734,"[array([[[  1, 172, 254],
        [  1, 172, 254],
        [  1, 172, 254],
        ...,
        [  2, 171, 255],
        [  1, 170, 254],
        [  0, 169, 254]],

       [[  1, 171, 254],
        [  1, 171, 254],
        [  1, 171, 254],
        ...,
        [  1, 170, 254],
        [  1, 169, 254],
        [  1, 168, 254]],

       [[  1, 170, 253],
        [  1, 170, 253],
        [  1, 170, 253],
        ...,
        [  0, 169, 254],
        [  1, 168, 253],
        [  1, 167, 253]],

       ...,

       [[  0, 155, 244],
        [  0, 156, 244],
        [  0, 159, 244],
        ...,
        [ 95, 132, 109],
        [110, 146, 122],
        [117, 152, 128]],

       [[  0, 158, 246],
        [  0, 158, 245],
        [  0, 160, 245],
        ...,
        [ 87, 129, 106],
        [101, 141, 118],
        [108, 147, 123]],

       [[  1, 159, 247],
        [  0, 159, 246],
        [  0, 161, 245],
        ...,
        [ 84, 127, 104],
        [ 97, 139, 115],
        [104, 145, 121]]], dtype=uint8)]"
Image_1735.jpg,280,126,105,121,775,518,385,247,121,daskShared_local/images/Image_1735.jpg,1735,"[array([[[ 92, 163, 181],
        [ 91, 162, 180],
        [ 89, 160, 178],
        ...,
        [ 96, 165, 180],
        [ 94, 163, 179],
        [ 94, 163, 179]],

       [[ 89, 160, 178],
        [ 89, 160, 178],
        [ 87, 158, 176],
        ...,
        [ 95, 164, 180],
        [ 93, 162, 177],
        [ 92, 161, 176]],

       [[ 82, 153, 171],
        [ 82, 153, 171],
        [ 82, 153, 171],
        ...,
        [ 94, 163, 178],
        [ 88, 157, 172],
        [ 86, 155, 170]],

       ...,

       [[154, 112,  89],
        [146, 104,  82],
        [128,  86,  62],
        ...,
        [152, 106,  93],
        [154, 112, 102],
        [156, 115, 106]],

       [[159, 115,  93],
        [151, 107,  85],
        [131,  87,  64],
        ...,
        [152, 104,  93],
        [141,  97,  88],
        [137,  94,  87]],

       [[161, 117,  94],
        [153, 109,  86],
        [133,  88,  65],
        ...,
        [151, 103,  92],
        [136,  91,  83],
        [129,  86,  79]]], dtype=uint8)]"
Image_1736.jpg,582,314,195,149,1440,960,777,463,195,daskShared_local/images/Image_1736.jpg,1736,"[array([[[  0, 146, 206],
        [  1, 147, 207],
        [  0, 146, 206],
        ...,
        [  0, 147, 216],
        [  0, 147, 216],
        [  0, 147, 216]],

       [[  0, 146, 206],
        [  1, 147, 207],
        [  0, 145, 205],
        ...,
        [  0, 146, 215],
        [  0, 146, 215],
        [  0, 147, 216]],

       [[  0, 146, 206],
        [  1, 147, 207],
        [  0, 146, 206],
        ...,
        [  0, 145, 214],
        [  0, 144, 213],
        [  0, 147, 216]],

       ...,

       [[139, 146,  94],
        [125, 133,  90],
        [134, 140,  96],
        ...,
        [  2,  86, 120],
        [  5,  79, 116],
        [  2,  74, 112]],

       [[154, 165, 109],
        [153, 165, 115],
        [156, 157, 113],
        ...,
        [  0,  80, 114],
        [  0,  84, 115],
        [  0,  70, 108]],

       [[163, 171, 114],
        [163, 172, 119],
        [162, 159, 111],
        ...,
        [  0,  82, 116],
        [  0,  87, 116],
        [  0,  72, 110]]], dtype=uint8)]"
Image_1737.jpg,449,153,140,110,1024,512,589,263,140,daskShared_local/images/Image_1737.jpg,1737,"[array([[[  0, 132, 189],
        [  0, 133, 190],
        [  0, 133, 190],
        ...,
        [  0, 166, 210],
        [  0, 166, 210],
        [  0, 166, 210]],

       [[  0, 133, 190],
        [  0, 133, 190],
        [  1, 134, 191],
        ...,
        [  0, 166, 210],
        [  0, 166, 210],
        [  0, 166, 210]],

       [[  0, 133, 190],
        [  1, 134, 191],
        [  2, 135, 192],
        ...,
        [  0, 166, 210],
        [  0, 166, 210],
        [  0, 166, 210]],

       ...,

       [[154, 137, 104],
        [141, 124,  92],
        [132, 117,  84],
        ...,
        [  1, 145, 198],
        [  1, 145, 198],
        [  0, 144, 197]],

       [[154, 141, 113],
        [150, 137, 108],
        [145, 132, 103],
        ...,
        [  1, 145, 198],
        [  0, 144, 197],
        [  0, 144, 197]],

       [[162, 151, 125],
        [173, 162, 135],
        [181, 170, 142],
        ...,
        [  0, 144, 197],
        [  0, 144, 197],
        [  0, 144, 197]]], dtype=uint8)]"
Image_1738.jpg,109,80,88,59,475,264,197,139,88,daskShared_local/images/Image_1738.jpg,1738,"[array([[[21, 36, 52],
        [22, 36, 52],
        [20, 36, 52],
        ...,
        [21, 38, 63],
        [22, 39, 64],
        [22, 38, 64]],

       [[21, 36, 52],
        [22, 36, 52],
        [20, 36, 52],
        ...,
        [21, 38, 63],
        [22, 39, 64],
        [21, 39, 64]],

       [[20, 36, 53],
        [21, 37, 53],
        [19, 36, 53],
        ...,
        [21, 38, 62],
        [22, 38, 63],
        [22, 38, 63]],

       ...,

       [[16, 25, 32],
        [17, 26, 33],
        [16, 25, 32],
        ...,
        [50, 64, 66],
        [47, 61, 63],
        [48, 62, 64]],

       [[16, 25, 32],
        [16, 25, 32],
        [15, 24, 31],
        ...,
        [57, 74, 77],
        [53, 70, 74],
        [54, 71, 74]],

       [[16, 25, 32],
        [16, 25, 32],
        [15, 24, 31],
        ...,
        [55, 72, 74],
        [52, 68, 71],
        [53, 69, 72]]], dtype=uint8)]"
Image_1739.jpg,578,175,184,177,1000,665,762,352,184,daskShared_local/images/Image_1739.jpg,1739,"[array([[[ 45, 134, 200],
        [ 50, 136, 201],
        [ 47, 134, 202],
        ...,
        [ 25, 130, 196],
        [ 17, 129, 197],
        [ 22, 130, 195]],

       [[ 36, 132, 200],
        [ 46, 134, 201],
        [ 43, 134, 201],
        ...,
        [ 24, 130, 195],
        [ 19, 130, 196],
        [ 31, 130, 198]],

       [[ 32, 133, 199],
        [ 45, 135, 201],
        [ 40, 133, 201],
        ...,
        [  9, 128, 194],
        [ 15, 129, 195],
        [ 24, 130, 196]],

       ...,

       [[  8,  80,  88],
        [ 12,  84,  95],
        [  7,  83,  98],
        ...,
        [  2,  77,  83],
        [  4,  77,  84],
        [  6,  78,  85]],

       [[  4,  64,  69],
        [ 15,  69,  73],
        [ 21,  76,  84],
        ...,
        [  5,  79,  86],
        [  5,  78,  87],
        [ 10,  80,  88]],

       [[ 19,  74,  79],
        [ 15,  66,  70],
        [ 10,  55,  61],
        ...,
        [ 24,  89,  98],
        [ 14,  84,  93],
        [ 16,  83,  91]]], dtype=uint8)]"
Image_174.jpg,1028,1503,1072,772,4613,2968,2100,2275,1072,daskShared_local/images/Image_174.jpg,174,"[array([[[124, 139, 142],
        [121, 138, 140],
        [119, 138, 139],
        ...,
        [ 82,  68,  59],
        [ 87,  73,  64],
        [ 91,  78,  69]],

       [[126, 142, 144],
        [125, 141, 142],
        [123, 139, 139],
        ...,
        [ 74,  62,  54],
        [ 81,  70,  62],
        [ 84,  74,  66]],

       [[126, 145, 146],
        [128, 142, 143],
        [127, 139, 140],
        ...,
        [ 68,  57,  52],
        [ 67,  56,  51],
        [ 63,  52,  46]],

       ...,

       [[ 58,  61,  64],
        [ 64,  71,  70],
        [ 68,  73,  72],
        ...,
        [138, 126, 110],
        [109, 106,  93],
        [125, 120, 104]],

       [[ 56,  58,  60],
        [ 64,  72,  70],
        [ 71,  81,  77],
        ...,
        [159, 154, 139],
        [147, 163, 151],
        [137, 150, 149]],

       [[ 50,  52,  53],
        [ 49,  53,  53],
        [ 64,  73,  71],
        ...,
        [ 83,  84,  77],
        [ 93, 106,  99],
        [119, 134, 134]]], dtype=uint8)]"
Image_1740.jpg,776,510,1230,1495,3072,2304,2006,2005,1495,daskShared_local/images/Image_1740.jpg,1740,"[array([[[108,  97,  95],
        [ 97,  88,  85],
        [ 94,  89,  88],
        ...,
        [ 73,  48,  61],
        [ 76,  51,  66],
        [ 82,  54,  74]],

       [[111, 102, 103],
        [102,  94,  95],
        [118, 113, 113],
        ...,
        [ 76,  52,  65],
        [ 81,  57,  70],
        [ 80,  56,  71]],

       [[114, 112, 109],
        [113, 109, 110],
        [121, 119, 119],
        ...,
        [ 89,  65,  79],
        [ 91,  64,  79],
        [ 85,  63,  78]],

       ...,

       [[  9, 113, 124],
        [  8, 113, 122],
        [  6, 113, 119],
        ...,
        [  9,  97, 109],
        [ 11,  94, 111],
        [ 17,  98, 116]],

       [[  8, 112, 123],
        [  7, 112, 121],
        [  6, 113, 120],
        ...,
        [  7,  94, 108],
        [ 13,  96, 115],
        [ 27, 108, 129]],

       [[  7, 111, 121],
        [  6, 112, 121],
        [  7, 111, 121],
        ...,
        [  8,  95, 112],
        [ 18, 102, 122],
        [ 35, 114, 136]]], dtype=uint8)]"
Image_1741.jpg,205,332,333,194,1024,768,538,526,333,daskShared_local/images/Image_1741.jpg,1741,"[array([[[100, 155, 161],
        [ 89, 140, 152],
        [ 97, 150, 164],
        ...,
        [ 94, 126, 147],
        [ 63,  94, 115],
        [ 73, 105, 125]],

       [[ 78, 126, 134],
        [ 97, 140, 157],
        [ 94, 145, 162],
        ...,
        [ 25,  59,  80],
        [ 54,  86, 107],
        [ 71, 103, 123]],

       [[ 72, 116, 127],
        [ 48,  87, 109],
        [ 54, 102, 120],
        ...,
        [ 74, 111, 130],
        [ 53,  88, 108],
        [ 60,  95, 114]],

       ...,

       [[154, 216, 195],
        [162, 227, 199],
        [142, 191, 153],
        ...,
        [ 95, 145, 162],
        [ 86, 131, 151],
        [ 95, 140, 156]],

       [[174, 255, 241],
        [167, 255, 236],
        [177, 246, 205],
        ...,
        [ 98, 148, 165],
        [ 74, 105, 125],
        [104, 134, 148]],

       [[178, 254, 242],
        [175, 255, 239],
        [181, 251, 216],
        ...,
        [100, 153, 171],
        [ 92, 126, 146],
        [106, 139, 153]]], dtype=uint8)]"
Image_1742.jpg,502,146,206,147,800,600,708,293,206,daskShared_local/images/Image_1742.jpg,1742,"[array([[[  0,  18,  51],
        [  3,  21,  57],
        [  8,  23,  54],
        ...,
        [ 13,  20,  28],
        [ 10,  15,  21],
        [  8,  11,  18]],

       [[  3,  19,  55],
        [  5,  19,  58],
        [  2,  18,  54],
        ...,
        [ 10,  17,  25],
        [  9,  12,  21],
        [  9,   9,  17]],

       [[  3,  16,  53],
        [  2,  17,  55],
        [  0,  19,  52],
        ...,
        [  9,  16,  24],
        [  8,  11,  20],
        [  8,   9,  16]],

       ...,

       [[206, 184, 139],
        [215, 191, 137],
        [208, 176, 128],
        ...,
        [ 38,  39,  44],
        [ 37,  39,  39],
        [ 44,  46,  43]],

       [[214, 195, 151],
        [224, 202, 150],
        [214, 183, 138],
        ...,
        [ 39,  40,  38],
        [ 31,  34,  27],
        [ 35,  38,  31]],

       [[206, 191, 150],
        [209, 193, 144],
        [210, 182, 141],
        ...,
        [ 27,  30,  22],
        [ 30,  34,  20],
        [ 33,  36,  25]]], dtype=uint8)]"
Image_1743.jpg,105,113,426,271,800,533,531,384,426,daskShared_local/images/Image_1743.jpg,1743,"[array([[[  5,  13,  60],
        [  3,  12,  58],
        [  3,  10,  57],
        ...,
        [  7,  20,  73],
        [ 10,  23,  76],
        [  9,  23,  77]],

       [[  3,  12,  58],
        [  3,  12,  59],
        [  4,  10,  58],
        ...,
        [  8,  22,  75],
        [  9,  22,  76],
        [ 10,  24,  76]],

       [[  6,  15,  59],
        [  7,  15,  60],
        [  8,  14,  60],
        ...,
        [  5,  18,  71],
        [ 10,  22,  76],
        [  9,  22,  75]],

       ...,

       [[  9,  15,  59],
        [ 10,  15,  60],
        [  7,  13,  58],
        ...,
        [125,  95,  50],
        [135, 104,  55],
        [137, 108,  63]],

       [[  7,  14,  58],
        [  9,  15,  60],
        [  7,  14,  60],
        ...,
        [129, 102,  58],
        [143, 114,  71],
        [141, 111,  68]],

       [[  8,  15,  59],
        [  8,  15,  59],
        [  8,  15,  61],
        ...,
        [126,  98,  53],
        [138, 105,  60],
        [141, 106,  56]]], dtype=uint8)]"
Image_1744.jpg,127,389,372,287,1715,1286,499,676,372,daskShared_local/images/Image_1744.jpg,1744,"[array([[[156, 171, 167],
        [155, 172, 168],
        [154, 171, 165],
        ...,
        [156, 172, 149],
        [159, 177, 138],
        [161, 179, 135]],

       [[155, 171, 167],
        [155, 172, 166],
        [155, 172, 166],
        ...,
        [151, 170, 162],
        [156, 177, 167],
        [161, 175, 169]],

       [[156, 171, 167],
        [156, 171, 167],
        [156, 170, 164],
        ...,
        [122, 163, 165],
        [155, 174, 170],
        [154, 172, 164]],

       ...,

       [[173, 154, 193],
        [163, 150, 181],
        [154, 145, 169],
        ...,
        [200, 207, 222],
        [202, 207, 224],
        [203, 208, 221]],

       [[178, 169, 161],
        [178, 165, 154],
        [177, 163, 147],
        ...,
        [200, 207, 221],
        [199, 204, 221],
        [199, 206, 225]],

       [[183, 190, 149],
        [187, 189, 148],
        [187, 188, 147],
        ...,
        [197, 206, 218],
        [200, 205, 216],
        [200, 207, 220]]], dtype=uint8)]"
Image_1745.jpg,317,290,147,96,1280,720,464,386,147,daskShared_local/images/Image_1745.jpg,1745,"[array([[[  1,  61, 134],
        [  1,  60, 135],
        [  1,  60, 136],
        ...,
        [  0,  62, 139],
        [  0,  62, 139],
        [  0,  62, 139]],

       [[  1,  61, 134],
        [  1,  60, 135],
        [  1,  60, 136],
        ...,
        [  0,  62, 139],
        [  0,  62, 139],
        [  0,  62, 139]],

       [[  1,  61, 134],
        [  1,  60, 135],
        [  1,  60, 136],
        ...,
        [  0,  62, 139],
        [  0,  62, 139],
        [  0,  62, 139]],

       ...,

       [[ 31, 105, 130],
        [ 31, 105, 130],
        [ 31, 105, 130],
        ...,
        [ 19,  97, 131],
        [ 19,  97, 131],
        [ 19,  98, 131]],

       [[ 31, 106, 130],
        [ 31, 106, 130],
        [ 31, 106, 130],
        ...,
        [ 20,  98, 131],
        [ 20,  98, 131],
        [ 20,  98, 131]],

       [[ 32, 107, 130],
        [ 32, 107, 130],
        [ 32, 107, 130],
        ...,
        [ 21,  97, 131],
        [ 21,  97, 131],
        [ 21,  97, 131]]], dtype=uint8)]"
Image_1746.jpg,348,24,614,514,1190,595,962,538,614,daskShared_local/images/Image_1746.jpg,1746,"[array([[[206, 224, 234],
        [210, 229, 237],
        [210, 228, 235],
        ...,
        [205, 216, 207],
        [204, 216, 206],
        [202, 214, 204]],

       [[215, 234, 243],
        [216, 235, 245],
        [217, 236, 245],
        ...,
        [204, 216, 206],
        [204, 216, 206],
        [202, 215, 205]],

       [[219, 239, 247],
        [216, 235, 243],
        [218, 236, 245],
        ...,
        [205, 217, 206],
        [203, 214, 206],
        [203, 214, 206]],

       ...,

       [[ 44,  29,  28],
        [ 45,  30,  31],
        [ 45,  30,  34],
        ...,
        [150,  90,  83],
        [159, 103,  98],
        [169, 119, 111]],

       [[ 43,  28,  28],
        [ 47,  28,  30],
        [ 51,  30,  32],
        ...,
        [151,  83,  78],
        [154,  96,  90],
        [163, 114, 101]],

       [[ 53,  28,  29],
        [ 53,  26,  29],
        [ 80,  34,  45],
        ...,
        [148,  77,  72],
        [153,  92,  87],
        [158, 109,  98]]], dtype=uint8)]"
Image_1747.jpg,1633,508,816,635,4100,2660,2449,1143,816,daskShared_local/images/Image_1747.jpg,1747,"[array([[[186, 174, 160],
        [186, 176, 164],
        [188, 177, 165],
        ...,
        [145, 138, 121],
        [145, 137, 124],
        [146, 138, 125]],

       [[188, 175, 158],
        [185, 174, 161],
        [187, 175, 162],
        ...,
        [148, 141, 124],
        [146, 138, 124],
        [148, 140, 126]],

       [[186, 173, 155],
        [187, 174, 161],
        [185, 173, 159],
        ...,
        [147, 140, 125],
        [150, 143, 126],
        [148, 141, 124]],

       ...,

       [[ 67,  58,  51],
        [ 65,  54,  47],
        [ 61,  48,  41],
        ...,
        [212, 219, 232],
        [216, 222, 233],
        [218, 226, 240]],

       [[ 62,  50,  44],
        [ 63,  48,  44],
        [ 61,  48,  45],
        ...,
        [215, 222, 229],
        [219, 228, 236],
        [221, 229, 241]],

       [[ 56,  40,  35],
        [ 57,  42,  40],
        [ 57,  46,  44],
        ...,
        [224, 230, 240],
        [227, 234, 242],
        [228, 234, 244]]], dtype=uint8)]"
Image_1748.jpg,334,125,202,201,770,422,536,326,202,daskShared_local/images/Image_1748.jpg,1748,"[array([[[225, 185,  89],
        [226, 188,  92],
        [219, 182,  50],
        ...,
        [ 23, 108, 199],
        [ 19, 102, 194],
        [ 20, 101, 192]],

       [[197, 172,  91],
        [182, 159,  82],
        [186, 165,  88],
        ...,
        [ 27, 112, 203],
        [ 25, 109, 199],
        [ 26, 107, 198]],

       [[163, 148,  84],
        [144, 133,  73],
        [127, 117,  94],
        ...,
        [ 24, 112, 202],
        [ 28, 113, 203],
        [ 32, 115, 203]],

       ...,

       [[ 19,  35,  24],
        [  7,  19,  14],
        [  4,  13,  18],
        ...,
        [  0,  18,  40],
        [  3,  21,  43],
        [  3,  24,  45]],

       [[ 12,  26,  26],
        [ 11,  21,  27],
        [  0,   9,  18],
        ...,
        [  0,  18,  40],
        [  0,  21,  42],
        [  1,  22,  43]],

       [[ 12,  23,  29],
        [ 29,  39,  49],
        [  0,  11,  17],
        ...,
        [  2,  20,  42],
        [  1,  22,  43],
        [  1,  22,  43]]], dtype=uint8)]"
Image_1749.jpg,437,203,206,187,900,600,643,390,206,daskShared_local/images/Image_1749.jpg,1749,"[array([[[  5, 132, 237],
        [  4, 133, 237],
        [  4, 132, 239],
        ...,
        [  1,  92, 207],
        [  1,  92, 207],
        [  0,  91, 206]],

       [[  3, 132, 236],
        [  3, 132, 236],
        [  3, 131, 238],
        ...,
        [  1,  92, 207],
        [  1,  92, 207],
        [  0,  91, 206]],

       [[  3, 132, 236],
        [  1, 132, 238],
        [  1, 132, 238],
        ...,
        [  1,  92, 207],
        [  1,  92, 207],
        [  0,  91, 206]],

       ...,

       [[179, 171, 123],
        [157, 147,  98],
        [166, 154, 103],
        ...,
        [  0,  54, 160],
        [  0,  54, 163],
        [  0,  53, 167]],

       [[174, 167, 113],
        [166, 159, 104],
        [166, 157, 100],
        ...,
        [  0,  54, 163],
        [  0,  54, 165],
        [  0,  53, 167]],

       [[136, 131,  67],
        [190, 185, 119],
        [184, 179, 111],
        ...,
        [  0,  56, 165],
        [  0,  56, 167],
        [  0,  55, 168]]], dtype=uint8)]"
Image_175.jpg,1433,431,454,369,2500,1667,1887,800,454,daskShared_local/images/Image_175.jpg,175,"[array([[[118, 168, 177],
        [124, 170, 179],
        [123, 167, 176],
        ...,
        [162, 185, 205],
        [158, 183, 203],
        [159, 184, 203]],

       [[126, 172, 178],
        [129, 171, 177],
        [126, 165, 174],
        ...,
        [186, 201, 217],
        [184, 201, 217],
        [176, 193, 210]],

       [[125, 171, 176],
        [118, 163, 170],
        [117, 161, 171],
        ...,
        [221, 227, 239],
        [213, 220, 232],
        [204, 212, 224]],

       ...,

       [[193, 184, 164],
        [187, 180, 157],
        [186, 184, 156],
        ...,
        [175, 175, 140],
        [174, 174, 140],
        [166, 164, 130]],

       [[198, 190, 165],
        [198, 191, 165],
        [197, 193, 164],
        ...,
        [176, 174, 136],
        [166, 163, 126],
        [164, 160, 125]],

       [[167, 156, 121],
        [178, 167, 134],
        [180, 173, 139],
        ...,
        [172, 169, 127],
        [165, 161, 120],
        [164, 160, 121]]], dtype=uint8)]"
Image_1750.jpg,106,110,135,123,500,375,241,233,135,daskShared_local/images/Image_1750.jpg,1750,"[array([[[ 58, 125, 151],
        [ 60, 127, 153],
        [ 65, 132, 158],
        ...,
        [ 30,  78, 116],
        [ 36,  85, 117],
        [ 41,  90, 117]],

       [[ 54, 121, 147],
        [ 55, 122, 148],
        [ 58, 125, 151],
        ...,
        [ 27,  75, 112],
        [ 33,  82, 113],
        [ 38,  88, 114]],

       [[ 52, 119, 145],
        [ 52, 119, 145],
        [ 51, 118, 144],
        ...,
        [ 23,  71, 107],
        [ 28,  77, 108],
        [ 33,  82, 109]],

       ...,

       [[ 36, 135, 159],
        [ 37, 136, 161],
        [ 40, 139, 163],
        ...,
        [200, 200, 209],
        [202, 202, 208],
        [202, 203, 206]],

       [[ 33, 131, 156],
        [ 33, 131, 156],
        [ 36, 134, 159],
        ...,
        [206, 203, 209],
        [205, 204, 207],
        [204, 204, 205]],

       [[ 30, 128, 153],
        [ 31, 129, 154],
        [ 33, 131, 156],
        ...,
        [209, 204, 209],
        [207, 205, 206],
        [205, 204, 204]]], dtype=uint8)]"
Image_1751.jpg,320,276,260,224,750,740,580,500,260,daskShared_local/images/Image_1751.jpg,1751,"[array([[[ 49, 210, 226],
        [ 51, 210, 226],
        [ 55, 209, 225],
        ...,
        [ 11, 197, 220],
        [ 10, 195, 218],
        [ 11, 193, 217]],

       [[ 36, 204, 221],
        [ 38, 204, 222],
        [ 42, 205, 223],
        ...,
        [ 11, 197, 220],
        [ 10, 195, 218],
        [ 11, 193, 217]],

       [[ 26, 204, 221],
        [ 30, 206, 224],
        [ 33, 207, 225],
        ...,
        [ 11, 197, 218],
        [ 10, 195, 217],
        [ 11, 193, 216]],

       ...,

       [[146, 180, 132],
        [147, 181, 133],
        [149, 183, 135],
        ...,
        [137, 186, 178],
        [141, 190, 184],
        [139, 189, 185]],

       [[140, 184, 133],
        [142, 186, 135],
        [145, 189, 138],
        ...,
        [131, 175, 172],
        [140, 184, 182],
        [142, 187, 186]],

       [[134, 182, 131],
        [137, 185, 134],
        [140, 189, 138],
        ...,
        [127, 167, 169],
        [136, 177, 178],
        [141, 181, 185]]], dtype=uint8)]"
Image_1752.jpg,625,448,217,184,1024,672,842,632,217,daskShared_local/images/Image_1752.jpg,1752,"[array([[[ 88,  97, 104],
        [ 97, 104, 112],
        [110, 114, 123],
        ...,
        [ 84,  90,  93],
        [117, 121, 122],
        [147, 149, 148]],

       [[ 86,  95, 104],
        [ 92,  99, 107],
        [103, 106, 115],
        ...,
        [ 69,  76,  77],
        [ 94,  99,  98],
        [128, 130, 127]],

       [[ 85,  94, 103],
        [ 93, 100, 108],
        [101, 104, 113],
        ...,
        [ 52,  62,  62],
        [ 55,  63,  60],
        [ 72,  80,  73]],

       ...,

       [[ 27,  79, 144],
        [ 30,  83, 146],
        [ 32,  85, 149],
        ...,
        [ 12, 116, 225],
        [ 16, 121, 230],
        [ 19, 124, 233]],

       [[ 28,  82, 149],
        [ 27,  82, 148],
        [ 28,  82, 147],
        ...,
        [ 12, 114, 223],
        [ 18, 120, 228],
        [ 21, 123, 231]],

       [[ 33,  87, 157],
        [ 33,  88, 155],
        [ 32,  87, 154],
        ...,
        [ 12, 114, 222],
        [ 18, 120, 228],
        [ 23, 125, 233]]], dtype=uint8)]"
Image_1753.jpg,308,105,224,295,1000,667,532,400,295,daskShared_local/images/Image_1753.jpg,1753,"[array([[[118, 126, 143],
        [ 68,  95, 125],
        [ 51,  85, 124],
        ...,
        [147, 131, 116],
        [126, 113,  97],
        [102,  90,  74]],

       [[ 35,  82, 126],
        [ 45,  90, 132],
        [ 69, 102, 135],
        ...,
        [125, 109,  93],
        [118, 105,  88],
        [117, 105,  88]],

       [[ 76, 108, 137],
        [111, 131, 150],
        [156, 158, 161],
        ...,
        [127, 112,  95],
        [121, 108,  90],
        [125, 113,  95]],

       ...,

       [[ 25, 107, 163],
        [ 23, 105, 161],
        [ 24, 106, 162],
        ...,
        [172, 146,  97],
        [124,  97,  57],
        [112,  83,  50]],

       [[ 26, 108, 164],
        [ 24, 106, 162],
        [ 25, 107, 163],
        ...,
        [221, 191, 143],
        [190, 156, 114],
        [126,  90,  53]],

       [[ 24, 106, 162],
        [ 24, 106, 162],
        [ 23, 105, 161],
        ...,
        [196, 167, 128],
        [132, 107,  79],
        [ 53,  30,  11]]], dtype=uint8)]"
Image_1754.jpg,391,6,85,65,530,180,476,71,85,daskShared_local/images/Image_1754.jpg,1754,"[array([[[ 10,  38,  81],
        [ 12,  41,  83],
        [  6,  34,  77],
        ...,
        [ 19,  34,  60],
        [ 34,  55,  63],
        [ 29,  48,  62]],

       [[ 11,  42,  84],
        [ 14,  45,  86],
        [  7,  38,  79],
        ...,
        [ 17,  34,  60],
        [ 32,  53,  62],
        [ 27,  47,  61]],

       [[  8,  34,  77],
        [ 10,  35,  79],
        [  5,  30,  74],
        ...,
        [ 21,  35,  60],
        [ 38,  57,  65],
        [ 32,  50,  63]],

       ...,

       [[ 11,  41,  91],
        [ 12,  43,  92],
        [  8,  38,  90],
        ...,
        [ 95,  92,  94],
        [108, 101, 110],
        [104,  98, 105]],

       [[  5,  51,  96],
        [  6,  50,  96],
        [  5,  52,  97],
        ...,
        [111, 108, 104],
        [119, 113, 118],
        [116, 111, 113]],

       [[  8,  47,  94],
        [  9,  47,  94],
        [  6,  46,  94],
        ...,
        [104, 101, 100],
        [114, 107, 115],
        [111, 105, 110]]], dtype=uint8)]"
Image_1755.jpg,752,268,357,303,1200,906,1109,571,357,daskShared_local/images/Image_1755.jpg,1755,"[array([[[ 93,  83,  93],
        [119, 110, 119],
        [128, 121, 130],
        ...,
        [ 16,  51,  73],
        [ 21,  56,  78],
        [ 20,  52,  75]],

       [[108,  97, 109],
        [102,  92, 104],
        [ 85,  77,  88],
        ...,
        [ 17,  53,  75],
        [ 16,  52,  74],
        [ 18,  52,  75]],

       [[ 97,  86, 100],
        [ 68,  58,  72],
        [ 66,  58,  71],
        ...,
        [ 17,  55,  76],
        [ 16,  52,  74],
        [ 16,  52,  74]],

       ...,

       [[ 53,  71,  82],
        [ 56,  79,  90],
        [ 50,  80,  91],
        ...,
        [ 22,  49,  76],
        [ 19,  48,  74],
        [ 16,  50,  73]],

       [[ 48,  68,  82],
        [ 47,  71,  84],
        [ 48,  78,  91],
        ...,
        [ 22,  50,  76],
        [ 21,  52,  76],
        [ 18,  54,  76]],

       [[ 59,  82,  97],
        [ 41,  67,  81],
        [ 46,  75,  90],
        ...,
        [ 20,  52,  76],
        [ 24,  59,  81],
        [ 22,  61,  81]]], dtype=uint8)]"
Image_1756.jpg,293,138,144,112,800,505,437,250,144,daskShared_local/images/Image_1756.jpg,1756,"[array([[[ 36,  95, 103],
        [ 33,  90,  98],
        [ 24,  79,  89],
        ...,
        [ 12,  33,  40],
        [ 15,  39,  46],
        [ 20,  45,  52]],

       [[ 54, 113, 119],
        [ 48, 105, 112],
        [ 38,  92,  99],
        ...,
        [ 12,  34,  40],
        [ 18,  42,  48],
        [ 26,  52,  57]],

       [[ 80, 137, 140],
        [ 72, 128, 132],
        [ 59, 112, 117],
        ...,
        [ 12,  34,  40],
        [ 20,  45,  50],
        [ 29,  57,  61]],

       ...,

       [[ 76,  76,  55],
        [ 76,  76,  56],
        [ 76,  77,  57],
        ...,
        [229, 205, 174],
        [219, 195, 163],
        [214, 191, 158]],

       [[ 74,  72,  51],
        [ 75,  73,  53],
        [ 75,  73,  54],
        ...,
        [212, 190, 159],
        [210, 188, 155],
        [214, 191, 158]],

       [[ 71,  69,  49],
        [ 73,  70,  51],
        [ 73,  71,  52],
        ...,
        [200, 179, 147],
        [203, 182, 149],
        [212, 190, 157]]], dtype=uint8)]"
Image_1757.jpg,431,218,114,175,900,600,545,393,175,daskShared_local/images/Image_1757.jpg,1757,"[array([[[  5, 109, 164],
        [  5, 109, 164],
        [  6, 110, 165],
        ...,
        [  4, 118, 170],
        [  4, 118, 170],
        [  5, 119, 171]],

       [[  5, 109, 164],
        [  5, 109, 164],
        [  6, 110, 165],
        ...,
        [  4, 118, 170],
        [  4, 118, 170],
        [  4, 118, 170]],

       [[  5, 109, 164],
        [  5, 109, 164],
        [  6, 110, 165],
        ...,
        [  3, 117, 169],
        [  4, 118, 170],
        [  4, 118, 170]],

       ...,

       [[119, 111,  24],
        [114, 106,  16],
        [121, 113,  22],
        ...,
        [  3,  94, 139],
        [  3,  94, 137],
        [  3,  95, 136]],

       [[131, 119,  43],
        [122, 110,  31],
        [104,  93,  15],
        ...,
        [  3,  95, 138],
        [  3,  95, 136],
        [  3,  95, 134]],

       [[140, 127,  62],
        [130, 117,  49],
        [135, 123,  50],
        ...,
        [  4,  96, 139],
        [  4,  96, 137],
        [  2,  94, 133]]], dtype=uint8)]"
Image_1758.jpg,773,161,228,186,1050,700,1001,347,228,daskShared_local/images/Image_1758.jpg,1758,"[array([[[ 11, 164, 146],
        [ 10, 153, 142],
        [  7, 145, 135],
        ...,
        [ 15,  91,  93],
        [  3,  84,  84],
        [ 14,  90,  94]],

       [[ 42, 194, 179],
        [ 41, 181, 174],
        [ 49, 170, 167],
        ...,
        [ 19,  94,  97],
        [ 12,  89,  90],
        [ 11,  95,  94]],

       [[ 28, 182, 168],
        [ 50, 187, 183],
        [ 92, 196, 202],
        ...,
        [ 16,  83,  87],
        [ 21,  88,  89],
        [ 11,  79,  81]],

       ...,

       [[ 38,  47,  52],
        [ 39,  48,  53],
        [ 38,  46,  51],
        ...,
        [ 39,  34,  43],
        [ 30,  28,  38],
        [ 28,  22,  29]],

       [[ 33,  42,  47],
        [ 33,  40,  46],
        [ 34,  42,  47],
        ...,
        [ 37,  33,  41],
        [ 33,  29,  39],
        [ 34,  30,  37]],

       [[ 35,  42,  48],
        [ 39,  46,  52],
        [ 39,  48,  53],
        ...,
        [ 33,  34,  41],
        [ 30,  30,  38],
        [ 28,  34,  40]]], dtype=uint8)]"
Image_1759.jpg,356,104,307,282,1024,670,663,386,307,daskShared_local/images/Image_1759.jpg,1759,"[array([[[  5,  70, 118],
        [  4,  68, 115],
        [  4,  68, 112],
        ...,
        [  6,  18,  32],
        [  8,  20,  34],
        [  4,  16,  30]],

       [[  3,  67, 115],
        [  2,  66, 112],
        [  4,  68, 112],
        ...,
        [  5,  17,  31],
        [  4,  16,  30],
        [  4,  16,  30]],

       [[  0,  63, 108],
        [  2,  65, 108],
        [  2,  65, 108],
        ...,
        [  4,  15,  32],
        [  2,  14,  28],
        [  5,  17,  29]],

       ...,

       [[ 85, 149,  95],
        [ 47, 106,  59],
        [ 11,  59,  20],
        ...,
        [  6,  23,  27],
        [  5,  24,  27],
        [  7,  26,  30]],

       [[ 40,  80,  45],
        [  6,  42,   3],
        [ 13,  50,   7],
        ...,
        [  6,  21,  24],
        [  6,  22,  24],
        [  6,  23,  25]],

       [[ 23,  38,  20],
        [ 33,  47,  10],
        [ 36,  63,   7],
        ...,
        [  6,  17,  21],
        [  5,  19,  22],
        [ 10,  25,  28]]], dtype=uint8)]"
Image_176.jpg,415,373,299,212,1536,1024,714,585,299,daskShared_local/images/Image_176.jpg,176,"[array([[[ 15, 142, 247],
        [ 15, 141, 244],
        [ 10, 136, 239],
        ...,
        [ 13, 160, 243],
        [ 12, 160, 243],
        [ 16, 164, 247]],

       [[ 15, 139, 248],
        [ 16, 140, 245],
        [ 11, 133, 242],
        ...,
        [ 15, 156, 244],
        [ 13, 155, 242],
        [ 18, 161, 248]],

       [[ 13, 136, 247],
        [ 16, 136, 246],
        [ 15, 135, 248],
        ...,
        [ 12, 153, 243],
        [ 12, 151, 242],
        [ 17, 156, 247]],

       ...,

       [[  9,  62, 210],
        [  9,  61, 212],
        [  9,  60, 211],
        ...,
        [ 19,  60,  51],
        [ 14,  49,  47],
        [ 27,  59,  55]],

       [[ 10,  61, 210],
        [ 11,  62, 213],
        [ 10,  62, 211],
        ...,
        [ 20,  84,  67],
        [ 24,  57,  42],
        [ 30,  47,  36]],

       [[ 10,  61, 208],
        [ 10,  62, 211],
        [ 10,  62, 210],
        ...,
        [ 30, 100,  96],
        [ 14,  62,  42],
        [ 17,  55,  49]]], dtype=uint8)]"
Image_1760.jpg,271,331,143,112,900,599,414,443,143,daskShared_local/images/Image_1760.jpg,1760,"[array([[[ 66, 133, 211],
        [ 66, 133, 211],
        [ 66, 133, 211],
        ...,
        [162, 201, 218],
        [195, 227, 238],
        [202, 231, 237]],

       [[ 66, 133, 211],
        [ 66, 133, 211],
        [ 65, 132, 210],
        ...,
        [183, 219, 232],
        [200, 229, 235],
        [199, 223, 226]],

       [[ 66, 133, 211],
        [ 65, 132, 210],
        [ 65, 132, 210],
        ...,
        [202, 233, 241],
        [207, 230, 230],
        [203, 221, 218]],

       ...,

       [[ 45,  86, 165],
        [ 45,  86, 165],
        [ 45,  86, 165],
        ...,
        [ 48,  91, 169],
        [ 48,  91, 169],
        [ 49,  92, 170]],

       [[ 46,  86, 165],
        [ 46,  86, 165],
        [ 46,  86, 165],
        ...,
        [ 48,  91, 169],
        [ 48,  91, 169],
        [ 49,  92, 170]],

       [[ 47,  86, 165],
        [ 47,  86, 165],
        [ 47,  86, 165],
        ...,
        [ 48,  91, 169],
        [ 48,  91, 169],
        [ 48,  91, 169]]], dtype=uint8)]"
Image_1761.jpg,277,172,255,223,1000,541,532,395,255,daskShared_local/images/Image_1761.jpg,1761,"[array([[[  0, 125, 156],
        [  0, 132, 167],
        [  8, 138, 176],
        ...,
        [  0, 105, 121],
        [  0, 105, 121],
        [  1, 102, 120]],

       [[  0, 129, 161],
        [  0, 136, 170],
        [  2, 140, 177],
        ...,
        [  0, 108, 120],
        [  0, 107, 119],
        [  0, 104, 118]],

       [[  1, 132, 164],
        [  0, 139, 171],
        [  0, 141, 177],
        ...,
        [  0, 114, 123],
        [  0, 112, 122],
        [  3, 108, 120]],

       ...,

       [[  1,  86, 103],
        [  0,  80, 100],
        [  2,  72,  89],
        ...,
        [214, 220, 243],
        [187, 198, 223],
        [126, 142, 167]],

       [[  2,  99, 121],
        [  1,  90, 107],
        [  0,  79,  95],
        ...,
        [131, 151, 186],
        [ 82, 115, 147],
        [ 53,  98, 122]],

       [[  3, 104, 125],
        [  1,  95, 110],
        [  3,  81,  95],
        ...,
        [ 49,  94, 124],
        [ 46,  94, 121],
        [ 59, 105, 129]]], dtype=uint8)]"
Image_1762.jpg,389,182,146,133,770,578,535,315,146,daskShared_local/images/Image_1762.jpg,1762,"[array([[[174, 157, 148],
        [169, 152, 143],
        [160, 143, 136],
        ...,
        [ 75,  74,  90],
        [ 72,  72,  88],
        [ 73,  74,  89]],

       [[172, 155, 145],
        [167, 150, 141],
        [161, 145, 138],
        ...,
        [ 78,  77,  91],
        [ 75,  75,  89],
        [ 75,  77,  90]],

       [[168, 151, 141],
        [165, 148, 139],
        [162, 146, 139],
        ...,
        [ 82,  83,  92],
        [ 79,  80,  91],
        [ 79,  81,  92]],

       ...,

       [[143, 148, 151],
        [126, 131, 134],
        [109, 114, 117],
        ...,
        [115, 119, 112],
        [135, 141, 134],
        [117, 125, 118]],

       [[150, 154, 155],
        [130, 134, 135],
        [111, 115, 116],
        ...,
        [105, 110, 103],
        [107, 115, 107],
        [ 84,  94,  86]],

       [[152, 156, 157],
        [134, 138, 139],
        [112, 116, 117],
        ...,
        [ 83,  87,  81],
        [ 73,  80,  73],
        [ 56,  65,  58]]], dtype=uint8)]"
Image_1763.jpg,293,355,190,156,1024,683,483,511,190,daskShared_local/images/Image_1763.jpg,1763,"[array([[[177, 193, 182],
        [177, 194, 184],
        [179, 199, 190],
        ...,
        [ 68,  64,  56],
        [ 71,  66,  60],
        [ 80,  80,  72]],

       [[169, 188, 182],
        [162, 181, 177],
        [152, 172, 169],
        ...,
        [ 75,  72,  67],
        [ 71,  69,  64],
        [ 79,  80,  72]],

       [[144, 161, 167],
        [145, 162, 169],
        [134, 151, 158],
        ...,
        [ 72,  72,  71],
        [ 73,  73,  71],
        [ 84,  87,  78]],

       ...,

       [[  0, 104, 131],
        [  0, 104, 131],
        [  0, 104, 131],
        ...,
        [  0, 114, 140],
        [  0, 114, 140],
        [  0, 114, 140]],

       [[  0, 104, 131],
        [  0, 104, 131],
        [  0, 104, 131],
        ...,
        [  0, 114, 141],
        [  0, 114, 141],
        [  0, 114, 141]],

       [[  0, 104, 131],
        [  0, 104, 131],
        [  0, 104, 131],
        ...,
        [  0, 114, 141],
        [  0, 114, 141],
        [  0, 114, 141]]], dtype=uint8)]"
Image_1764.jpg,184,205,502,297,1599,1065,686,502,502,daskShared_local/images/Image_1764.jpg,1764,"[array([[[  4,   0,   1],
        [  4,   0,   1],
        [  4,   0,   1],
        ...,
        [  4,   0,   1],
        [  4,   0,   1],
        [  4,   0,   1]],

       [[  4,   0,   1],
        [  4,   0,   1],
        [  4,   0,   1],
        ...,
        [  4,   0,   1],
        [  4,   0,   1],
        [  4,   0,   1]],

       [[  4,   0,   1],
        [  4,   0,   1],
        [  4,   0,   1],
        ...,
        [  4,   0,   1],
        [  4,   0,   1],
        [  4,   0,   1]],

       ...,

       [[  4,   0,   1],
        [  4,   0,   1],
        [  4,   0,   1],
        ...,
        [154, 203, 177],
        [154, 186, 166],
        [128, 158, 130]],

       [[  4,   0,   1],
        [  4,   0,   1],
        [  4,   0,   1],
        ...,
        [157, 200, 178],
        [135, 157, 140],
        [134, 156, 121]],

       [[  4,   0,   1],
        [  4,   0,   1],
        [  4,   0,   1],
        ...,
        [150, 189, 173],
        [148, 181, 161],
        [138, 164, 158]]], dtype=uint8)]"
Image_1765.JPG,287,425,1499,1495,2560,1920,1786,1920,1499,daskShared_local/images/Image_1765.JPG,1765,"[array([[[ 85,  71,  28],
        [ 84,  70,  28],
        [ 86,  68,  27],
        ...,
        [129, 111,  68],
        [140, 127,  95],
        [157, 140, 115]],

       [[ 77,  67,  29],
        [ 78,  68,  33],
        [ 79,  69,  27],
        ...,
        [134, 115,  81],
        [141, 127,  98],
        [156, 139, 115]],

       [[ 76,  67,  27],
        [ 77,  67,  31],
        [ 81,  68,  34],
        ...,
        [130, 113,  80],
        [136, 118,  77],
        [147, 122,  76]],

       ...,

       [[ 77,  83,  27],
        [ 79,  87,  38],
        [ 96, 106,  73],
        ...,
        [ 89,  99,  29],
        [ 88,  99,  32],
        [ 88, 101,  29]],

       [[ 79,  81,  34],
        [ 78,  83,  40],
        [ 87,  97,  61],
        ...,
        [ 91, 100,  28],
        [ 88, 102,  32],
        [ 85,  99,  32]],

       [[ 77,  84,  22],
        [ 79,  88,  29],
        [ 80,  88,  33],
        ...,
        [ 90,  97,  30],
        [ 87,  99,  33],
        [ 88,  98,  28]]], dtype=uint8)]"
Image_1766.jpg,290,392,204,211,1024,768,494,603,211,daskShared_local/images/Image_1766.jpg,1766,"[array([[[ 83,  73,  68],
        [ 88,  81,  73],
        [106,  99,  91],
        ...,
        [122,  91,  45],
        [ 78,  43,   9],
        [116,  83,  42]],

       [[ 65,  51,  47],
        [ 81,  71,  64],
        [ 98,  84,  79],
        ...,
        [133, 100,  51],
        [ 83,  49,   9],
        [139, 109,  57]],

       [[ 48,  35,  23],
        [ 63,  48,  37],
        [ 75,  58,  49],
        ...,
        [129,  97,  52],
        [ 97,  65,  23],
        [138, 109,  54]],

       ...,

       [[242, 216, 177],
        [225, 195, 167],
        [223, 191, 160],
        ...,
        [205, 178, 139],
        [189, 163, 120],
        [177, 149, 107]],

       [[232, 211, 167],
        [234, 209, 173],
        [223, 197, 160],
        ...,
        [197, 165, 125],
        [185, 153, 110],
        [190, 158, 116]],

       [[220, 198, 151],
        [231, 208, 166],
        [235, 213, 173],
        ...,
        [169, 135,  93],
        [157, 120,  78],
        [194, 160, 119]]], dtype=uint8)]"
Image_1767.jpg,553,226,288,243,986,653,841,469,288,daskShared_local/images/Image_1767.jpg,1767,"[array([[[158, 160, 137],
        [162, 163, 139],
        [153, 152, 126],
        ...,
        [ 62, 119, 100],
        [ 62, 119, 100],
        [ 61, 118,  99]],

       [[131, 131, 106],
        [175, 175, 148],
        [142, 141, 112],
        ...,
        [ 61, 118,  99],
        [ 61, 118,  99],
        [ 60, 117,  98]],

       [[115, 114,  85],
        [150, 148, 117],
        [146, 143, 110],
        ...,
        [ 61, 118,  99],
        [ 61, 118,  99],
        [ 60, 117,  98]],

       ...,

       [[ 71,  90,  12],
        [ 75,  94,  16],
        [ 80,  99,  21],
        ...,
        [ 54,  80,  42],
        [ 54,  80,  42],
        [ 55,  81,  44]],

       [[ 82, 102,  11],
        [ 85, 105,  15],
        [ 90, 108,  20],
        ...,
        [ 55,  81,  41],
        [ 54,  80,  41],
        [ 55,  81,  44]],

       [[ 96, 118,  12],
        [100, 120,  15],
        [102, 121,  19],
        ...,
        [ 55,  82,  41],
        [ 53,  79,  39],
        [ 53,  79,  40]]], dtype=uint8)]"
Image_1768.jpg,663,244,338,288,2121,1063,1001,532,338,daskShared_local/images/Image_1768.jpg,1768,"[array([[[100, 156, 169],
        [ 98, 152, 164],
        [ 93, 143, 156],
        ...,
        [136, 157, 163],
        [140, 161, 167],
        [138, 158, 166]],

       [[ 97, 155, 167],
        [ 96, 154, 166],
        [100, 154, 168],
        ...,
        [132, 153, 155],
        [134, 155, 158],
        [133, 154, 158]],

       [[ 95, 155, 166],
        [101, 160, 171],
        [ 98, 156, 169],
        ...,
        [132, 153, 152],
        [129, 150, 151],
        [129, 149, 152]],

       ...,

       [[ 56, 104, 123],
        [ 53, 101, 121],
        [ 55, 103, 123],
        ...,
        [163, 157, 138],
        [159, 152, 134],
        [129, 121, 102]],

       [[ 55, 103, 121],
        [ 54, 102, 122],
        [ 53, 101, 121],
        ...,
        [164, 158, 141],
        [181, 174, 156],
        [165, 157, 138]],

       [[ 56, 105, 123],
        [ 56, 104, 124],
        [ 53, 101, 121],
        ...,
        [153, 149, 133],
        [174, 168, 149],
        [167, 160, 141]]], dtype=uint8)]"
Image_1769.jpg,1053,1210,985,838,3840,2160,2038,2048,985,daskShared_local/images/Image_1769.jpg,1769,"[array([[[153, 151, 145],
        [205, 211, 193],
        [209, 212, 187],
        ...,
        [ 58,  50,  45],
        [ 70,  60,  53],
        [ 76,  65,  54]],

       [[104,  95,  97],
        [177, 177, 164],
        [211, 210, 185],
        ...,
        [ 35,  32,  27],
        [ 59,  53,  46],
        [ 70,  60,  50]],

       [[119, 100,  98],
        [149, 138, 128],
        [201, 194, 178],
        ...,
        [ 27,  26,  20],
        [ 52,  46,  35],
        [ 96,  83,  67]],

       ...,

       [[  5,  24,  30],
        [  5,  24,  30],
        [  5,  24,  30],
        ...,
        [  2,  12,  21],
        [  2,  12,  21],
        [  1,  11,  19]],

       [[  5,  24,  30],
        [  5,  24,  30],
        [  5,  24,  30],
        ...,
        [  4,  14,  23],
        [  2,  13,  21],
        [  0,  11,  20]],

       [[  4,  22,  29],
        [  5,  23,  29],
        [  5,  23,  30],
        ...,
        [  3,  13,  22],
        [  2,  11,  20],
        [  1,  11,  20]]], dtype=uint8)]"
Image_177.jpg,297,170,204,182,1000,664,501,352,204,daskShared_local/images/Image_177.jpg,177,"[array([[[  0,  78, 145],
        [  1,  78, 146],
        [  0,  79, 148],
        ...,
        [  0,  97, 145],
        [  1,  96, 144],
        [  2,  99, 150]],

       [[  0,  76, 144],
        [  0,  79, 145],
        [  1,  80, 146],
        ...,
        [  0,  94, 140],
        [  0,  96, 146],
        [  0,  97, 142]],

       [[  0,  79, 146],
        [  0,  79, 145],
        [  1,  79, 145],
        ...,
        [  0,  90, 139],
        [  1,  93, 143],
        [  0,  93, 141]],

       ...,

       [[ 64,  75,  58],
        [ 56,  62,  42],
        [ 38,  40,  35],
        ...,
        [186, 183, 166],
        [206, 208, 187],
        [214, 214, 201]],

       [[ 62,  62,  52],
        [ 49,  49,  41],
        [ 35,  36,  40],
        ...,
        [208, 205, 190],
        [220, 220, 209],
        [205, 199, 185]],

       [[ 47,  47,  39],
        [ 43,  39,  36],
        [ 36,  37,  39],
        ...,
        [192, 183, 169],
        [195, 186, 170],
        [202, 179, 149]]], dtype=uint8)]"
Image_1770.jpg,66,138,121,105,525,340,187,243,121,daskShared_local/images/Image_1770.jpg,1770,"[array([[[ 34,  83,  95],
        [ 36,  85,  97],
        [ 41,  89, 102],
        ...,
        [194, 209, 172],
        [144, 155, 117],
        [124, 134,  95]],

       [[ 34,  83,  96],
        [ 36,  85,  98],
        [ 40,  89, 102],
        ...,
        [194, 209, 172],
        [151, 163, 124],
        [134, 145, 105]],

       [[ 33,  85,  98],
        [ 35,  86, 100],
        [ 39,  88, 103],
        ...,
        [195, 210, 171],
        [171, 184, 143],
        [162, 173, 132]],

       ...,

       [[  8,  19,  13],
        [ 14,  25,  18],
        [ 29,  39,  31],
        ...,
        [  2,  18,   2],
        [ 65,  82,  64],
        [ 90, 106,  89]],

       [[ 22,  26,  21],
        [ 26,  30,  24],
        [ 35,  39,  33],
        ...,
        [  1,  12,   1],
        [ 50,  64,  49],
        [ 69,  85,  68]],

       [[ 28,  29,  25],
        [ 31,  32,  28],
        [ 38,  40,  35],
        ...,
        [  1,  11,   1],
        [ 44,  58,  43],
        [ 60,  76,  60]]], dtype=uint8)]"
Image_1771.jpg,548,185,110,71,1000,700,658,256,110,daskShared_local/images/Image_1771.jpg,1771,"[array([[[  3, 157, 229],
        [  3, 157, 229],
        [  3, 157, 229],
        ...,
        [  0, 158, 228],
        [  0, 159, 227],
        [  0, 159, 227]],

       [[  3, 157, 229],
        [  3, 157, 229],
        [  3, 157, 229],
        ...,
        [  0, 158, 228],
        [  0, 159, 227],
        [  0, 159, 227]],

       [[  2, 156, 228],
        [  2, 156, 228],
        [  2, 156, 228],
        ...,
        [  0, 159, 227],
        [  0, 159, 226],
        [  0, 159, 226]],

       ...,

       [[ 83, 120, 132],
        [ 88, 125, 137],
        [115, 150, 162],
        ...,
        [  0, 148, 220],
        [  0, 148, 220],
        [  0, 148, 220]],

       [[102, 140, 150],
        [102, 140, 150],
        [103, 142, 151],
        ...,
        [  0, 147, 219],
        [  0, 148, 220],
        [  0, 148, 220]],

       [[106, 144, 153],
        [105, 144, 152],
        [100, 141, 149],
        ...,
        [  0, 147, 219],
        [  0, 148, 220],
        [  0, 148, 220]]], dtype=uint8)]"
Image_1772.jpg,396,61,1082,940,1920,1080,1478,1001,1082,daskShared_local/images/Image_1772.jpg,1772,"[array([[[  0, 125, 156],
        [  0, 124, 156],
        [  0, 123, 155],
        ...,
        [ 43, 111,  99],
        [ 12,  77,  77],
        [ 13,  92,  88]],

       [[  0, 125, 157],
        [  0, 125, 157],
        [  0, 124, 155],
        ...,
        [ 22, 119, 113],
        [  2,  85,  91],
        [  2,  69,  77]],

       [[  0, 125, 157],
        [  0, 125, 157],
        [  0, 124, 155],
        ...,
        [ 25, 120, 111],
        [  3,  84,  90],
        [  2,  69,  76]],

       ...,

       [[106, 100,  64],
        [102,  94,  57],
        [109,  99,  58],
        ...,
        [ 15,  21,  21],
        [ 16,  20,  21],
        [ 19,  22,  21]],

       [[ 87,  82,  46],
        [104,  95,  56],
        [133, 121,  76],
        ...,
        [ 20,  23,  18],
        [ 28,  28,  20],
        [ 36,  35,  24]],

       [[ 94,  88,  53],
        [124, 114,  74],
        [122, 111,  67],
        ...,
        [ 34,  33,  21],
        [ 40,  37,  24],
        [ 47,  44,  27]]], dtype=uint8)]"
Image_1773.jpg,284,92,184,164,732,420,468,256,184,daskShared_local/images/Image_1773.jpg,1773,"[array([[[  0, 161, 213],
        [  0, 161, 213],
        [  0, 161, 213],
        ...,
        [  0, 182, 215],
        [  0, 186, 216],
        [  0, 190, 220]],

       [[  0, 161, 213],
        [  0, 161, 213],
        [  0, 161, 213],
        ...,
        [  7, 180, 214],
        [  0, 179, 210],
        [  0, 183, 213]],

       [[  0, 160, 212],
        [  0, 160, 212],
        [  0, 160, 212],
        ...,
        [ 32, 186, 221],
        [ 18, 181, 215],
        [  6, 180, 212]],

       ...,

       [[179, 181, 123],
        [186, 189, 130],
        [190, 191, 132],
        ...,
        [138, 143,  69],
        [165, 167,  88],
        [154, 154,  71]],

       [[180, 181, 113],
        [182, 181, 116],
        [186, 184, 123],
        ...,
        [117, 112,  60],
        [144, 132,  69],
        [157, 139,  57]],

       [[172, 172, 100],
        [179, 177, 107],
        [183, 178, 113],
        ...,
        [ 92,  87,  38],
        [110,  97,  39],
        [125, 105,  32]]], dtype=uint8)]"
Image_1774.jpg,444,382,205,201,1024,683,649,583,205,daskShared_local/images/Image_1774.jpg,1774,"[array([[[ 87,  78,  83],
        [ 59,  50,  53],
        [131, 126, 122],
        ...,
        [ 81,  68,  60],
        [102,  89,  81],
        [121,  95,  82]],

       [[163, 152, 156],
        [160, 151, 152],
        [ 64,  56,  53],
        ...,
        [ 88,  75,  66],
        [112, 100,  88],
        [119,  99,  88]],

       [[ 93,  82,  77],
        [107,  96,  94],
        [ 68,  58,  56],
        ...,
        [ 96,  82,  71],
        [147, 133, 120],
        [139, 127, 119]],

       ...,

       [[180, 162,  90],
        [210, 182, 144],
        [196, 161, 139],
        ...,
        [244, 226, 194],
        [253, 243, 212],
        [254, 234, 197]],

       [[216, 192, 111],
        [248, 206, 160],
        [193, 138, 111],
        ...,
        [245, 246, 224],
        [237, 243, 225],
        [241, 218, 170]],

       [[163, 145,  89],
        [192, 146, 106],
        [187, 136,  99],
        ...,
        [237, 218, 182],
        [254, 235, 193],
        [240, 226, 181]]], dtype=uint8)]"
Image_1775.jpg,553,98,282,264,1024,770,835,362,282,daskShared_local/images/Image_1775.jpg,1775,"[array([[[  3, 114, 186],
        [  3, 114, 186],
        [  3, 114, 186],
        ...,
        [ 36,  36,  41],
        [ 32,  37,  42],
        [ 41,  46,  51]],

       [[  2, 113, 185],
        [  2, 113, 185],
        [  2, 113, 185],
        ...,
        [ 33,  35,  41],
        [ 32,  40,  46],
        [ 46,  54,  60]],

       [[  2, 113, 185],
        [  1, 112, 184],
        [  1, 112, 184],
        ...,
        [ 35,  38,  47],
        [ 32,  43,  49],
        [ 54,  65,  73]],

       ...,

       [[ 83, 109, 102],
        [ 64,  98,  85],
        [ 77, 118, 100],
        ...,
        [ 34,  34,  34],
        [ 33,  31,  32],
        [ 34,  32,  33]],

       [[ 57,  92,  77],
        [ 50,  91,  72],
        [ 99, 144, 120],
        ...,
        [ 35,  31,  34],
        [ 32,  32,  32],
        [ 32,  32,  32]],

       [[ 48,  82,  66],
        [ 47,  86,  67],
        [119, 162, 140],
        ...,
        [ 32,  30,  33],
        [ 33,  33,  33],
        [ 33,  33,  33]]], dtype=uint8)]"
Image_1776.jpg,2228,275,613,492,3033,1757,2841,767,613,daskShared_local/images/Image_1776.jpg,1776,"[array([[[  0,  53, 217],
        [  0,  53, 217],
        [  0,  53, 217],
        ...,
        [  0,  53, 217],
        [  0,  53, 217],
        [  0,  53, 217]],

       [[  0,  53, 217],
        [  0,  53, 217],
        [  0,  53, 217],
        ...,
        [  0,  53, 217],
        [  0,  53, 217],
        [  0,  53, 217]],

       [[  0,  53, 217],
        [  0,  53, 217],
        [  0,  53, 217],
        ...,
        [  0,  53, 217],
        [  0,  53, 217],
        [  0,  53, 217]],

       ...,

       [[100, 108,  59],
        [ 92,  99,  54],
        [ 74,  81,  43],
        ...,
        [  0,  53, 217],
        [  0,  53, 217],
        [  0,  53, 217]],

       [[102, 110,  62],
        [ 99, 107,  59],
        [ 83,  90,  48],
        ...,
        [  0,  53, 217],
        [  0,  53, 217],
        [  0,  53, 217]],

       [[ 95, 102,  59],
        [101, 108,  63],
        [ 92,  99,  57],
        ...,
        [  0,  53, 217],
        [  0,  53, 217],
        [  0,  53, 217]]], dtype=uint8)]"
Image_1777.jpg,515,372,184,163,1024,678,699,535,184,daskShared_local/images/Image_1777.jpg,1777,"[array([[[105,  90, 100],
        [112, 102, 111],
        [111, 101, 107],
        ...,
        [155, 128,  90],
        [150, 125,  93],
        [156, 122,  85]],

       [[106, 103, 108],
        [119, 120, 114],
        [175, 172, 159],
        ...,
        [138, 106,  72],
        [145, 112,  77],
        [156, 119,  82]],

       [[125, 127, 135],
        [108, 110, 112],
        [129, 123, 124],
        ...,
        [155, 127, 103],
        [174, 139, 109],
        [185, 145, 109]],

       ...,

       [[237, 222, 179],
        [240, 225, 184],
        [248, 228, 183],
        ...,
        [236, 220, 172],
        [248, 224, 173],
        [243, 216, 167]],

       [[236, 223, 179],
        [242, 230, 191],
        [247, 230, 191],
        ...,
        [239, 224, 175],
        [252, 236, 185],
        [252, 234, 185]],

       [[240, 237, 202],
        [242, 244, 212],
        [246, 242, 210],
        ...,
        [243, 222, 174],
        [247, 227, 176],
        [243, 222, 172]]], dtype=uint8)]"
Image_1778.jpg,474,124,109,78,685,360,583,202,109,daskShared_local/images/Image_1778.jpg,1778,"[array([[[  1, 107, 149],
        [  1, 107, 149],
        [  0, 107, 148],
        ...,
        [  0, 101, 145],
        [  0, 101, 145],
        [  0, 101, 145]],

       [[  1, 107, 149],
        [  0, 107, 149],
        [  0, 107, 149],
        ...,
        [  0, 101, 145],
        [  0, 101, 145],
        [  0, 101, 145]],

       [[  0, 107, 148],
        [  0, 108, 149],
        [  0, 108, 150],
        ...,
        [  0, 101, 145],
        [  0, 101, 145],
        [  0, 101, 145]],

       ...,

       [[  3,  87, 123],
        [  3,  87, 123],
        [  4,  88, 124],
        ...,
        [  0,  82, 114],
        [  0,  82, 114],
        [  0,  82, 114]],

       [[  2,  86, 122],
        [  2,  86, 122],
        [  3,  87, 123],
        ...,
        [  0,  82, 114],
        [  0,  82, 114],
        [  0,  82, 114]],

       [[  2,  86, 122],
        [  2,  86, 122],
        [  2,  86, 122],
        ...,
        [  0,  82, 114],
        [  0,  82, 114],
        [  0,  82, 114]]], dtype=uint8)]"
Image_1779.jpg,330,266,125,133,1000,667,455,399,133,daskShared_local/images/Image_1779.jpg,1779,"[array([[[  1, 210, 228],
        [  1, 210, 228],
        [  2, 209, 229],
        ...,
        [ 56, 213, 233],
        [ 65, 214, 233],
        [ 74, 214, 233]],

       [[  3, 210, 229],
        [  4, 210, 229],
        [  5, 209, 229],
        ...,
        [ 57, 213, 232],
        [ 64, 213, 232],
        [ 71, 214, 232]],

       [[  7, 210, 229],
        [  7, 210, 229],
        [  9, 209, 228],
        ...,
        [ 62, 213, 231],
        [ 64, 212, 231],
        [ 68, 212, 230]],

       ...,

       [[128,  78,   2],
        [120,  74,   1],
        [108,  66,   0],
        ...,
        [ 23,  70, 123],
        [ 10,  62, 117],
        [  3,  58, 116]],

       [[145,  89,   2],
        [135,  83,   1],
        [119,  73,   1],
        ...,
        [ 35,  63, 111],
        [ 31,  63, 112],
        [ 26,  64, 115]],

       [[155,  94,   3],
        [143,  87,   2],
        [126,  76,   1],
        ...,
        [ 43,  60, 107],
        [ 45,  67, 113],
        [ 42,  72, 119]]], dtype=uint8)]"
Image_178.jpg,408,141,200,183,869,574,608,324,200,daskShared_local/images/Image_178.jpg,178,"[array([[[  0, 140, 207],
        [  1, 142, 214],
        [  8, 141, 220],
        ...,
        [ 78, 165, 242],
        [ 78, 165, 242],
        [ 78, 165, 242]],

       [[  0, 138, 202],
        [  3, 142, 211],
        [  5, 142, 212],
        ...,
        [ 77, 164, 241],
        [ 75, 165, 241],
        [ 74, 164, 240]],

       [[  2, 142, 204],
        [  6, 145, 210],
        [  1, 145, 208],
        ...,
        [ 76, 163, 240],
        [ 73, 163, 239],
        [ 73, 163, 239]],

       ...,

       [[  6,  64,  40],
        [  4,  58,  35],
        [  4,  53,  32],
        ...,
        [  0, 110, 181],
        [  0, 110, 181],
        [  0, 110, 181]],

       [[ 20,  82,  57],
        [ 13,  71,  47],
        [ 10,  64,  41],
        ...,
        [  0, 110, 181],
        [  0, 110, 181],
        [  0, 110, 181]],

       [[ 21,  81,  56],
        [ 18,  76,  52],
        [ 11,  69,  45],
        ...,
        [  0, 110, 181],
        [  0, 110, 181],
        [  0, 110, 181]]], dtype=uint8)]"
Image_1780.jpg,577,55,173,163,930,500,750,218,173,daskShared_local/images/Image_1780.jpg,1780,"[array([[[ 12, 150, 212],
        [ 10, 148, 210],
        [  8, 146, 208],
        ...,
        [  9, 145, 203],
        [ 10, 146, 204],
        [ 10, 146, 204]],

       [[ 11, 149, 211],
        [ 10, 148, 210],
        [  9, 147, 209],
        ...,
        [ 10, 146, 204],
        [ 10, 146, 204],
        [ 10, 146, 204]],

       [[ 10, 148, 211],
        [ 11, 149, 211],
        [ 10, 148, 211],
        ...,
        [ 10, 146, 204],
        [ 10, 146, 204],
        [ 10, 146, 204]],

       ...,

       [[238, 237, 235],
        [245, 244, 242],
        [249, 249, 247],
        ...,
        [  6, 134, 199],
        [  6, 134, 199],
        [  6, 134, 199]],

       [[237, 237, 235],
        [228, 228, 226],
        [225, 225, 223],
        ...,
        [  6, 134, 199],
        [  6, 134, 199],
        [  6, 134, 199]],

       [[221, 221, 219],
        [192, 192, 190],
        [175, 175, 173],
        ...,
        [  6, 134, 199],
        [  7, 135, 200],
        [  7, 135, 200]]], dtype=uint8)]"
Image_1781.jpg,1278,648,332,238,2106,1578,1610,886,332,daskShared_local/images/Image_1781.jpg,1781,"[array([[[ 25, 146, 146],
        [ 27, 150, 150],
        [ 27, 146, 147],
        ...,
        [ 27, 144, 150],
        [ 27, 142, 148],
        [ 19, 146, 149]],

       [[ 20, 140, 145],
        [ 20, 142, 145],
        [ 29, 151, 154],
        ...,
        [ 21, 146, 148],
        [ 17, 142, 144],
        [ 19, 143, 143]],

       [[ 26, 145, 144],
        [ 28, 145, 145],
        [ 27, 147, 146],
        ...,
        [ 17, 146, 148],
        [ 13, 145, 148],
        [ 20, 143, 140]],

       ...,

       [[ 37, 156, 149],
        [ 39, 157, 154],
        [ 34, 156, 152],
        ...,
        [ 31, 162, 157],
        [ 34, 163, 159],
        [ 29, 165, 164]],

       [[ 35, 154, 148],
        [ 36, 157, 150],
        [ 35, 157, 152],
        ...,
        [ 32, 163, 158],
        [ 32, 163, 158],
        [ 30, 166, 160]],

       [[ 39, 156, 150],
        [ 39, 155, 150],
        [ 40, 159, 153],
        ...,
        [ 33, 161, 157],
        [ 35, 160, 157],
        [ 30, 163, 157]]], dtype=uint8)]"
Image_1782.jpg,972,270,191,144,1600,1280,1163,414,191,daskShared_local/images/Image_1782.jpg,1782,"[array([[[ 21, 152, 121],
        [ 14, 155, 129],
        [ 19, 153, 131],
        ...,
        [ 28, 161, 130],
        [ 23, 152, 122],
        [ 26, 149, 121]],

       [[ 25, 160, 127],
        [ 25, 169, 134],
        [ 33, 167, 142],
        ...,
        [ 28, 162, 130],
        [ 24, 153, 125],
        [ 25, 147, 122]],

       [[ 19, 158, 122],
        [ 18, 162, 122],
        [ 28, 163, 135],
        ...,
        [ 27, 160, 129],
        [ 26, 155, 127],
        [ 27, 149, 124]],

       ...,

       [[105,  95,  18],
        [112, 105,  53],
        [ 76,  45,  25],
        ...,
        [ 35, 155, 138],
        [ 42, 158, 136],
        [ 36, 149, 119]],

       [[ 97,  77,  10],
        [109,  93,  51],
        [ 85,  50,  32],
        ...,
        [ 36, 153, 134],
        [ 39, 151, 128],
        [ 29, 138, 107]],

       [[102,  75,  21],
        [115,  88,  60],
        [ 97,  56,  43],
        ...,
        [ 39, 151, 131],
        [ 37, 144, 120],
        [ 27, 132, 101]]], dtype=uint8)]"
Image_1783.jpg,381,185,474,310,1280,854,855,495,474,daskShared_local/images/Image_1783.jpg,1783,"[array([[[125, 144, 171],
        [118, 142, 172],
        [115, 141, 169],
        ...,
        [ 20, 210, 246],
        [ 20, 210, 246],
        [ 19, 209, 245]],

       [[120, 142, 169],
        [116, 140, 169],
        [116, 140, 169],
        ...,
        [ 20, 210, 246],
        [ 20, 210, 246],
        [ 19, 209, 245]],

       [[116, 143, 168],
        [115, 139, 169],
        [116, 139, 169],
        ...,
        [ 20, 210, 246],
        [ 20, 210, 246],
        [ 19, 209, 245]],

       ...,

       [[131, 205, 230],
        [130, 203, 230],
        [128, 203, 230],
        ...,
        [  8, 101, 160],
        [  9, 105, 163],
        [  8, 105, 164]],

       [[128, 199, 225],
        [129, 201, 228],
        [122, 199, 225],
        ...,
        [  7, 104, 162],
        [  9, 108, 167],
        [  8, 109, 168]],

       [[126, 195, 223],
        [128, 201, 227],
        [116, 193, 218],
        ...,
        [  7, 107, 166],
        [  9, 111, 171],
        [  8, 114, 172]]], dtype=uint8)]"
Image_1784.jpg,61,125,188,172,600,350,249,297,188,daskShared_local/images/Image_1784.jpg,1784,"[array([[[ 25,  50,  31],
        [ 23,  51,  29],
        [ 23,  51,  29],
        ...,
        [ 64,  67,  71],
        [ 78,  82,  83],
        [ 89,  93,  94]],

       [[ 25,  50,  31],
        [ 25,  50,  31],
        [ 24,  49,  30],
        ...,
        [ 65,  66,  69],
        [ 77,  80,  77],
        [ 94,  95,  99]],

       [[ 25,  50,  31],
        [ 25,  48,  30],
        [ 25,  48,  30],
        ...,
        [ 62,  60,  63],
        [ 67,  66,  62],
        [ 72,  74,  73]],

       ...,

       [[151, 136, 114],
        [152, 140, 115],
        [162, 154, 128],
        ...,
        [149, 131, 105],
        [149, 126,  98],
        [138, 114,  90]],

       [[150, 136, 109],
        [152, 138, 111],
        [144, 133, 104],
        ...,
        [148, 120,  97],
        [155, 121,  94],
        [144, 109,  84]],

       [[147, 130, 102],
        [147, 127,  96],
        [151, 129,  97],
        ...,
        [148, 118,  82],
        [149, 115,  78],
        [143, 113,  79]]], dtype=uint8)]"
Image_1785.jpg,130,93,150,114,500,333,280,207,150,daskShared_local/images/Image_1785.jpg,1785,"[array([[[ 27,  42,  61],
        [ 27,  42,  61],
        [ 27,  42,  61],
        ...,
        [ 24,  42,  64],
        [ 24,  42,  64],
        [ 24,  42,  64]],

       [[ 27,  42,  61],
        [ 27,  42,  61],
        [ 27,  42,  61],
        ...,
        [ 24,  42,  64],
        [ 24,  42,  64],
        [ 24,  42,  64]],

       [[ 27,  42,  61],
        [ 27,  42,  61],
        [ 27,  42,  61],
        ...,
        [ 24,  42,  64],
        [ 24,  42,  64],
        [ 24,  42,  64]],

       ...,

       [[ 24,  43,  58],
        [ 23,  42,  57],
        [ 23,  42,  57],
        ...,
        [113, 130, 122],
        [112, 129, 121],
        [111, 128, 120]],

       [[ 24,  42,  57],
        [ 23,  42,  57],
        [ 23,  42,  57],
        ...,
        [114, 130, 123],
        [113, 130, 122],
        [113, 129, 121]],

       [[ 23,  41,  55],
        [ 24,  42,  56],
        [ 24,  42,  56],
        ...,
        [115, 130, 123],
        [114, 130, 123],
        [114, 129, 122]]], dtype=uint8)]"
Image_1786.jpg,400,177,88,82,800,600,488,259,88,daskShared_local/images/Image_1786.jpg,1786,"[array([[[104, 102, 114],
        [103, 102, 113],
        [105, 102, 115],
        ...,
        [ 64, 114, 153],
        [ 64, 115, 153],
        [ 64, 115, 153]],

       [[104, 102, 111],
        [104, 102, 111],
        [106, 103, 113],
        ...,
        [ 63, 114, 153],
        [ 63, 115, 153],
        [ 63, 115, 153]],

       [[102, 102, 120],
        [102, 102, 120],
        [102, 101, 121],
        ...,
        [ 67, 114, 152],
        [ 68, 115, 152],
        [ 68, 115, 152]],

       ...,

       [[119, 117, 162],
        [117, 115, 159],
        [124, 123, 170],
        ...,
        [ 17, 133, 239],
        [ 17, 134, 237],
        [ 17, 134, 237]],

       [[120, 118, 164],
        [118, 115, 161],
        [128, 126, 174],
        ...,
        [ 18, 134, 236],
        [ 18, 135, 233],
        [ 18, 135, 234]],

       [[120, 118, 164],
        [118, 115, 160],
        [127, 126, 173],
        ...,
        [ 18, 134, 237],
        [ 18, 135, 234],
        [ 18, 134, 235]]], dtype=uint8)]"
Image_1787.jpg,872,518,229,210,1920,1200,1101,728,229,daskShared_local/images/Image_1787.jpg,1787,"[array([[[  0, 115, 115],
        [  0, 115, 115],
        [  0, 112, 114],
        ...,
        [  1, 124, 123],
        [  0, 124, 122],
        [  0, 124, 121]],

       [[  0, 115, 115],
        [  1, 115, 116],
        [  2, 114, 116],
        ...,
        [  2, 125, 124],
        [  0, 124, 122],
        [  0, 123, 121]],

       [[  1, 116, 116],
        [  2, 116, 116],
        [  3, 116, 116],
        ...,
        [  1, 124, 122],
        [  1, 125, 122],
        [  0, 124, 121]],

       ...,

       [[101,  89,  47],
        [117, 108,  67],
        [115, 107,  69],
        ...,
        [ 65,  50,  33],
        [ 41,  28,  12],
        [ 47,  33,  20]],

       [[100,  89,  53],
        [113, 103,  67],
        [104,  95,  62],
        ...,
        [ 75,  56,  43],
        [ 57,  41,  29],
        [ 44,  31,  21]],

       [[104,  94,  59],
        [108,  98,  64],
        [110,  99,  68],
        ...,
        [110,  89,  77],
        [ 77,  59,  48],
        [ 40,  25,  16]]], dtype=uint8)]"
Image_1788.jpg,166,11,102,103,498,272,268,114,103,daskShared_local/images/Image_1788.jpg,1788,"[array([[[  0,  33,  69],
        [  0,  33,  69],
        [  0,  34,  69],
        ...,
        [  2,  30,  51],
        [  2,  30,  51],
        [  2,  30,  51]],

       [[  0,  33,  68],
        [  0,  33,  68],
        [  0,  34,  69],
        ...,
        [  2,  29,  51],
        [  2,  29,  51],
        [  2,  29,  51]],

       [[  0,  32,  67],
        [  0,  32,  67],
        [  0,  33,  67],
        ...,
        [  1,  28,  50],
        [  1,  28,  50],
        [  1,  28,  50]],

       ...,

       [[109, 112, 110],
        [110, 112, 110],
        [112, 113, 113],
        ...,
        [195, 199, 205],
        [198, 204, 211],
        [199, 204, 212]],

       [[107, 111, 106],
        [107, 111, 107],
        [112, 116, 112],
        ...,
        [176, 180, 183],
        [176, 180, 183],
        [176, 180, 184]],

       [[106, 111, 106],
        [107, 111, 106],
        [112, 116, 112],
        ...,
        [175, 179, 181],
        [174, 178, 181],
        [174, 178, 181]]], dtype=uint8)]"
Image_1789.JPG,472,415,527,309,1600,1467,999,724,527,daskShared_local/images/Image_1789.JPG,1789,"[array([[[ 69,  85,  83],
        [ 64,  80,  81],
        [ 63,  79,  78],
        ...,
        [104, 111,  89],
        [105, 111,  91],
        [100, 108,  91]],

       [[ 75,  87,  82],
        [ 66,  81,  81],
        [ 62,  80,  79],
        ...,
        [114, 117, 100],
        [ 99, 101,  86],
        [ 98, 103,  91]],

       [[ 71,  85,  85],
        [ 64,  81,  84],
        [ 64,  84,  85],
        ...,
        [107, 109,  92],
        [ 94,  98,  85],
        [ 98, 103,  92]],

       ...,

       [[170, 165, 122],
        [180, 179, 138],
        [206, 206, 149],
        ...,
        [154, 158, 140],
        [137, 140, 122],
        [126, 130, 113]],

       [[204, 200, 151],
        [211, 207, 154],
        [215, 214, 151],
        ...,
        [132, 134, 120],
        [130, 132, 117],
        [119, 120, 106]],

       [[205, 201, 156],
        [213, 207, 152],
        [214, 213, 144],
        ...,
        [133, 134, 121],
        [128, 128, 115],
        [126, 125, 111]]], dtype=uint8)]"
Image_179.jpg,696,675,350,221,2793,2090,1046,896,350,daskShared_local/images/Image_179.jpg,179,"[array([[[  3,  67, 190],
        [  3,  67, 190],
        [  3,  67, 190],
        ...,
        [  3,  68, 186],
        [  3,  68, 186],
        [  3,  68, 186]],

       [[  3,  67, 190],
        [  3,  67, 190],
        [  3,  67, 190],
        ...,
        [  3,  68, 186],
        [  3,  68, 186],
        [  3,  68, 186]],

       [[  3,  67, 190],
        [  3,  67, 190],
        [  3,  67, 190],
        ...,
        [  3,  68, 186],
        [  3,  68, 186],
        [  3,  68, 186]],

       ...,

       [[  5,  52, 156],
        [  5,  52, 156],
        [  5,  52, 156],
        ...,
        [ 55,  58,  40],
        [ 57,  60,  39],
        [ 76,  80,  56]],

       [[  5,  52, 156],
        [  5,  52, 156],
        [  5,  52, 156],
        ...,
        [ 67,  70,  55],
        [ 58,  61,  41],
        [ 67,  71,  47]],

       [[  5,  52, 156],
        [  5,  52, 156],
        [  5,  52, 156],
        ...,
        [ 66,  76,  58],
        [ 56,  65,  43],
        [ 58,  66,  42]]], dtype=uint8)]"
Image_1790.jpg,673,294,290,314,1600,900,963,608,314,daskShared_local/images/Image_1790.jpg,1790,"[array([[[  0, 116, 199],
        [  0, 116, 199],
        [  0, 116, 199],
        ...,
        [  1, 117, 202],
        [  1, 117, 202],
        [  1, 117, 202]],

       [[  0, 116, 199],
        [  0, 116, 199],
        [  0, 116, 199],
        ...,
        [  1, 117, 202],
        [  1, 117, 202],
        [  1, 117, 202]],

       [[  0, 116, 199],
        [  0, 116, 199],
        [  0, 116, 199],
        ...,
        [  1, 117, 201],
        [  1, 117, 201],
        [  1, 117, 201]],

       ...,

       [[151, 142, 102],
        [155, 147, 109],
        [155, 147, 111],
        ...,
        [194, 192, 158],
        [182, 184, 150],
        [107, 112,  78]],

       [[186, 178, 141],
        [184, 176, 140],
        [177, 169, 134],
        ...,
        [114, 116,  90],
        [130, 136, 113],
        [ 84,  94,  71]],

       [[210, 202, 168],
        [213, 204, 171],
        [190, 181, 148],
        ...,
        [ 69,  74,  55],
        [ 95, 103,  89],
        [116, 128, 116]]], dtype=uint8)]"
Image_1791.jpg,75,74,89,82,300,260,164,156,89,daskShared_local/images/Image_1791.jpg,1791,"[array([[[  2, 229, 253],
        [  2, 229, 253],
        [  1, 229, 253],
        ...,
        [ 20, 200, 229],
        [ 31, 200, 230],
        [ 29, 200, 230]],

       [[  2, 229, 253],
        [  2, 229, 253],
        [  1, 229, 252],
        ...,
        [ 13, 198, 231],
        [ 21, 196, 230],
        [ 19, 197, 230]],

       [[  2, 228, 253],
        [  2, 228, 253],
        [  2, 228, 253],
        ...,
        [ 43, 207, 225],
        [ 68, 211, 232],
        [ 62, 210, 230]],

       ...,

       [[  1, 187, 239],
        [  1, 187, 239],
        [  1, 187, 238],
        ...,
        [  6,  39,  27],
        [  5,  43,  29],
        [  6,  42,  28]],

       [[  1, 186, 239],
        [  1, 186, 239],
        [  1, 187, 239],
        ...,
        [  7,  22,  19],
        [  7,  26,  23],
        [  7,  26,  22]],

       [[  1, 186, 239],
        [  1, 186, 239],
        [  1, 187, 239],
        ...,
        [  7,  26,  21],
        [  7,  30,  25],
        [  7,  29,  24]]], dtype=uint8)]"
Image_1792.jpg,327,277,97,64,800,600,424,341,97,daskShared_local/images/Image_1792.jpg,1792,"[array([[[  1, 159, 255],
        [  1, 159, 255],
        [  0, 159, 254],
        ...,
        [  1, 164, 255],
        [  1, 164, 255],
        [  1, 164, 255]],

       [[  1, 159, 255],
        [  1, 159, 255],
        [  0, 159, 254],
        ...,
        [  1, 164, 255],
        [  1, 164, 255],
        [  1, 164, 255]],

       [[  0, 159, 255],
        [  0, 159, 255],
        [  1, 159, 254],
        ...,
        [  1, 164, 255],
        [  0, 163, 254],
        [  0, 163, 254]],

       ...,

       [[ 80, 129,  91],
        [ 80, 129,  91],
        [ 92, 139, 101],
        ...,
        [ 34,  41,  31],
        [ 35,  43,  32],
        [ 35,  43,  32]],

       [[ 86, 135,  99],
        [ 86, 134,  99],
        [ 90, 136,  97],
        ...,
        [ 36,  44,  34],
        [ 37,  45,  35],
        [ 37,  45,  35]],

       [[ 86, 134,  98],
        [ 86, 134,  98],
        [ 90, 137,  97],
        ...,
        [ 36,  44,  34],
        [ 37,  45,  35],
        [ 37,  45,  35]]], dtype=uint8)]"
Image_1793.jpg,304,242,268,264,1000,664,572,506,268,daskShared_local/images/Image_1793.jpg,1793,"[array([[[198, 199, 201],
        [198, 199, 201],
        [198, 199, 201],
        ...,
        [189, 136,  87],
        [193, 141,  96],
        [197, 147, 109]],

       [[196, 197, 199],
        [197, 198, 200],
        [198, 199, 201],
        ...,
        [187, 135,  88],
        [194, 143, 101],
        [203, 153, 115]],

       [[196, 197, 199],
        [196, 197, 199],
        [197, 198, 200],
        ...,
        [185, 134,  89],
        [193, 145, 104],
        [204, 156, 120]],

       ...,

       [[177, 142, 110],
        [168, 130,  96],
        [155, 114,  76],
        ...,
        [126, 100,  67],
        [128, 102,  69],
        [131, 105,  72]],

       [[172, 140, 110],
        [168, 132,  99],
        [159, 119,  81],
        ...,
        [132, 107,  74],
        [134, 109,  77],
        [134, 110,  77]],

       [[168, 138, 108],
        [167, 134, 101],
        [160, 122,  85],
        ...,
        [127, 104,  73],
        [130, 106,  75],
        [128, 105,  74]]], dtype=uint8)]"
Image_1794.jpg,322,157,166,175,1200,735,488,332,175,daskShared_local/images/Image_1794.jpg,1794,"[array([[[106, 182, 196],
        [103, 179, 193],
        [ 94, 178, 189],
        ...,
        [ 18,  58,  84],
        [ 16,  57,  82],
        [  9,  51,  75]],

       [[103, 179, 193],
        [101, 177, 191],
        [ 94, 179, 190],
        ...,
        [ 17,  60,  83],
        [ 18,  63,  84],
        [ 11,  58,  79]],

       [[101, 177, 191],
        [ 98, 174, 188],
        [ 94, 180, 191],
        ...,
        [ 12,  57,  77],
        [ 14,  61,  80],
        [  6,  57,  73]],

       ...,

       [[144, 186, 177],
        [144, 186, 176],
        [143, 179, 180],
        ...,
        [ 47,  13,   2],
        [ 40,   4,   1],
        [ 58,  20,   4]],

       [[139, 182, 166],
        [140, 182, 167],
        [142, 178, 176],
        ...,
        [ 31,   6,   1],
        [ 44,  15,   6],
        [ 72,  37,  17]],

       [[134, 179, 160],
        [136, 181, 160],
        [146, 181, 175],
        ...,
        [ 54,  30,   6],
        [ 88,  61,  27],
        [110,  79,  48]]], dtype=uint8)]"
Image_1795.jpg,329,242,886,615,1500,1125,1215,857,886,daskShared_local/images/Image_1795.jpg,1795,"[array([[[ 95, 171, 171],
        [ 95, 171, 168],
        [ 97, 171, 169],
        ...,
        [115, 138, 149],
        [116, 138, 147],
        [118, 139, 148]],

       [[ 94, 171, 168],
        [ 95, 171, 169],
        [ 95, 170, 172],
        ...,
        [117, 137, 147],
        [116, 138, 148],
        [120, 139, 150]],

       [[ 96, 169, 167],
        [ 96, 169, 169],
        [ 95, 170, 171],
        ...,
        [117, 135, 147],
        [119, 139, 150],
        [125, 144, 152]],

       ...,

       [[ 96, 186, 231],
        [ 98, 184, 229],
        [ 98, 182, 228],
        ...,
        [ 96, 129, 127],
        [102, 131, 130],
        [106, 132, 134]],

       [[ 97, 188, 233],
        [ 98, 185, 232],
        [ 98, 184, 229],
        ...,
        [ 97, 129, 127],
        [103, 131, 129],
        [108, 133, 131]],

       [[ 98, 191, 236],
        [ 98, 188, 234],
        [ 99, 185, 232],
        ...,
        [ 99, 131, 126],
        [105, 131, 127],
        [111, 133, 131]]], dtype=uint8)]"
Image_1796.jpg,189,426,38,36,1024,683,227,462,38,daskShared_local/images/Image_1796.jpg,1796,"[array([[[ 95,  84,  51],
        [ 94,  83,  50],
        [ 94,  83,  49],
        ...,
        [  5, 183, 195],
        [  4, 182, 194],
        [  4, 182, 194]],

       [[ 96,  85,  53],
        [ 96,  84,  52],
        [ 95,  84,  51],
        ...,
        [  5, 183, 195],
        [  5, 183, 195],
        [  5, 183, 195]],

       [[ 98,  86,  56],
        [ 97,  85,  54],
        [ 96,  85,  53],
        ...,
        [  6, 184, 196],
        [  6, 184, 196],
        [  6, 184, 196]],

       ...,

       [[120, 114,  21],
        [123, 116,  26],
        [125, 118,  30],
        ...,
        [ 59,  84,  26],
        [ 63,  88,  27],
        [ 67,  91,  28]],

       [[118, 113,  21],
        [120, 114,  25],
        [121, 116,  29],
        ...,
        [ 55,  81,  26],
        [ 58,  84,  27],
        [ 61,  87,  27]],

       [[116, 112,  22],
        [117, 112,  24],
        [117, 113,  27],
        ...,
        [ 50,  78,  26],
        [ 53,  80,  26],
        [ 55,  83,  26]]], dtype=uint8)]"
Image_1797.jpg,387,109,174,167,800,600,561,276,174,daskShared_local/images/Image_1797.jpg,1797,"[array([[[248, 250, 213],
        [248, 249, 215],
        [247, 250, 215],
        ...,
        [ 50, 119,  96],
        [ 49, 118,  97],
        [ 49, 123,  99]],

       [[251, 253, 215],
        [250, 253, 218],
        [249, 254, 219],
        ...,
        [ 53, 122,  99],
        [ 51, 121, 100],
        [ 44, 117,  96]],

       [[242, 249, 210],
        [236, 243, 208],
        [226, 235, 200],
        ...,
        [ 52, 122, 100],
        [ 51, 122, 101],
        [ 48, 123, 103]],

       ...,

       [[244, 142,  32],
        [242, 140,  32],
        [240, 137,  32],
        ...,
        [111, 137,  92],
        [117, 144,  92],
        [118, 147,  92]],

       [[240, 138,  29],
        [240, 138,  32],
        [239, 136,  34],
        ...,
        [ 98, 128,  81],
        [122, 153, 101],
        [125, 159, 104]],

       [[240, 139,  31],
        [238, 140,  33],
        [239, 138,  35],
        ...,
        [ 99, 132,  85],
        [125, 160, 108],
        [122, 161, 108]]], dtype=uint8)]"
Image_1798.jpg,135,39,135,137,425,282,270,176,137,daskShared_local/images/Image_1798.jpg,1798,"[array([[[  0,  81, 128],
        [  0,  82, 129],
        [  1,  82, 130],
        ...,
        [  0, 122, 169],
        [  0, 121, 168],
        [  0, 120, 167]],

       [[  0,  80, 128],
        [  0,  81, 128],
        [  0,  81, 129],
        ...,
        [  0, 121, 168],
        [  0, 120, 167],
        [  0, 119, 167]],

       [[  0,  78, 127],
        [  0,  79, 127],
        [  0,  80, 128],
        ...,
        [  0, 119, 166],
        [  0, 118, 166],
        [  0, 118, 166]],

       ...,

       [[  9,   3,   1],
        [  7,   4,   2],
        [  5,   6,   4],
        ...,
        [ 31,  91,  93],
        [ 11,  86,  92],
        [  8,  87,  93]],

       [[  6,   3,   1],
        [  5,   4,   1],
        [  4,   6,   3],
        ...,
        [ 19,  86,  91],
        [  2,  80,  87],
        [  1,  78,  87]],

       [[  6,   4,   1],
        [  5,   5,   1],
        [  4,   6,   2],
        ...,
        [ 18,  86,  91],
        [  2,  78,  86],
        [  0,  75,  83]]], dtype=uint8)]"
Image_1799.jpg,334,38,122,74,623,200,456,112,122,daskShared_local/images/Image_1799.jpg,1799,"[array([[[  0, 163, 252],
        [  0, 163, 252],
        [  0, 163, 252],
        ...,
        [  2, 130, 255],
        [  2, 130, 255],
        [  2, 130, 255]],

       [[  0, 163, 252],
        [  0, 163, 252],
        [  0, 163, 252],
        ...,
        [  2, 130, 255],
        [  2, 130, 255],
        [  2, 130, 255]],

       [[  0, 163, 252],
        [  0, 163, 252],
        [  0, 163, 252],
        ...,
        [  2, 130, 255],
        [  2, 130, 255],
        [  2, 130, 255]],

       ...,

       [[ 26,  41,  46],
        [ 25,  39,  45],
        [ 21,  35,  41],
        ...,
        [  6,  99, 238],
        [ 11, 102, 240],
        [ 13, 104, 240]],

       [[ 15,  29,  32],
        [ 15,  29,  31],
        [ 13,  27,  30],
        ...,
        [  5,  99, 239],
        [ 12, 104, 243],
        [ 15, 106, 245]],

       [[ 11,  25,  26],
        [ 10,  24,  26],
        [ 10,  24,  25],
        ...,
        [  4,  98, 240],
        [ 12, 105, 245],
        [ 16, 107, 247]]], dtype=uint8)]"
Image_18.png,238,32,85,85,589,295,323,117,85,daskShared_local/images/Image_18.png,18,"[array([[[  0, 173, 191],
        [  0, 174, 192],
        [  0, 170, 189],
        ...,
        [  0, 173, 196],
        [  0, 171, 194],
        [  0, 172, 195]],

       [[  0, 174, 192],
        [  0, 175, 192],
        [  0, 171, 190],
        ...,
        [  0, 173, 196],
        [  0, 170, 194],
        [  0, 171, 195]],

       [[  0, 171, 189],
        [  0, 172, 190],
        [  0, 169, 188],
        ...,
        [  0, 174, 196],
        [  0, 172, 195],
        [  0, 173, 195]],

       ...,

       [[ 54,  29,  27],
        [ 56,  30,  29],
        [ 51,  26,  23],
        ...,
        [168, 113, 112],
        [215, 141, 134],
        [199, 132, 126]],

       [[ 63,  35,  31],
        [ 65,  37,  32],
        [ 57,  30,  30],
        ...,
        [231, 158, 150],
        [240, 160, 150],
        [237, 159, 150]],

       [[ 60,  33,  30],
        [ 62,  34,  31],
        [ 55,  29,  27],
        ...,
        [210, 143, 138],
        [232, 154, 145],
        [224, 150, 142]]], dtype=uint8)]"
Image_180.jpg,3232,770,828,861,5616,2633,4060,1631,861,daskShared_local/images/Image_180.jpg,180,"[array([[[  0, 197, 244],
        [  0, 196, 244],
        [  0, 196, 244],
        ...,
        [  0, 210, 255],
        [  0, 210, 255],
        [  0, 210, 255]],

       [[  0, 196, 244],
        [  0, 196, 244],
        [  0, 196, 244],
        ...,
        [  0, 209, 255],
        [  1, 209, 255],
        [  0, 209, 255]],

       [[  0, 196, 244],
        [  0, 196, 244],
        [  0, 196, 244],
        ...,
        [  0, 208, 254],
        [  0, 208, 254],
        [  0, 208, 254]],

       ...,

       [[ 46, 155, 167],
        [ 29, 144, 165],
        [ 11, 136, 167],
        ...,
        [221, 174, 163],
        [225, 181, 168],
        [229, 189, 172]],

       [[  1, 120, 152],
        [  1, 120, 159],
        [  1, 123, 166],
        ...,
        [215, 170, 160],
        [225, 186, 176],
        [222, 179, 164]],

       [[  0, 120, 155],
        [  0, 123, 161],
        [  0, 125, 166],
        ...,
        [199, 148, 136],
        [208, 160, 146],
        [205, 159, 142]]], dtype=uint8)]"
Image_1800.jpg,71,181,211,157,600,600,282,338,211,daskShared_local/images/Image_1800.jpg,1800,"[array([[[170, 186, 175],
        [170, 182, 176],
        [164, 177, 172],
        ...,
        [142, 158, 138],
        [157, 170, 141],
        [167, 182, 151]],

       [[159, 175, 165],
        [171, 184, 175],
        [174, 187, 178],
        ...,
        [150, 168, 147],
        [157, 175, 144],
        [164, 183, 151]],

       [[135, 150, 143],
        [154, 168, 157],
        [174, 187, 176],
        ...,
        [154, 172, 151],
        [159, 177, 153],
        [162, 181, 156]],

       ...,

       [[187, 181, 148],
        [191, 178, 137],
        [194, 179, 122],
        ...,
        [129, 112,  74],
        [132, 113,  73],
        [137, 118,  76]],

       [[182, 171, 141],
        [189, 177, 134],
        [194, 180, 123],
        ...,
        [129, 110,  73],
        [137, 118,  78],
        [141, 122,  79]],

       [[176, 165, 133],
        [184, 172, 129],
        [191, 182, 125],
        ...,
        [132, 112,  75],
        [137, 117,  76],
        [141, 124,  80]]], dtype=uint8)]"
Image_1801.jpg,419,351,308,236,1536,1024,727,587,308,daskShared_local/images/Image_1801.jpg,1801,"[array([[[ 11, 133, 244],
        [ 14, 136, 247],
        [ 16, 138, 248],
        ...,
        [ 16, 178, 249],
        [ 15, 176, 249],
        [ 16, 174, 250]],

       [[  8, 130, 241],
        [  8, 130, 241],
        [  9, 131, 241],
        ...,
        [ 18, 182, 247],
        [ 15, 176, 244],
        [ 19, 178, 251]],

       [[ 14, 136, 247],
        [ 14, 136, 247],
        [ 14, 136, 247],
        ...,
        [ 16, 181, 242],
        [ 13, 175, 240],
        [ 16, 176, 243]],

       ...,

       [[ 11,  62, 214],
        [ 14,  66, 214],
        [ 12,  64, 209],
        ...,
        [ 23,  71,  65],
        [ 14,  77,  82],
        [ 12, 113, 111]],

       [[  8,  63, 213],
        [ 11,  65, 213],
        [ 10,  64, 210],
        ...,
        [ 32,  79,  70],
        [ 34, 118, 122],
        [ 15, 124, 123]],

       [[  7,  63, 209],
        [  9,  64, 211],
        [  8,  64, 213],
        ...,
        [ 11,  67,  62],
        [ 16,  86,  86],
        [ 16,  89,  91]]], dtype=uint8)]"
Image_1802.jpg,299,174,224,193,1000,664,523,367,224,daskShared_local/images/Image_1802.jpg,1802,"[array([[[  0,  79, 148],
        [  1,  80, 146],
        [  2,  79, 148],
        ...,
        [  0,  99, 170],
        [  1,  98, 169],
        [  1, 100, 167]],

       [[  1,  80, 146],
        [  1,  80, 146],
        [  1,  80, 146],
        ...,
        [  1,  99, 169],
        [  1,  98, 169],
        [  0,  98, 169]],

       [[  1,  78, 145],
        [  1,  79, 145],
        [  0,  79, 145],
        ...,
        [  0,  99, 168],
        [  0,  99, 168],
        [  0,  99, 167]],

       ...,

       [[ 35,  52,  48],
        [ 43,  53,  43],
        [ 49,  49,  40],
        ...,
        [218, 204, 183],
        [222, 205, 178],
        [216, 196, 156]],

       [[ 37,  65,  59],
        [ 45,  58,  47],
        [ 48,  52,  44],
        ...,
        [228, 220, 193],
        [232, 217, 185],
        [232, 217, 177]],

       [[ 41,  64,  56],
        [ 43,  60,  49],
        [ 42,  50,  43],
        ...,
        [222, 213, 186],
        [231, 218, 183],
        [232, 222, 186]]], dtype=uint8)]"
Image_1803.jpg,609,223,387,429,1600,1070,996,652,429,daskShared_local/images/Image_1803.jpg,1803,"[array([[[ 24,  74, 145],
        [ 26,  73, 145],
        [ 24,  75, 143],
        ...,
        [ 28,  69, 133],
        [ 28,  69, 133],
        [ 28,  69, 133]],

       [[ 26,  73, 145],
        [ 27,  72, 145],
        [ 24,  75, 141],
        ...,
        [ 28,  69, 133],
        [ 28,  69, 133],
        [ 28,  69, 133]],

       [[ 25,  73, 145],
        [ 26,  73, 145],
        [ 24,  75, 141],
        ...,
        [ 28,  69, 133],
        [ 28,  69, 133],
        [ 28,  69, 133]],

       ...,

       [[137, 126, 100],
        [123, 113,  88],
        [120, 113,  94],
        ...,
        [106,  88,  57],
        [131, 109,  63],
        [161, 133,  89]],

       [[194, 167, 126],
        [155, 127,  85],
        [112,  96,  62],
        ...,
        [109,  84,  42],
        [135, 105,  42],
        [171, 132,  72]],

       [[229, 198, 151],
        [216, 183, 132],
        [149, 126,  80],
        ...,
        [182, 152, 102],
        [187, 152,  74],
        [225, 183, 107]]], dtype=uint8)]"
Image_1804.jpg,372,141,236,183,869,574,608,324,236,daskShared_local/images/Image_1804.jpg,1804,"[array([[[ 83, 179, 243],
        [ 89, 179, 244],
        [ 86, 177, 242],
        ...,
        [ 84, 166, 242],
        [ 83, 165, 241],
        [ 83, 165, 241]],

       [[ 54, 168, 229],
        [ 77, 175, 237],
        [ 86, 177, 238],
        ...,
        [ 85, 167, 243],
        [ 86, 168, 244],
        [ 86, 168, 244]],

       [[ 22, 156, 220],
        [ 54, 169, 232],
        [ 78, 178, 239],
        ...,
        [ 85, 167, 243],
        [ 86, 168, 244],
        [ 87, 169, 245]],

       ...,

       [[  2,  12,  10],
        [ 12,  25,  22],
        [  8,  54,  43],
        ...,
        [  0, 106, 180],
        [  0, 106, 180],
        [  0, 106, 180]],

       [[  3,  16,  11],
        [ 21,  52,  44],
        [  9,  76,  58],
        ...,
        [  0, 106, 180],
        [  0, 106, 180],
        [  0, 106, 180]],

       [[  8,   5,   7],
        [  6,  10,  11],
        [ 10,  17,  19],
        ...,
        [  0, 105, 179],
        [  0, 105, 179],
        [  0, 105, 179]]], dtype=uint8)]"
Image_1805.jpg,450,219,173,189,1200,630,623,408,189,daskShared_local/images/Image_1805.jpg,1805,"[array([[[ 26, 101, 169],
        [ 25, 100, 168],
        [ 21,  96, 163],
        ...,
        [ 21,  50,  51],
        [ 29,  54,  56],
        [ 41,  62,  67]],

       [[ 27, 102, 170],
        [ 28, 103, 171],
        [ 27, 102, 170],
        ...,
        [ 21,  51,  51],
        [ 24,  48,  50],
        [ 33,  53,  58]],

       [[ 27, 102, 170],
        [ 28, 103, 171],
        [ 30, 105, 172],
        ...,
        [ 28,  56,  55],
        [ 25,  46,  50],
        [ 22,  40,  47]],

       ...,

       [[ 26,  71,  94],
        [ 30,  75,  96],
        [ 32,  77,  96],
        ...,
        [ 36,  36,  38],
        [ 35,  35,  37],
        [ 30,  31,  33]],

       [[ 26,  70,  95],
        [ 26,  71,  94],
        [ 25,  70,  91],
        ...,
        [ 29,  29,  31],
        [ 21,  22,  24],
        [ 13,  14,  16]],

       [[ 34,  78, 103],
        [ 32,  77, 100],
        [ 22,  67,  90],
        ...,
        [ 25,  25,  27],
        [ 23,  24,  26],
        [ 21,  25,  26]]], dtype=uint8)]"
Image_1806.jpg,1878,631,1206,1142,4752,3168,3084,1773,1206,daskShared_local/images/Image_1806.jpg,1806,"[array([[[ 69,  65,  38],
        [ 70,  65,  38],
        [ 72,  68,  40],
        ...,
        [ 52, 124, 149],
        [ 53, 124, 149],
        [ 53, 123, 148]],

       [[ 67,  62,  33],
        [ 67,  61,  33],
        [ 72,  65,  38],
        ...,
        [ 48, 119, 148],
        [ 48, 120, 148],
        [ 50, 121, 149]],

       [[ 70,  64,  36],
        [ 71,  64,  37],
        [ 75,  68,  40],
        ...,
        [ 42, 116, 147],
        [ 43, 117, 148],
        [ 44, 118, 149]],

       ...,

       [[  9,  96, 142],
        [ 10,  97, 141],
        [  6,  97, 140],
        ...,
        [140, 120,  89],
        [119,  98,  76],
        [ 95,  79,  68]],

       [[ 13,  98, 141],
        [ 14,  98, 141],
        [ 14,  98, 141],
        ...,
        [172, 157, 121],
        [138, 121,  95],
        [100,  86,  75]],

       [[ 23, 106, 142],
        [ 20, 102, 141],
        [ 25, 103, 142],
        ...,
        [186, 173, 135],
        [148, 136, 110],
        [101,  88,  78]]], dtype=uint8)]"
Image_1807.jpg,417,142,234,230,1024,686,651,372,234,daskShared_local/images/Image_1807.jpg,1807,"[array([[[ 30, 186, 237],
        [ 30, 186, 237],
        [ 30, 186, 237],
        ...,
        [  0, 156, 217],
        [  0, 156, 217],
        [  0, 156, 217]],

       [[ 30, 186, 237],
        [ 30, 186, 237],
        [ 30, 186, 237],
        ...,
        [  0, 156, 217],
        [  0, 156, 217],
        [  0, 156, 217]],

       [[ 31, 187, 238],
        [ 30, 186, 237],
        [ 30, 186, 237],
        ...,
        [  0, 156, 217],
        [  0, 156, 217],
        [  0, 156, 217]],

       ...,

       [[200, 179, 173],
        [212, 195, 189],
        [228, 215, 211],
        ...,
        [  3, 115, 181],
        [  2, 115, 181],
        [  3, 116, 182]],

       [[211, 193, 188],
        [216, 201, 196],
        [226, 214, 208],
        ...,
        [  3, 115, 181],
        [  2, 115, 181],
        [  4, 117, 183]],

       [[234, 219, 216],
        [228, 214, 208],
        [231, 218, 211],
        ...,
        [  3, 116, 182],
        [  3, 116, 182],
        [  4, 117, 183]]], dtype=uint8)]"
Image_1808.jpg,446,236,166,146,900,586,612,382,166,daskShared_local/images/Image_1808.jpg,1808,"[array([[[  3, 173, 208],
        [  3, 173, 208],
        [  2, 174, 208],
        ...,
        [102, 204, 226],
        [103, 205, 227],
        [104, 206, 228]],

       [[  3, 173, 208],
        [  3, 173, 208],
        [  2, 174, 208],
        ...,
        [102, 204, 226],
        [103, 205, 227],
        [104, 206, 228]],

       [[  2, 172, 207],
        [  2, 172, 207],
        [  1, 173, 208],
        ...,
        [102, 204, 226],
        [103, 205, 227],
        [103, 205, 227]],

       ...,

       [[  1,  79,  65],
        [  0,  72,  60],
        [  4,  73,  61],
        ...,
        [  1, 163, 209],
        [  1, 163, 209],
        [  1, 163, 209]],

       [[  4,  76,  65],
        [  1,  68,  58],
        [  8,  67,  58],
        ...,
        [  1, 163, 209],
        [  1, 163, 209],
        [  1, 163, 209]],

       [[  5,  69,  61],
        [  2,  63,  56],
        [  1,  65,  54],
        ...,
        [  1, 163, 209],
        [  1, 163, 209],
        [  1, 163, 209]]], dtype=uint8)]"
Image_1809.png,239,35,84,82,589,295,323,117,84,daskShared_local/images/Image_1809.png,1809,"[array([[[  0, 166, 187],
        [  0, 165, 186],
        [  0, 168, 188],
        ...,
        [  0, 174, 195],
        [  0, 175, 195],
        [  0, 174, 195]],

       [[  0, 166, 186],
        [  0, 165, 185],
        [  0, 168, 188],
        ...,
        [  0, 175, 196],
        [  0, 175, 195],
        [  0, 175, 196]],

       [[  0, 166, 187],
        [  0, 166, 187],
        [  0, 168, 189],
        ...,
        [  0, 174, 194],
        [  0, 173, 194],
        [  0, 174, 194]],

       ...,

       [[ 48,  26,  31],
        [ 46,  24,  30],
        [ 52,  31,  33],
        ...,
        [178, 114, 109],
        [160, 100,  96],
        [167, 105, 101]],

       [[ 43,  25,  30],
        [ 40,  22,  29],
        [ 50,  31,  32],
        ...,
        [108,  58,  57],
        [ 75,  36,  39],
        [ 87,  43,  45]],

       [[ 45,  26,  30],
        [ 42,  23,  29],
        [ 51,  31,  33],
        ...,
        [133,  78,  75],
        [106,  58,  59],
        [115,  65,  65]]], dtype=uint8)]"
Image_181.jpg,443,224,177,187,1200,630,620,411,187,daskShared_local/images/Image_181.jpg,181,"[array([[[ 32, 107, 175],
        [ 28, 102, 173],
        [ 28, 104, 175],
        ...,
        [ 86, 104, 106],
        [ 83, 101, 100],
        [152, 167, 135]],

       [[ 30, 105, 173],
        [ 28, 102, 173],
        [ 22,  98, 168],
        ...,
        [ 66,  84,  86],
        [ 63,  81,  81],
        [ 86, 100,  74]],

       [[ 29, 103, 174],
        [ 30, 104, 176],
        [ 25,  99, 172],
        ...,
        [ 57,  75,  76],
        [ 60,  78,  77],
        [ 91, 104,  87]],

       ...,

       [[ 40,  96, 113],
        [ 40,  93, 113],
        [ 25,  76,  97],
        ...,
        [ 22,  23,  25],
        [ 25,  25,  28],
        [ 25,  21,  25]],

       [[ 45, 100, 117],
        [ 36,  89, 107],
        [ 24,  75,  96],
        ...,
        [ 21,  22,  24],
        [ 19,  19,  22],
        [ 23,  18,  22]],

       [[ 67, 120, 136],
        [ 51, 102, 121],
        [ 30,  81, 100],
        ...,
        [ 21,  21,  23],
        [ 25,  25,  27],
        [ 30,  28,  29]]], dtype=uint8)]"
Image_1810.jpg,728,438,466,356,2119,1414,1194,794,466,daskShared_local/images/Image_1810.jpg,1810,"[array([[[ 94, 147, 179],
        [100, 155, 186],
        [102, 157, 188],
        ...,
        [ 76, 142, 172],
        [ 75, 140, 171],
        [ 72, 137, 168]],

       [[ 92, 145, 177],
        [101, 155, 186],
        [ 99, 154, 185],
        ...,
        [ 79, 144, 174],
        [ 80, 145, 175],
        [ 73, 138, 168]],

       [[ 94, 147, 179],
        [ 93, 148, 179],
        [ 96, 151, 182],
        ...,
        [ 78, 143, 173],
        [ 72, 137, 167],
        [ 71, 136, 166]],

       ...,

       [[ 79, 173, 198],
        [ 79, 173, 198],
        [ 80, 174, 199],
        ...,
        [ 11,  98, 122],
        [  0,  96, 117],
        [  4,  95, 115]],

       [[ 79, 173, 198],
        [ 79, 173, 198],
        [ 80, 174, 199],
        ...,
        [  4,  95, 110],
        [  6,  95, 109],
        [ 29,  99, 111]],

       [[ 78, 173, 198],
        [ 79, 174, 199],
        [ 80, 174, 199],
        ...,
        [ 15,  93, 100],
        [ 44, 108, 109],
        [ 79, 120, 115]]], dtype=uint8)]"
Image_1811.jpg,216,191,167,158,500,559,383,349,167,daskShared_local/images/Image_1811.jpg,1811,"[array([[[ 74, 167, 167],
        [ 83, 171, 170],
        [ 97, 178, 176],
        ...,
        [115, 208, 198],
        [117, 207, 198],
        [119, 209, 199]],

       [[ 79, 175, 175],
        [ 85, 177, 176],
        [ 96, 181, 180],
        ...,
        [113, 207, 197],
        [116, 207, 198],
        [119, 209, 200]],

       [[ 86, 177, 174],
        [ 88, 175, 173],
        [ 92, 175, 174],
        ...,
        [112, 206, 196],
        [116, 208, 198],
        [120, 210, 201]],

       ...,

       [[ 83,  79,   6],
        [ 79,  73,   7],
        [ 68,  58,   5],
        ...,
        [ 17,  98,  83],
        [ 24,  89,  61],
        [ 16,  70,  33]],

       [[ 39,  34,  11],
        [ 42,  37,  11],
        [ 44,  37,   9],
        ...,
        [  1, 154, 144],
        [  3, 134, 117],
        [  4, 117,  95]],

       [[  8,   3,   3],
        [  9,   4,   2],
        [ 15,   7,   3],
        ...,
        [  6, 172, 171],
        [ 11, 160, 154],
        [ 14, 150, 141]]], dtype=uint8)]"
Image_1812.jpg,483,245,352,209,1200,900,835,454,352,daskShared_local/images/Image_1812.jpg,1812,"[array([[[ 43, 158, 163],
        [ 53, 170, 178],
        [ 45, 159, 173],
        ...,
        [104, 193, 214],
        [ 98, 193, 211],
        [106, 194, 213]],

       [[  4, 139, 144],
        [ 32, 149, 154],
        [ 30, 163, 172],
        ...,
        [ 86, 189, 216],
        [ 93, 193, 214],
        [100, 193, 212]],

       [[ 34, 153, 163],
        [  4, 146, 160],
        [ 26, 147, 157],
        ...,
        [108, 196, 213],
        [ 93, 191, 211],
        [ 93, 191, 212]],

       ...,

       [[ 93, 144, 137],
        [ 94, 147, 139],
        [ 90, 143, 136],
        ...,
        [135, 204, 222],
        [140, 204, 219],
        [144, 207, 216]],

       [[110, 147, 138],
        [ 86, 144, 133],
        [ 88, 127, 117],
        ...,
        [146, 208, 223],
        [139, 204, 221],
        [133, 203, 217]],

       [[ 85, 137, 121],
        [ 61, 133, 114],
        [ 60, 130, 107],
        ...,
        [178, 219, 228],
        [158, 211, 227],
        [144, 206, 220]]], dtype=uint8)]"
Image_1813.jpg,359,130,211,181,1280,720,570,311,211,daskShared_local/images/Image_1813.jpg,1813,"[array([[[ 17, 113, 200],
        [ 18, 116, 203],
        [ 16, 114, 201],
        ...,
        [ 18, 131, 211],
        [ 18, 131, 211],
        [ 17, 130, 210]],

       [[  8, 104, 191],
        [ 12, 109, 196],
        [  7, 104, 191],
        ...,
        [ 21, 134, 214],
        [ 20, 133, 213],
        [ 20, 133, 213]],

       [[ 10, 105, 192],
        [ 14, 110, 197],
        [ 10, 106, 193],
        ...,
        [ 21, 134, 214],
        [ 26, 139, 219],
        [ 26, 139, 219]],

       ...,

       [[ 14,  79, 171],
        [ 14,  79, 171],
        [ 13,  78, 170],
        ...,
        [183, 174, 141],
        [198, 187, 152],
        [190, 177, 142]],

       [[ 15,  80, 172],
        [ 12,  77, 169],
        [ 11,  76, 168],
        ...,
        [ 78,  71,  42],
        [142, 133, 101],
        [174, 163, 128]],

       [[ 15,  80, 172],
        [ 11,  76, 168],
        [ 10,  75, 167],
        ...,
        [ 14,   9,   1],
        [ 48,  41,  14],
        [104,  95,  63]]], dtype=uint8)]"
Image_1814.jpg,425,158,267,250,1200,822,692,408,267,daskShared_local/images/Image_1814.jpg,1814,"[array([[[  0, 147, 173],
        [  0, 147, 173],
        [  0, 147, 173],
        ...,
        [  0, 164, 192],
        [  0, 164, 192],
        [  1, 165, 193]],

       [[  0, 148, 174],
        [  1, 148, 174],
        [  1, 148, 174],
        ...,
        [  3, 164, 192],
        [  3, 164, 192],
        [  3, 164, 192]],

       [[  0, 149, 174],
        [  0, 150, 175],
        [  0, 150, 175],
        ...,
        [  1, 162, 190],
        [  1, 162, 190],
        [  1, 162, 190]],

       ...,

       [[ 75,  82,  51],
        [ 74,  80,  49],
        [ 60,  70,  32],
        ...,
        [139, 107,  72],
        [128,  98,  53],
        [104,  84,  35]],

       [[ 61,  69,  41],
        [ 74,  80,  56],
        [ 51,  60,  32],
        ...,
        [149, 124, 104],
        [122,  95,  65],
        [104,  84,  43]],

       [[ 42,  52,  20],
        [ 56,  58,  38],
        [ 52,  48,  34],
        ...,
        [145, 125,  96],
        [115,  93,  57],
        [100,  77,  32]]], dtype=uint8)]"
Image_1815.jpg,280,165,173,164,800,533,453,329,173,daskShared_local/images/Image_1815.jpg,1815,"[array([[[226, 199, 170],
        [223, 196, 167],
        [217, 190, 161],
        ...,
        [ 32,  29,  58],
        [ 52,  49,  78],
        [ 61,  58,  85]],

       [[215, 190, 157],
        [216, 191, 158],
        [214, 190, 156],
        ...,
        [ 40,  37,  66],
        [ 52,  49,  76],
        [ 57,  55,  80]],

       [[223, 201, 165],
        [226, 204, 168],
        [229, 206, 170],
        ...,
        [ 74,  72,  98],
        [ 75,  73,  98],
        [ 70,  68,  91]],

       ...,

       [[139, 111,  99],
        [142, 114, 102],
        [145, 117, 105],
        ...,
        [ 72,  54,  43],
        [ 73,  55,  44],
        [ 77,  59,  48]],

       [[151, 123, 111],
        [156, 128, 116],
        [157, 129, 117],
        ...,
        [ 71,  53,  41],
        [ 72,  54,  41],
        [ 74,  56,  44]],

       [[170, 142, 130],
        [168, 140, 128],
        [162, 134, 122],
        ...,
        [ 87,  69,  55],
        [ 87,  69,  55],
        [ 89,  71,  57]]], dtype=uint8)]"
Image_1816.jpg,697,279,459,498,1920,1080,1156,777,498,daskShared_local/images/Image_1816.jpg,1816,"[array([[[  1, 120, 204],
        [  0, 119, 203],
        [  0, 119, 203],
        ...,
        [  1, 116, 199],
        [  1, 116, 199],
        [  1, 116, 199]],

       [[  1, 120, 204],
        [  0, 119, 203],
        [  0, 119, 203],
        ...,
        [  1, 116, 199],
        [  1, 116, 199],
        [  1, 116, 199]],

       [[  0, 119, 203],
        [  0, 119, 203],
        [  0, 119, 203],
        ...,
        [  1, 116, 199],
        [  1, 116, 199],
        [  1, 116, 199]],

       ...,

       [[167, 173, 141],
        [150, 151, 117],
        [180, 178, 141],
        ...,
        [157, 153, 113],
        [175, 171, 127],
        [175, 171, 124]],

       [[106, 114,  88],
        [125, 130,  96],
        [187, 189, 151],
        ...,
        [153, 144, 103],
        [152, 143, 100],
        [156, 147, 103]],

       [[ 73,  83,  58],
        [105, 111,  80],
        [160, 162, 130],
        ...,
        [160, 147, 112],
        [164, 151, 114],
        [166, 153, 115]]], dtype=uint8)]"
Image_1817.jpg,359,98,147,191,728,486,506,289,191,daskShared_local/images/Image_1817.jpg,1817,"[array([[[  1,  66, 254],
        [  1,  66, 254],
        [  0,  67, 254],
        ...,
        [  1, 105, 254],
        [  1, 107, 255],
        [  0, 106, 254]],

       [[  1,  64, 255],
        [  0,  63, 252],
        [  1,  64, 253],
        ...,
        [  0, 106, 254],
        [  0, 106, 254],
        [  0, 107, 255]],

       [[  3,  63, 255],
        [  1,  64, 253],
        [  3,  64, 253],
        ...,
        [  0, 106, 254],
        [  2, 106, 255],
        [  0, 106, 251]],

       ...,

       [[203, 153, 120],
        [199, 150, 117],
        [187, 138, 105],
        ...,
        [ 70,  72,  56],
        [ 71,  70,  57],
        [ 60,  64,  56]],

       [[203, 153, 121],
        [202, 162, 131],
        [209, 164, 133],
        ...,
        [110, 128, 108],
        [ 82,  88,  65],
        [ 65,  74,  54]],

       [[207, 161, 127],
        [196, 151, 118],
        [184, 135, 102],
        ...,
        [173, 187, 176],
        [117, 142, 117],
        [ 95, 111,  74]]], dtype=uint8)]"
Image_1818.jpg,328,138,270,209,845,563,598,347,270,daskShared_local/images/Image_1818.jpg,1818,"[array([[[ 69, 191, 189],
        [ 72, 190, 189],
        [ 77, 189, 191],
        ...,
        [ 91, 197, 193],
        [ 90, 196, 192],
        [ 87, 196, 191]],

       [[ 73, 192, 191],
        [ 82, 194, 195],
        [ 93, 196, 200],
        ...,
        [ 87, 197, 193],
        [ 86, 196, 192],
        [ 85, 195, 192]],

       [[ 80, 198, 196],
        [ 93, 203, 204],
        [111, 209, 214],
        ...,
        [ 86, 196, 193],
        [ 86, 196, 193],
        [ 87, 199, 195]],

       ...,

       [[ 53,  88,  14],
        [ 61,  96,  23],
        [ 64, 100,  27],
        ...,
        [ 48, 196, 188],
        [ 41, 193, 185],
        [ 34, 193, 183]],

       [[ 56,  85,   9],
        [ 59,  91,  15],
        [ 60,  97,  19],
        ...,
        [ 47, 192, 187],
        [ 38, 190, 184],
        [ 28, 187, 180]],

       [[ 65, 103,  30],
        [ 65, 103,  30],
        [ 61, 102,  28],
        ...,
        [ 48, 193, 190],
        [ 38, 189, 186],
        [ 28, 186, 181]]], dtype=uint8)]"
Image_1819.jpg,313,213,189,199,1000,600,502,412,199,daskShared_local/images/Image_1819.jpg,1819,"[array([[[  1, 146, 193],
        [  1, 146, 193],
        [  1, 146, 193],
        ...,
        [  1, 158, 201],
        [  1, 158, 201],
        [  1, 158, 201]],

       [[  1, 146, 193],
        [  1, 146, 193],
        [  1, 146, 193],
        ...,
        [  1, 158, 201],
        [  1, 158, 201],
        [  1, 158, 201]],

       [[  1, 146, 193],
        [  1, 146, 193],
        [  1, 146, 193],
        ...,
        [  1, 158, 201],
        [  1, 158, 201],
        [  1, 158, 201]],

       ...,

       [[210, 179,  89],
        [206, 174,  89],
        [213, 179, 105],
        ...,
        [248, 223, 159],
        [247, 222, 158],
        [249, 222, 155]],

       [[166, 140,  47],
        [144, 112,  70],
        [153, 124,  83],
        ...,
        [246, 222, 158],
        [245, 222, 155],
        [246, 221, 154]],

       [[102,  78,  18],
        [ 72,  44,  32],
        [ 76,  53,  37],
        ...,
        [244, 223, 160],
        [244, 223, 158],
        [245, 222, 155]]], dtype=uint8)]"
Image_182.jpg,730,441,470,355,2119,1414,1200,796,470,daskShared_local/images/Image_182.jpg,182,"[array([[[ 99, 154, 185],
        [102, 157, 188],
        [ 96, 153, 183],
        ...,
        [ 73, 138, 168],
        [ 75, 140, 170],
        [ 77, 142, 172]],

       [[ 98, 152, 183],
        [ 98, 153, 184],
        [ 95, 152, 182],
        ...,
        [ 76, 141, 171],
        [ 73, 138, 168],
        [ 70, 135, 165]],

       [[ 92, 146, 177],
        [ 95, 150, 181],
        [ 93, 149, 179],
        ...,
        [ 69, 134, 164],
        [ 72, 137, 167],
        [ 71, 136, 166]],

       ...,

       [[ 79, 174, 199],
        [ 79, 174, 199],
        [ 81, 175, 199],
        ...,
        [ 97, 113,  94],
        [112, 103,  74],
        [125,  97,  62]],

       [[ 79, 175, 199],
        [ 79, 175, 199],
        [ 80, 174, 198],
        ...,
        [ 98,  91,  56],
        [108,  91,  58],
        [130, 104,  76]],

       [[ 77, 173, 197],
        [ 78, 174, 198],
        [ 80, 174, 198],
        ...,
        [117,  97,  63],
        [123, 104,  69],
        [126, 106,  73]]], dtype=uint8)]"
Image_1820.png,372,192,337,271,900,600,709,463,337,daskShared_local/images/Image_1820.png,1820,"[array([[[127, 118, 109],
        [139, 135, 129],
        [155, 154, 144],
        ...,
        [ 18, 148, 179],
        [ 22, 148, 179],
        [ 25, 149, 184]],

       [[119, 115, 102],
        [129, 119, 105],
        [141, 128, 107],
        ...,
        [ 15, 152, 184],
        [ 14, 152, 181],
        [ 19, 153, 182]],

       [[128, 118,  95],
        [116, 113,  98],
        [106,  99,  90],
        ...,
        [ 17, 152, 183],
        [ 12, 150, 182],
        [ 18, 149, 182]],

       ...,

       [[ 33,  72,  65],
        [ 31,  72,  64],
        [ 21,  67,  63],
        ...,
        [ 80, 139, 146],
        [ 75, 140, 142],
        [ 77, 137, 139]],

       [[ 26,  82,  68],
        [ 24,  79,  68],
        [ 24,  67,  66],
        ...,
        [ 77, 135, 135],
        [ 75, 137, 133],
        [ 75, 137, 131]],

       [[ 33,  84,  74],
        [ 29,  70,  70],
        [ 26,  66,  62],
        ...,
        [ 85, 143, 136],
        [ 83, 138, 130],
        [ 82, 137, 129]]], dtype=uint8)]"
Image_1821.jpg,25,84,254,157,800,600,279,241,254,daskShared_local/images/Image_1821.jpg,1821,"[array([[[  3, 154, 211],
        [  2, 153, 207],
        [  0, 151, 204],
        ...,
        [ 15, 174, 229],
        [ 12, 173, 227],
        [ 16, 175, 229]],

       [[  2, 153, 210],
        [  1, 152, 207],
        [  1, 153, 204],
        ...,
        [ 21, 178, 233],
        [ 20, 178, 231],
        [ 18, 175, 227]],

       [[  5, 154, 211],
        [  3, 152, 208],
        [  1, 153, 205],
        ...,
        [ 21, 175, 229],
        [ 23, 178, 230],
        [ 21, 178, 227]],

       ...,

       [[ 66, 132, 113],
        [ 69, 135, 115],
        [ 73, 141, 115],
        ...,
        [105,  77,  58],
        [102,  75,  54],
        [107,  77,  59]],

       [[ 67, 129, 110],
        [ 69, 132, 112],
        [ 74, 139, 114],
        ...,
        [110,  80,  65],
        [103,  73,  57],
        [ 96,  64,  51]],

       [[ 68, 127, 107],
        [ 72, 131, 111],
        [ 73, 135, 111],
        ...,
        [ 95,  59,  49],
        [ 88,  52,  41],
        [ 84,  46,  38]]], dtype=uint8)]"
Image_1822.jpg,467,130,278,312,1600,1019,745,442,312,daskShared_local/images/Image_1822.jpg,1822,"[array([[[ 26, 109, 213],
        [ 26, 109, 213],
        [ 26, 109, 213],
        ...,
        [ 28, 116, 213],
        [ 28, 116, 213],
        [ 28, 116, 213]],

       [[ 26, 109, 213],
        [ 26, 109, 213],
        [ 26, 109, 213],
        ...,
        [ 28, 116, 213],
        [ 28, 116, 213],
        [ 28, 116, 213]],

       [[ 26, 109, 213],
        [ 26, 109, 213],
        [ 26, 109, 213],
        ...,
        [ 28, 116, 213],
        [ 28, 116, 213],
        [ 28, 116, 213]],

       ...,

       [[226, 228, 213],
        [240, 242, 228],
        [243, 245, 232],
        ...,
        [ 68,  47,  37],
        [ 81,  65,  55],
        [115, 103,  93]],

       [[255, 255, 244],
        [254, 254, 243],
        [251, 252, 241],
        ...,
        [ 58,  34,  26],
        [ 65,  41,  34],
        [103,  81,  73]],

       [[253, 253, 246],
        [251, 253, 244],
        [244, 246, 236],
        ...,
        [ 62,  34,  29],
        [ 59,  29,  24],
        [ 85,  51,  47]]], dtype=uint8)]"
Image_1823.jpg,993,147,241,316,1686,1216,1234,463,316,daskShared_local/images/Image_1823.jpg,1823,"[array([[[124, 183, 213],
        [123, 182, 212],
        [124, 182, 212],
        ...,
        [159, 201, 225],
        [159, 201, 225],
        [159, 201, 225]],

       [[124, 183, 213],
        [124, 183, 213],
        [124, 182, 212],
        ...,
        [159, 201, 225],
        [159, 201, 225],
        [159, 201, 225]],

       [[124, 183, 213],
        [124, 183, 213],
        [124, 183, 213],
        ...,
        [159, 201, 225],
        [159, 201, 225],
        [159, 201, 225]],

       ...,

       [[136, 181, 173],
        [110, 157, 151],
        [114, 164, 150],
        ...,
        [ 88, 164, 200],
        [ 87, 163, 199],
        [ 86, 162, 198]],

       [[152, 194, 182],
        [113, 157, 149],
        [108, 157, 142],
        ...,
        [ 89, 165, 201],
        [ 89, 165, 201],
        [ 89, 165, 201]],

       [[163, 205, 184],
        [131, 175, 159],
        [108, 155, 138],
        ...,
        [ 89, 165, 201],
        [ 89, 165, 201],
        [ 89, 165, 201]]], dtype=uint8)]"
Image_1824.jpg,425,166,792,642,1500,1000,1217,808,792,daskShared_local/images/Image_1824.jpg,1824,"[array([[[  3,  55,  66],
        [  2,  54,  65],
        [  2,  54,  65],
        ...,
        [152, 144, 166],
        [168, 156, 175],
        [168, 157, 175]],

       [[  3,  55,  66],
        [  2,  54,  66],
        [  2,  54,  66],
        ...,
        [167, 160, 177],
        [166, 158, 176],
        [153, 146, 168]],

       [[  3,  55,  66],
        [  2,  54,  66],
        [  2,  54,  67],
        ...,
        [174, 165, 182],
        [164, 157, 178],
        [139, 133, 160]],

       ...,

       [[126, 136, 170],
        [130, 146, 181],
        [164, 178, 198],
        ...,
        [ 36,  63,  40],
        [ 32,  61,  38],
        [ 35,  62,  41]],

       [[161, 166, 176],
        [139, 149, 176],
        [148, 161, 191],
        ...,
        [ 38,  64,  42],
        [ 35,  63,  41],
        [ 36,  64,  42]],

       [[182, 185, 191],
        [161, 166, 181],
        [143, 150, 185],
        ...,
        [ 39,  66,  43],
        [ 37,  65,  42],
        [ 37,  64,  42]]], dtype=uint8)]"
Image_1825.jpg,248,382,846,691,1512,1231,1094,1073,846,daskShared_local/images/Image_1825.jpg,1825,"[array([[[ 68,  82,  72],
        [ 70,  82,  72],
        [ 70,  84,  72],
        ...,
        [ 77, 112,  86],
        [ 79, 110,  83],
        [ 95, 124,  95]],

       [[ 80,  90,  82],
        [ 74,  85,  76],
        [ 73,  86,  74],
        ...,
        [ 80, 113,  89],
        [ 79, 109,  86],
        [ 81, 110,  86]],

       [[ 84,  96,  89],
        [ 76,  88,  81],
        [ 73,  86,  78],
        ...,
        [ 81, 112,  89],
        [ 79, 108,  86],
        [ 78, 108,  85]],

       ...,

       [[236, 220, 198],
        [216, 197, 181],
        [192, 174, 156],
        ...,
        [237, 215, 176],
        [245, 228, 196],
        [242, 224, 198]],

       [[176, 164, 151],
        [152, 138, 129],
        [136, 122, 109],
        ...,
        [250, 237, 208],
        [252, 241, 218],
        [242, 227, 206]],

       [[122, 118, 113],
        [116, 110, 106],
        [115, 105,  96],
        ...,
        [254, 245, 225],
        [253, 243, 226],
        [242, 228, 208]]], dtype=uint8)]"
Image_1826.jpg,609,226,147,106,1000,667,756,332,147,daskShared_local/images/Image_1826.jpg,1826,"[array([[[  3, 129, 154],
        [  3, 129, 155],
        [  7, 132, 157],
        ...,
        [ 56, 131, 145],
        [ 59, 133, 147],
        [ 60, 133, 146]],

       [[  2, 123, 149],
        [  2, 123, 149],
        [  3, 124, 150],
        ...,
        [ 58, 130, 145],
        [ 63, 132, 148],
        [ 64, 133, 148]],

       [[  1, 114, 137],
        [  1, 113, 137],
        [  0, 115, 137],
        ...,
        [ 50, 125, 139],
        [ 58, 130, 145],
        [ 62, 133, 148]],

       ...,

       [[117, 133, 113],
        [117, 133, 112],
        [118, 134, 112],
        ...,
        [ 49,  82,  91],
        [ 39,  67,  77],
        [ 32,  57,  67]],

       [[117, 134, 112],
        [113, 129, 108],
        [115, 131, 109],
        ...,
        [ 46,  74,  83],
        [ 36,  60,  70],
        [ 29,  51,  60]],

       [[122, 139, 118],
        [112, 130, 108],
        [112, 130, 107],
        ...,
        [ 42,  68,  76],
        [ 33,  55,  63],
        [ 27,  47,  55]]], dtype=uint8)]"
Image_1827.jpg,649,288,312,323,1600,1000,961,611,323,daskShared_local/images/Image_1827.jpg,1827,"[array([[[  0,  71, 163],
        [  0,  71, 163],
        [  0,  71, 163],
        ...,
        [  2,  69, 160],
        [  2,  69, 160],
        [  2,  69, 160]],

       [[  0,  71, 163],
        [  0,  71, 163],
        [  0,  71, 163],
        ...,
        [  2,  69, 160],
        [  2,  69, 160],
        [  1,  68, 159]],

       [[  0,  70, 163],
        [  0,  70, 162],
        [  0,  69, 162],
        ...,
        [  1,  68, 159],
        [  1,  68, 159],
        [  1,  68, 159]],

       ...,

       [[ 76,  84,  55],
        [ 77,  80,  59],
        [120, 119,  88],
        ...,
        [154, 148,  98],
        [197, 195, 135],
        [171, 167, 105]],

       [[ 47,  62,  33],
        [112, 128,  93],
        [113, 123,  80],
        ...,
        [107,  98,  61],
        [148, 144,  99],
        [153, 148,  98]],

       [[ 37,  52,  26],
        [ 80,  95,  65],
        [ 83,  91,  54],
        ...,
        [ 97,  86,  49],
        [101,  95,  52],
        [109, 100,  54]]], dtype=uint8)]"
Image_1828.jpg,449,285,164,164,850,567,613,449,164,daskShared_local/images/Image_1828.jpg,1828,"[array([[[154,  97,  71],
        [132,  77,  68],
        [147,  91,  93],
        ...,
        [ 97,  85,  77],
        [102,  71,  59],
        [122,  86,  75]],

       [[155,  97,  78],
        [131,  75,  69],
        [144,  87,  87],
        ...,
        [108,  86,  82],
        [112,  82,  78],
        [143, 113, 103]],

       [[136,  74,  64],
        [126,  69,  67],
        [155, 100,  94],
        ...,
        [113,  90,  89],
        [ 98,  82,  90],
        [107,  91,  96]],

       ...,

       [[  9, 123, 235],
        [  8, 122, 234],
        [  8, 122, 234],
        ...,
        [  9, 127, 233],
        [ 10, 128, 234],
        [ 10, 128, 234]],

       [[  9, 123, 234],
        [  8, 123, 235],
        [  8, 123, 235],
        ...,
        [ 11, 129, 235],
        [ 10, 128, 234],
        [ 11, 129, 235]],

       [[  8, 124, 233],
        [  9, 125, 235],
        [  9, 125, 236],
        ...,
        [ 12, 130, 236],
        [ 11, 129, 235],
        [ 10, 128, 234]]], dtype=uint8)]"
Image_1829.jpg,909,468,697,506,3008,2000,1606,974,697,daskShared_local/images/Image_1829.jpg,1829,"[array([[[148, 187, 194],
        [148, 187, 194],
        [148, 187, 194],
        ...,
        [135, 177, 189],
        [135, 177, 189],
        [135, 177, 189]],

       [[148, 187, 194],
        [148, 187, 194],
        [148, 187, 194],
        ...,
        [135, 177, 189],
        [135, 177, 189],
        [135, 177, 189]],

       [[148, 187, 194],
        [148, 187, 194],
        [148, 187, 194],
        ...,
        [135, 177, 189],
        [135, 177, 189],
        [135, 177, 189]],

       ...,

       [[112, 170, 176],
        [115, 168, 176],
        [115, 168, 176],
        ...,
        [ 59,  79,  82],
        [ 58,  77,  81],
        [ 54,  73,  77]],

       [[111, 168, 175],
        [115, 168, 176],
        [115, 168, 176],
        ...,
        [ 60,  80,  84],
        [ 47,  66,  70],
        [ 42,  61,  65]],

       [[110, 168, 174],
        [115, 168, 176],
        [115, 168, 176],
        ...,
        [ 71,  91,  95],
        [ 58,  78,  82],
        [ 49,  68,  72]]], dtype=uint8)]"
Image_183.jpeg,645,152,249,236,1200,800,894,388,249,daskShared_local/images/Image_183.jpeg,183,"[array([[[181, 217, 225],
        [184, 218, 227],
        [188, 222, 231],
        ...,
        [180, 215, 232],
        [174, 213, 230],
        [170, 212, 228]],

       [[183, 220, 228],
        [185, 219, 228],
        [185, 219, 228],
        ...,
        [181, 215, 233],
        [173, 212, 229],
        [169, 211, 227]],

       [[183, 220, 228],
        [184, 218, 227],
        [181, 215, 224],
        ...,
        [182, 216, 234],
        [174, 212, 229],
        [168, 210, 226]],

       ...,

       [[ 79,  32,   1],
        [140,  94,  18],
        [159, 115,  37],
        ...,
        [177, 160, 121],
        [191, 170, 137],
        [195, 169, 141]],

       [[135,  88,  34],
        [188, 144,  77],
        [189, 148,  73],
        ...,
        [174, 159, 107],
        [186, 168, 124],
        [203, 180, 141]],

       [[158, 114,  65],
        [229, 187, 131],
        [226, 187, 119],
        ...,
        [168, 152,  94],
        [175, 158, 106],
        [191, 171, 124]]], dtype=uint8)]"
Image_1830.jpg,2401,927,646,538,3840,2160,3047,1465,646,daskShared_local/images/Image_1830.jpg,1830,"[array([[[174, 150, 126],
        [207, 182, 159],
        [176, 153, 131],
        ...,
        [  0, 131, 178],
        [  1, 134, 177],
        [  0, 132, 175]],

       [[207, 183, 158],
        [223, 199, 175],
        [198, 176, 153],
        ...,
        [  0, 131, 179],
        [  0, 133, 176],
        [  0, 133, 176]],

       [[189, 165, 139],
        [183, 159, 134],
        [172, 150, 126],
        ...,
        [  1, 130, 176],
        [  1, 133, 177],
        [  0, 133, 176]],

       ...,

       [[  0, 151, 171],
        [  1, 150, 172],
        [  0, 149, 172],
        ...,
        [  1, 121, 164],
        [  2, 121, 161],
        [  2, 121, 162]],

       [[  0, 151, 170],
        [  1, 151, 171],
        [  1, 150, 170],
        ...,
        [  1, 120, 163],
        [  1, 120, 162],
        [  1, 120, 162]],

       [[  1, 152, 171],
        [  2, 152, 172],
        [  2, 151, 171],
        ...,
        [  1, 120, 163],
        [  1, 120, 162],
        [  1, 120, 163]]], dtype=uint8)]"
Image_1831.jpg,423,7,395,493,1280,720,818,500,493,daskShared_local/images/Image_1831.jpg,1831,"[array([[[156, 227, 238],
        [156, 227, 239],
        [157, 227, 239],
        ...,
        [ 58, 180, 209],
        [ 52, 179, 206],
        [ 55, 179, 208]],

       [[160, 226, 240],
        [158, 228, 240],
        [158, 228, 240],
        ...,
        [ 65, 184, 210],
        [ 54, 179, 206],
        [ 42, 180, 205]],

       [[159, 227, 240],
        [158, 228, 240],
        [158, 228, 240],
        ...,
        [ 62, 182, 208],
        [ 61, 184, 206],
        [ 68, 186, 212]],

       ...,

       [[ 80,  67,  55],
        [ 89,  75,  59],
        [102,  87,  65],
        ...,
        [  2,  76,  99],
        [  4,  77,  99],
        [  2,  77, 100]],

       [[ 58,  52,  44],
        [ 88,  76,  66],
        [116, 105,  86],
        ...,
        [  3,  75,  99],
        [  4,  75,  98],
        [  3,  76, 100]],

       [[ 67,  58,  45],
        [ 84,  73,  60],
        [111,  95,  83],
        ...,
        [  3,  75,  99],
        [  3,  75,  99],
        [  3,  75,  99]]], dtype=uint8)]"
Image_1832.jpg,219,214,130,157,800,600,349,371,157,daskShared_local/images/Image_1832.jpg,1832,"[array([[[ 66, 186, 210],
        [ 66, 186, 210],
        [ 65, 186, 209],
        ...,
        [ 20, 164, 193],
        [ 20, 163, 193],
        [ 20, 163, 193]],

       [[ 66, 186, 210],
        [ 66, 186, 210],
        [ 64, 187, 209],
        ...,
        [ 18, 164, 193],
        [ 17, 164, 192],
        [ 17, 164, 192]],

       [[ 65, 185, 209],
        [ 65, 186, 210],
        [ 65, 187, 210],
        ...,
        [ 19, 164, 193],
        [ 20, 164, 194],
        [ 21, 164, 194]],

       ...,

       [[ 25, 114,  99],
        [ 26, 115, 100],
        [ 26, 114,  99],
        ...,
        [229, 200, 145],
        [226, 201, 145],
        [233, 209, 163]],

       [[ 21, 108,  95],
        [ 22, 110,  96],
        [ 24, 111,  96],
        ...,
        [229, 198, 146],
        [226, 199, 151],
        [231, 206, 164]],

       [[ 20, 107,  94],
        [ 23, 109,  96],
        [ 23, 109,  95],
        ...,
        [230, 198, 146],
        [227, 199, 151],
        [226, 202, 154]]], dtype=uint8)]"
Image_1833.jpg,617,320,184,140,1400,933,801,460,184,daskShared_local/images/Image_1833.jpg,1833,"[array([[[  0, 173, 229],
        [  0, 173, 229],
        [  0, 173, 229],
        ...,
        [  1, 208, 248],
        [  2, 209, 249],
        [  2, 209, 251]],

       [[  1, 176, 231],
        [  1, 176, 231],
        [  1, 176, 231],
        ...,
        [  1, 208, 248],
        [  2, 209, 249],
        [  2, 208, 248]],

       [[  3, 178, 233],
        [  4, 179, 234],
        [  4, 179, 234],
        ...,
        [  1, 207, 247],
        [  2, 208, 248],
        [  1, 207, 247]],

       ...,

       [[145, 112,  73],
        [141, 113,  77],
        [109,  85,  53],
        ...,
        [  2, 183, 236],
        [  2, 183, 236],
        [  1, 185, 237]],

       [[190, 164, 118],
        [216, 199, 156],
        [155, 140,  98],
        ...,
        [  2, 183, 236],
        [  2, 183, 236],
        [  0, 184, 236]],

       [[206, 184, 143],
        [248, 238, 204],
        [208, 196, 164],
        ...,
        [  2, 183, 236],
        [  2, 183, 236],
        [  0, 184, 236]]], dtype=uint8)]"
Image_1834.jpg,233,450,145,183,2015,1510,378,633,183,daskShared_local/images/Image_1834.jpg,1834,"[array([[[ 81,  73,  70],
        [ 74,  69,  65],
        [ 61,  58,  53],
        ...,
        [ 11,   2,   1],
        [ 14,   4,   3],
        [ 19,   7,   7]],

       [[ 76,  71,  67],
        [ 66,  61,  57],
        [ 43,  40,  35],
        ...,
        [ 12,   4,   2],
        [ 12,   4,   2],
        [ 14,   6,   4]],

       [[ 65,  61,  58],
        [ 53,  48,  45],
        [ 53,  49,  46],
        ...,
        [ 12,   6,   3],
        [ 10,   5,   2],
        [ 11,   5,   2]],

       ...,

       [[ 98,  90,  77],
        [104,  96,  83],
        [111, 102,  90],
        ...,
        [139, 144, 148],
        [123, 126, 130],
        [119, 122, 127]],

       [[ 97,  89,  76],
        [101,  93,  80],
        [109, 100,  88],
        ...,
        [133, 138, 141],
        [125, 129, 132],
        [121, 125, 128]],

       [[ 92,  84,  71],
        [ 91,  83,  70],
        [ 97,  87,  75],
        ...,
        [138, 143, 146],
        [132, 136, 139],
        [117, 121, 124]]], dtype=uint8)]"
Image_1835.png,364,60,193,148,600,600,557,208,193,daskShared_local/images/Image_1835.png,1835,"[array([[[  0, 102, 249],
        [  0, 102, 249],
        [  1, 103, 250],
        ...,
        [  1, 119, 255],
        [  1, 119, 255],
        [  1, 119, 255]],

       [[  1, 103, 250],
        [  0, 102, 249],
        [  1, 103, 250],
        ...,
        [  1, 119, 255],
        [  1, 119, 255],
        [  1, 119, 255]],

       [[  2, 104, 249],
        [  2, 104, 249],
        [  1, 103, 248],
        ...,
        [  1, 122, 255],
        [  0, 121, 254],
        [  0, 121, 254]],

       ...,

       [[185, 244, 251],
        [154, 168, 184],
        [177, 159,  80],
        ...,
        [235, 242, 200],
        [236, 246, 186],
        [236, 247, 180]],

       [[134, 162, 193],
        [145, 130,  70],
        [232, 212, 135],
        ...,
        [235, 246, 170],
        [235, 244, 188],
        [235, 244, 188]],

       [[127, 115,  67],
        [179, 148,  40],
        [205, 198, 151],
        ...,
        [233, 245, 143],
        [234, 238, 205],
        [237, 242, 202]]], dtype=uint8)]"
Image_1836.jpg,214,40,203,170,900,521,417,210,203,daskShared_local/images/Image_1836.jpg,1836,"[array([[[ 16,  58, 170],
        [ 16,  58, 170],
        [ 16,  58, 170],
        ...,
        [ 31,  68, 183],
        [ 31,  68, 183],
        [ 31,  68, 183]],

       [[ 16,  58, 170],
        [ 16,  58, 170],
        [ 16,  58, 170],
        ...,
        [ 31,  68, 183],
        [ 31,  68, 183],
        [ 31,  68, 183]],

       [[ 16,  58, 170],
        [ 16,  58, 170],
        [ 17,  59, 171],
        ...,
        [ 31,  68, 183],
        [ 31,  68, 183],
        [ 31,  68, 183]],

       ...,

       [[  2,  52, 139],
        [  2,  52, 139],
        [  0,  54, 142],
        ...,
        [207, 224, 216],
        [186, 203, 195],
        [188, 205, 199]],

       [[  2,  52, 139],
        [  2,  52, 139],
        [  0,  54, 142],
        ...,
        [190, 207, 199],
        [161, 178, 170],
        [190, 207, 200]],

       [[  1,  53, 139],
        [  1,  53, 139],
        [  0,  54, 142],
        ...,
        [158, 175, 167],
        [145, 162, 154],
        [192, 209, 203]]], dtype=uint8)]"
Image_1837.jpg,415,1014,824,558,4601,3200,1239,1572,824,daskShared_local/images/Image_1837.jpg,1837,"[array([[[ 29, 160, 236],
        [ 28, 164, 237],
        [ 27, 166, 239],
        ...,
        [ 51, 160, 234],
        [ 51, 161, 234],
        [ 51, 160, 229]],

       [[ 31, 163, 235],
        [ 28, 165, 237],
        [ 24, 162, 230],
        ...,
        [ 48, 155, 228],
        [ 49, 156, 228],
        [ 47, 156, 223]],

       [[ 36, 163, 237],
        [ 35, 167, 244],
        [ 30, 161, 239],
        ...,
        [ 50, 162, 228],
        [ 49, 168, 227],
        [ 48, 167, 225]],

       ...,

       [[ 30, 162, 225],
        [ 31, 165, 231],
        [ 30, 166, 226],
        ...,
        [ 45, 147, 197],
        [ 46, 154, 205],
        [ 42, 150, 189]],

       [[ 31, 159, 220],
        [ 30, 160, 216],
        [ 26, 153, 208],
        ...,
        [ 40, 151, 206],
        [ 40, 154, 205],
        [ 38, 153, 203]],

       [[ 29, 157, 220],
        [ 24, 151, 209],
        [ 27, 151, 208],
        ...,
        [ 39, 154, 209],
        [ 37, 151, 207],
        [ 34, 153, 208]]], dtype=uint8)]"
Image_1838.jpg,390,343,315,205,1904,803,705,548,315,daskShared_local/images/Image_1838.jpg,1838,"[array([[[  4,  53, 109],
        [  2,  51, 107],
        [  2,  51, 107],
        ...,
        [ 46, 159, 155],
        [ 64, 166, 168],
        [101, 170, 173]],

       [[  4,  53, 109],
        [  2,  51, 107],
        [  2,  51, 107],
        ...,
        [ 53, 153, 154],
        [ 84, 174, 178],
        [136, 205, 208]],

       [[  4,  53, 109],
        [  2,  51, 107],
        [  2,  51, 107],
        ...,
        [ 93, 174, 179],
        [140, 211, 221],
        [183, 247, 250]],

       ...,

       [[  6,  20,  96],
        [ 11,  43, 141],
        [  3,  61, 164],
        ...,
        [ 34, 109, 119],
        [  9,  78,  88],
        [ 11,  75,  89]],

       [[ 13,  11,  90],
        [  3,  18, 120],
        [  3,  41, 154],
        ...,
        [  2,  75,  84],
        [  2,  70,  80],
        [  9,  74,  90]],

       [[ 13,   4,  76],
        [ 15,  15, 116],
        [ 19,  41, 155],
        ...,
        [  1,  66,  75],
        [  0,  56,  66],
        [  5,  66,  84]]], dtype=uint8)]"
Image_1839.jpg,692,186,193,142,1000,600,885,328,193,daskShared_local/images/Image_1839.jpg,1839,"[array([[[  3, 155, 202],
        [  2, 157, 203],
        [  0, 157, 202],
        ...,
        [  2, 145, 205],
        [  2, 145, 205],
        [  2, 145, 205]],

       [[  1, 156, 202],
        [  1, 158, 203],
        [  0, 157, 202],
        ...,
        [  3, 146, 206],
        [  2, 145, 205],
        [  1, 144, 204]],

       [[  1, 156, 202],
        [  1, 158, 203],
        [  0, 158, 203],
        ...,
        [  3, 146, 206],
        [  2, 145, 205],
        [  2, 145, 205]],

       ...,

       [[ 22,   2,   0],
        [ 30,   7,   2],
        [ 55,  32,  24],
        ...,
        [130, 145,  42],
        [148, 162,  64],
        [145, 154,  89]],

       [[ 50,  34,   1],
        [ 40,  29,   1],
        [ 61,  52,   7],
        ...,
        [160, 163, 109],
        [156, 157, 117],
        [166, 165, 135]],

       [[ 47,  32,   0],
        [ 89,  77,  35],
        [159, 151, 104],
        ...,
        [192, 193, 149],
        [193, 192, 162],
        [189, 187, 166]]], dtype=uint8)]"
Image_184.jpg,615,225,379,400,1600,1070,994,625,400,daskShared_local/images/Image_184.jpg,184,"[array([[[ 24,  75, 141],
        [ 22,  76, 141],
        [ 21,  76, 141],
        ...,
        [ 28,  69, 133],
        [ 28,  69, 133],
        [ 28,  69, 133]],

       [[ 24,  75, 141],
        [ 22,  76, 141],
        [ 21,  76, 141],
        ...,
        [ 28,  69, 133],
        [ 28,  69, 133],
        [ 28,  69, 133]],

       [[ 24,  75, 141],
        [ 22,  76, 141],
        [ 21,  76, 141],
        ...,
        [ 28,  69, 133],
        [ 28,  69, 133],
        [ 28,  69, 133]],

       ...,

       [[136, 137, 123],
        [153, 151, 133],
        [171, 161, 143],
        ...,
        [102,  75,  41],
        [126,  98,  60],
        [164, 137,  98]],

       [[119, 130, 118],
        [132, 140, 127],
        [157, 157, 146],
        ...,
        [201, 167, 130],
        [215, 181, 145],
        [215, 183, 150]],

       [[135, 148, 145],
        [130, 140, 133],
        [137, 141, 132],
        ...,
        [209, 168, 144],
        [217, 180, 155],
        [196, 165, 142]]], dtype=uint8)]"
Image_1840.jpg,104,264,166,112,900,600,270,376,166,daskShared_local/images/Image_1840.jpg,1840,"[array([[[  0,  83,  85],
        [  3,  84,  87],
        [  2,  81,  85],
        ...,
        [  1,  90, 106],
        [  0,  90, 105],
        [  0,  91, 106]],

       [[  0,  80,  86],
        [  2,  80,  86],
        [  2,  78,  84],
        ...,
        [  0,  92, 107],
        [  0,  92, 107],
        [  0,  92, 107]],

       [[  0,  75,  85],
        [  1,  75,  86],
        [  2,  74,  84],
        ...,
        [  0,  93, 108],
        [  1,  94, 109],
        [  2,  95, 110]],

       ...,

       [[  0,  68,  77],
        [  0,  68,  77],
        [  1,  69,  78],
        ...,
        [ 17,  52,  46],
        [ 17,  52,  46],
        [ 16,  48,  43]],

       [[  0,  67,  76],
        [  0,  67,  76],
        [  0,  67,  76],
        ...,
        [ 16,  51,  45],
        [ 18,  52,  47],
        [ 18,  50,  45]],

       [[  0,  66,  75],
        [  0,  66,  75],
        [  0,  66,  75],
        ...,
        [ 16,  51,  45],
        [ 19,  53,  47],
        [ 19,  51,  46]]], dtype=uint8)]"
Image_1841.jpg,271,205,183,117,1000,667,454,322,183,daskShared_local/images/Image_1841.jpg,1841,"[array([[[  0,  67, 174],
        [  0,  67, 171],
        [  0,  67, 171],
        ...,
        [  2,  50, 133],
        [  2,  49, 131],
        [  2,  49, 131]],

       [[  3,  67, 168],
        [  1,  66, 168],
        [  1,  66, 168],
        ...,
        [  1,  47, 133],
        [  2,  48, 133],
        [  1,  49, 133]],

       [[  1,  65, 166],
        [  1,  65, 170],
        [  2,  65, 170],
        ...,
        [  0,  46, 131],
        [  0,  47, 130],
        [  1,  47, 132]],

       ...,

       [[ 78, 129, 122],
        [ 81, 136, 126],
        [ 85, 141, 127],
        ...,
        [158, 158, 100],
        [155, 152,  96],
        [177, 178, 128]],

       [[ 88, 138, 124],
        [ 88, 139, 121],
        [ 84, 135, 122],
        ...,
        [182, 182, 119],
        [177, 179, 119],
        [184, 188, 136]],

       [[ 91, 136, 106],
        [ 97, 136, 112],
        [ 91, 136, 121],
        ...,
        [195, 195, 136],
        [188, 196, 131],
        [188, 193, 139]]], dtype=uint8)]"
Image_1842.jpg,581,82,228,169,1068,601,809,251,228,daskShared_local/images/Image_1842.jpg,1842,"[array([[[  0,  72, 255],
        [  0,  72, 255],
        [  0,  72, 255],
        ...,
        [  0,  85, 254],
        [  0,  85, 254],
        [  0,  84, 253]],

       [[  0,  72, 255],
        [  0,  72, 255],
        [  0,  72, 255],
        ...,
        [  0,  86, 254],
        [  0,  86, 254],
        [  0,  85, 253]],

       [[  0,  72, 255],
        [  0,  72, 255],
        [  0,  72, 255],
        ...,
        [  0,  86, 254],
        [  0,  86, 254],
        [  0,  86, 254]],

       ...,

       [[209, 185, 155],
        [202, 175, 153],
        [168, 142, 110],
        ...,
        [209, 222, 231],
        [208, 222, 222],
        [212, 224, 219]],

       [[207, 186, 153],
        [219, 195, 161],
        [207, 182, 139],
        ...,
        [208, 221, 233],
        [207, 221, 223],
        [213, 225, 218]],

       [[109,  94,  60],
        [211, 192, 150],
        [218, 194, 149],
        ...,
        [205, 218, 231],
        [210, 224, 226],
        [211, 223, 214]]], dtype=uint8)]"
Image_1843.jpg,517,83,142,188,1200,630,659,271,188,daskShared_local/images/Image_1843.jpg,1843,"[array([[[  2, 155, 222],
        [  2, 155, 222],
        [  4, 156, 223],
        ...,
        [  3, 155, 222],
        [  3, 155, 222],
        [  3, 155, 222]],

       [[  2, 155, 222],
        [  2, 155, 222],
        [  4, 156, 223],
        ...,
        [  3, 155, 222],
        [  3, 155, 222],
        [  3, 155, 222]],

       [[  1, 154, 221],
        [  1, 154, 221],
        [  3, 155, 222],
        ...,
        [  2, 154, 221],
        [  3, 155, 222],
        [  3, 155, 222]],

       ...,

       [[ 33,  26,  20],
        [ 26,  19,  13],
        [ 32,  19,  18],
        ...,
        [  0,  81, 119],
        [  2,  84, 122],
        [  1,  83, 121]],

       [[ 32,  24,  21],
        [ 29,  21,  18],
        [ 33,  20,  20],
        ...,
        [  0,  80, 118],
        [  2,  84, 122],
        [  1,  83, 121]],

       [[ 28,  19,  20],
        [ 30,  22,  20],
        [ 29,  18,  17],
        ...,
        [  2,  81, 120],
        [  1,  80, 119],
        [  0,  79, 118]]], dtype=uint8)]"
Image_1844.jpg,362,26,152,125,550,380,514,151,152,daskShared_local/images/Image_1844.jpg,1844,"[array([[[ 74,  93, 149],
        [ 74,  93, 149],
        [ 74,  93, 149],
        ...,
        [ 69,  85, 144],
        [ 68,  83, 142],
        [ 69,  84, 143]],

       [[ 75,  94, 150],
        [ 75,  94, 150],
        [ 75,  94, 150],
        ...,
        [ 69,  85, 144],
        [ 68,  83, 142],
        [ 69,  84, 143]],

       [[ 75,  94, 150],
        [ 75,  94, 150],
        [ 75,  94, 150],
        ...,
        [ 69,  85, 144],
        [ 68,  83, 142],
        [ 69,  84, 143]],

       ...,

       [[196, 182, 140],
        [184, 170, 131],
        [176, 161, 129],
        ...,
        [ 65,  78, 139],
        [ 66,  77, 139],
        [ 66,  77, 139]],

       [[198, 184, 144],
        [179, 166, 130],
        [172, 158, 128],
        ...,
        [ 65,  77, 139],
        [ 65,  76, 138],
        [ 66,  77, 139]],

       [[208, 195, 156],
        [193, 179, 145],
        [184, 170, 143],
        ...,
        [ 65,  77, 139],
        [ 65,  76, 138],
        [ 65,  76, 138]]], dtype=uint8)]"
Image_1845.jpg,1188,1051,463,409,2592,1944,1651,1460,463,daskShared_local/images/Image_1845.jpg,1845,"[array([[[140, 110,  66],
        [166, 135,  89],
        [152, 121,  80],
        ...,
        [ 45, 116, 172],
        [ 45, 116, 172],
        [ 45, 114, 171]],

       [[163, 133, 104],
        [150, 123,  95],
        [142, 117,  92],
        ...,
        [ 43, 115, 171],
        [ 43, 114, 170],
        [ 45, 114, 171]],

       [[173, 148, 138],
        [151, 131, 121],
        [128, 108,  94],
        ...,
        [ 44, 115, 171],
        [ 43, 114, 170],
        [ 45, 117, 172]],

       ...,

       [[ 39, 123, 169],
        [ 41, 123, 170],
        [ 40, 121, 168],
        ...,
        [ 36, 126, 164],
        [ 36, 124, 165],
        [ 36, 123, 167]],

       [[ 38, 124, 169],
        [ 41, 124, 171],
        [ 40, 122, 169],
        ...,
        [ 36, 125, 167],
        [ 37, 124, 169],
        [ 38, 127, 169]],

       [[ 36, 123, 168],
        [ 43, 128, 173],
        [ 40, 122, 169],
        ...,
        [ 36, 123, 168],
        [ 36, 122, 170],
        [ 37, 124, 167]]], dtype=uint8)]"
Image_1846.jpg,124,163,355,263,1152,768,479,426,355,daskShared_local/images/Image_1846.jpg,1846,"[array([[[183, 234, 225],
        [186, 236, 227],
        [188, 236, 226],
        ...,
        [148, 224, 220],
        [148, 223, 219],
        [147, 223, 219]],

       [[184, 235, 225],
        [187, 237, 227],
        [185, 236, 224],
        ...,
        [144, 219, 218],
        [144, 219, 218],
        [144, 219, 218]],

       [[186, 236, 224],
        [187, 237, 225],
        [187, 237, 226],
        ...,
        [142, 221, 216],
        [142, 221, 216],
        [142, 221, 216]],

       ...,

       [[100, 180, 187],
        [ 99, 178, 185],
        [ 99, 178, 185],
        ...,
        [101, 129, 140],
        [ 96, 120, 132],
        [118, 143, 157]],

       [[101, 183, 189],
        [101, 181, 188],
        [100, 180, 187],
        ...,
        [ 77, 104, 113],
        [ 77, 104, 115],
        [101, 130, 143]],

       [[102, 185, 193],
        [103, 183, 192],
        [101, 181, 188],
        ...,
        [ 84, 108, 114],
        [ 75, 101, 109],
        [ 85, 117, 127]]], dtype=uint8)]"
Image_1847.jpg,965,0,2569,2746,4608,3072,3534,2746,2746,daskShared_local/images/Image_1847.jpg,1847,"[array([[[ 37,  39,  39],
        [ 38,  41,  42],
        [ 43,  47,  48],
        ...,
        [176, 171, 127],
        [176, 170, 125],
        [175, 169, 124]],

       [[ 40,  41,  41],
        [ 43,  45,  45],
        [ 47,  50,  52],
        ...,
        [176, 170, 126],
        [175, 170, 125],
        [175, 169, 123]],

       [[ 43,  44,  44],
        [ 46,  47,  47],
        [ 49,  50,  51],
        ...,
        [175, 169, 124],
        [175, 169, 124],
        [175, 168, 123]],

       ...,

       [[ 98,  81,  50],
        [ 99,  81,  52],
        [ 98,  81,  51],
        ...,
        [149, 114,  62],
        [135, 103,  68],
        [126, 107,  83]],

       [[ 95,  78,  47],
        [ 96,  79,  50],
        [ 97,  80,  50],
        ...,
        [164, 145,  79],
        [163, 138,  69],
        [163, 133,  76]],

       [[ 93,  75,  44],
        [ 93,  76,  48],
        [ 94,  77,  50],
        ...,
        [141, 130, 103],
        [142, 134, 106],
        [152, 140, 100]]], dtype=uint8)]"
Image_1848.jpg,517,82,295,444,1600,900,812,526,444,daskShared_local/images/Image_1848.jpg,1848,"[array([[[  0, 153, 210],
        [  0, 153, 210],
        [  0, 154, 208],
        ...,
        [156, 201, 242],
        [156, 201, 242],
        [155, 200, 241]],

       [[  0, 153, 209],
        [  0, 153, 210],
        [  0, 154, 208],
        ...,
        [155, 200, 242],
        [156, 201, 242],
        [156, 201, 242]],

       [[  0, 154, 208],
        [  0, 154, 208],
        [  0, 154, 208],
        ...,
        [154, 199, 241],
        [155, 200, 242],
        [157, 202, 243]],

       ...,

       [[  0, 138, 201],
        [  1, 139, 202],
        [  1, 140, 202],
        ...,
        [ 75,  73,  70],
        [116,  99,  89],
        [133, 103,  80]],

       [[  0, 138, 201],
        [  1, 139, 202],
        [  1, 140, 202],
        ...,
        [109,  99,  86],
        [134, 111,  94],
        [153, 120,  93]],

       [[  0, 138, 201],
        [  1, 139, 202],
        [  1, 140, 202],
        ...,
        [120, 106,  86],
        [136, 114,  93],
        [144, 116,  92]]], dtype=uint8)]"
Image_1849.jpg,944,388,224,198,2000,1000,1168,586,224,daskShared_local/images/Image_1849.jpg,1849,"[array([[[199, 181, 145],
        [207, 189, 153],
        [209, 190, 155],
        ...,
        [213, 193, 159],
        [215, 193, 159],
        [215, 191, 158]],

       [[193, 172, 143],
        [195, 177, 146],
        [200, 185, 151],
        ...,
        [207, 190, 155],
        [208, 191, 158],
        [213, 195, 165]],

       [[193, 172, 141],
        [191, 172, 139],
        [196, 180, 144],
        ...,
        [207, 188, 153],
        [209, 190, 156],
        [212, 193, 160]],

       ...,

       [[100,  98,  86],
        [ 93,  91,  81],
        [ 79,  78,  73],
        ...,
        [202, 173, 135],
        [214, 185, 148],
        [201, 172, 136]],

       [[120, 118, 104],
        [105, 103,  93],
        [ 86,  85,  81],
        ...,
        [202, 170, 135],
        [207, 174, 139],
        [202, 171, 133]],

       [[113, 111,  96],
        [ 93,  92,  81],
        [ 77,  76,  73],
        ...,
        [206, 177, 143],
        [198, 170, 133],
        [198, 170, 131]]], dtype=uint8)]"
Image_185.jpg,1883,617,1205,1166,4752,3168,3088,1783,1205,daskShared_local/images/Image_185.jpg,185,"[array([[[ 70,  65,  38],
        [ 71,  67,  41],
        [ 74,  72,  43],
        ...,
        [ 53, 125, 149],
        [ 52, 124, 148],
        [ 54, 124, 149]],

       [[ 67,  61,  33],
        [ 71,  64,  38],
        [ 74,  67,  39],
        ...,
        [ 50, 121, 148],
        [ 50, 121, 148],
        [ 51, 122, 149]],

       [[ 70,  62,  35],
        [ 73,  66,  39],
        [ 76,  69,  39],
        ...,
        [ 43, 117, 147],
        [ 45, 118, 149],
        [ 45, 118, 149]],

       ...,

       [[  8,  96, 141],
        [  6,  97, 141],
        [  3,  96, 140],
        ...,
        [120,  97,  74],
        [100,  82,  69],
        [ 76,  62,  60]],

       [[ 12,  97, 141],
        [ 10,  97, 141],
        [  9,  98, 141],
        ...,
        [143, 124,  96],
        [109,  93,  78],
        [ 76,  64,  59]],

       [[ 15, 100, 141],
        [ 20, 100, 142],
        [ 19, 101, 142],
        ...,
        [161, 149, 117],
        [113, 100,  85],
        [ 82,  67,  61]]], dtype=uint8)]"
Image_1850.jpg,422,154,235,181,1000,667,657,335,235,daskShared_local/images/Image_1850.jpg,1850,"[array([[[ 21, 173, 249],
        [ 22, 172, 250],
        [ 26, 174, 251],
        ...,
        [  0, 143, 223],
        [  1, 142, 222],
        [  0, 141, 224]],

       [[ 25, 174, 251],
        [ 26, 173, 251],
        [ 23, 172, 251],
        ...,
        [  0, 141, 221],
        [  0, 140, 221],
        [  0, 141, 221]],

       [[ 30, 176, 253],
        [ 34, 178, 251],
        [ 33, 177, 251],
        ...,
        [  0, 139, 220],
        [  1, 139, 220],
        [  0, 140, 222]],

       ...,

       [[196, 179, 131],
        [214, 202, 157],
        [221, 208, 154],
        ...,
        [  1,  61, 105],
        [  0,  61, 105],
        [  0,  61, 105]],

       [[184, 163, 117],
        [187, 169, 119],
        [203, 185, 127],
        ...,
        [  1,  61, 105],
        [  1,  60, 104],
        [  0,  60, 105]],

       [[178, 157, 112],
        [187, 169, 118],
        [190, 174, 115],
        ...,
        [  0,  61, 104],
        [  0,  61, 104],
        [  0,  59, 102]]], dtype=uint8)]"
Image_1851.jpg,426,154,705,605,1152,763,1131,759,705,daskShared_local/images/Image_1851.jpg,1851,"[array([[[  1, 182, 237],
        [  1, 182, 237],
        [  2, 181, 237],
        ...,
        [  0, 183, 237],
        [  0, 183, 237],
        [  0, 184, 237]],

       [[  0, 183, 237],
        [  1, 182, 237],
        [  2, 181, 237],
        ...,
        [  0, 183, 237],
        [  0, 183, 237],
        [  0, 183, 237]],

       [[  1, 182, 237],
        [  2, 181, 237],
        [  2, 181, 237],
        ...,
        [  0, 183, 237],
        [  0, 184, 238],
        [  0, 183, 237]],

       ...,

       [[156, 179, 155],
        [156, 179, 156],
        [157, 180, 157],
        ...,
        [165, 192, 179],
        [144, 163, 148],
        [157, 173, 135]],

       [[159, 182, 159],
        [159, 182, 159],
        [159, 182, 159],
        ...,
        [180, 193, 179],
        [170, 195, 178],
        [153, 182, 173]],

       [[159, 183, 161],
        [159, 183, 161],
        [159, 183, 159],
        ...,
        [196, 213, 220],
        [166, 189, 186],
        [183, 196, 178]]], dtype=uint8)]"
Image_1852.jpg,539,234,158,191,990,681,697,425,191,daskShared_local/images/Image_1852.jpg,1852,"[array([[[ 42,  38,  26],
        [ 40,  37,  22],
        [ 37,  34,  19],
        ...,
        [ 33,  25,  15],
        [ 27,  19,   8],
        [ 29,  17,   3]],

       [[ 40,  36,  24],
        [ 40,  37,  22],
        [ 39,  36,  21],
        ...,
        [ 36,  30,  16],
        [ 35,  27,  12],
        [ 37,  26,   8]],

       [[ 36,  32,  20],
        [ 37,  34,  19],
        [ 37,  34,  19],
        ...,
        [ 41,  36,  17],
        [ 37,  31,   9],
        [ 40,  29,   7]],

       ...,

       [[131, 124,  88],
        [126, 118,  81],
        [130, 122,  83],
        ...,
        [ 49,  55,  41],
        [ 49,  56,  40],
        [ 53,  58,  43]],

       [[120, 114,  78],
        [123, 118,  81],
        [131, 126,  86],
        ...,
        [ 44,  50,  36],
        [ 44,  51,  35],
        [ 48,  55,  39]],

       [[174, 168, 134],
        [170, 165, 127],
        [133, 128,  88],
        ...,
        [ 38,  44,  30],
        [ 41,  48,  32],
        [ 45,  52,  36]]], dtype=uint8)]"
Image_1853.jpg,502,167,93,72,660,438,595,239,93,daskShared_local/images/Image_1853.jpg,1853,"[array([[[  3,  24,  62],
        [  3,  24,  62],
        [  2,  22,  60],
        ...,
        [  8,  32,  71],
        [  9,  32,  72],
        [  9,  32,  72]],

       [[  3,  24,  62],
        [  3,  24,  63],
        [  2,  22,  60],
        ...,
        [  8,  32,  72],
        [  8,  32,  72],
        [  8,  32,  72]],

       [[  4,  24,  62],
        [  4,  25,  62],
        [  2,  23,  59],
        ...,
        [  8,  33,  70],
        [  9,  33,  72],
        [  9,  33,  72]],

       ...,

       [[211, 161, 114],
        [210, 159, 112],
        [217, 173, 130],
        ...,
        [ 36,  31,  59],
        [ 42,  35,  64],
        [ 41,  35,  63]],

       [[162, 100,  68],
        [161,  98,  66],
        [169, 111,  80],
        ...,
        [ 38,  32,  57],
        [ 41,  34,  59],
        [ 41,  33,  59]],

       [[168, 107,  74],
        [167, 106,  72],
        [175, 119,  86],
        ...,
        [ 38,  32,  57],
        [ 41,  34,  59],
        [ 41,  34,  59]]], dtype=uint8)]"
Image_1854.jpg,386,165,117,119,900,600,503,284,119,daskShared_local/images/Image_1854.jpg,1854,"[array([[[ 25, 113, 179],
        [ 27, 114, 180],
        [ 31, 118, 185],
        ...,
        [ 10,  88, 158],
        [  5,  84, 154],
        [  3,  82, 153]],

       [[ 32, 113, 176],
        [ 33, 114, 178],
        [ 37, 118, 182],
        ...,
        [  7,  84, 155],
        [  4,  80, 152],
        [  3,  79, 151]],

       [[ 53, 113, 168],
        [ 53, 114, 169],
        [ 55, 117, 174],
        ...,
        [  0,  72, 146],
        [  2,  70, 144],
        [  2,  70, 144]],

       ...,

       [[  2,  80, 164],
        [  1,  81, 164],
        [  0,  82, 166],
        ...,
        [121,  89, 112],
        [131,  99, 122],
        [135, 103, 126]],

       [[  1,  80, 165],
        [  0,  80, 165],
        [  0,  81, 167],
        ...,
        [124,  92, 114],
        [129,  97, 119],
        [130,  98, 120]],

       [[  0,  80, 165],
        [  0,  80, 165],
        [  0,  80, 167],
        ...,
        [125,  93, 114],
        [128,  96, 117],
        [129,  97, 118]]], dtype=uint8)]"
Image_1855.jpg,405,132,127,88,759,422,532,220,127,daskShared_local/images/Image_1855.jpg,1855,"[array([[[103, 178, 184],
        [109, 184, 189],
        [119, 193, 199],
        ...,
        [ 51, 153, 167],
        [ 53, 159, 173],
        [ 54, 162, 175]],

       [[105, 180, 186],
        [111, 186, 191],
        [120, 195, 200],
        ...,
        [ 49, 152, 166],
        [ 53, 160, 174],
        [ 54, 163, 176]],

       [[108, 183, 189],
        [113, 188, 194],
        [123, 197, 202],
        ...,
        [ 46, 152, 166],
        [ 52, 162, 176],
        [ 54, 166, 180]],

       ...,

       [[  1, 151, 186],
        [  1, 151, 186],
        [  1, 151, 186],
        ...,
        [  1, 133, 154],
        [  1, 132, 153],
        [  0, 131, 152]],

       [[  2, 152, 187],
        [  2, 152, 187],
        [  2, 152, 187],
        ...,
        [  1, 134, 154],
        [  0, 132, 152],
        [  0, 132, 152]],

       [[  2, 152, 187],
        [  2, 152, 187],
        [  2, 152, 187],
        ...,
        [  1, 134, 153],
        [  0, 133, 152],
        [  0, 132, 152]]], dtype=uint8)]"
Image_1856.jpg,475,162,226,269,981,650,701,431,269,daskShared_local/images/Image_1856.jpg,1856,"[array([[[244, 244, 244],
        [244, 244, 244],
        [244, 244, 244],
        ...,
        [242, 242, 242],
        [242, 242, 242],
        [242, 242, 242]],

       [[244, 244, 244],
        [244, 244, 244],
        [244, 244, 244],
        ...,
        [242, 242, 244],
        [242, 242, 242],
        [242, 242, 242]],

       [[244, 244, 244],
        [244, 244, 244],
        [244, 244, 244],
        ...,
        [243, 241, 242],
        [242, 242, 240],
        [242, 242, 242]],

       ...,

       [[ 26,  93, 174],
        [ 27,  94, 174],
        [ 27,  94, 172],
        ...,
        [ 21,  89, 170],
        [ 21,  89, 174],
        [ 22,  90, 173]],

       [[ 26,  93, 174],
        [ 27,  94, 173],
        [ 25,  92, 170],
        ...,
        [ 21,  89, 171],
        [ 20,  87, 172],
        [ 20,  88, 171]],

       [[ 25,  92, 173],
        [ 27,  94, 174],
        [ 27,  94, 172],
        ...,
        [ 22,  90, 172],
        [ 17,  84, 171],
        [ 18,  86, 171]]], dtype=uint8)]"
Image_1857.jpg,412,308,228,210,1500,1000,640,518,228,daskShared_local/images/Image_1857.jpg,1857,"[array([[[  2, 134, 157],
        [  3, 135, 158],
        [  3, 134, 158],
        ...,
        [  5, 117, 137],
        [  6, 119, 137],
        [  7, 118, 137]],

       [[  0, 135, 157],
        [  0, 135, 157],
        [  0, 135, 157],
        ...,
        [  0, 113, 132],
        [  1, 116, 134],
        [  2, 116, 134]],

       [[  0, 136, 157],
        [  0, 135, 156],
        [  0, 133, 155],
        ...,
        [  0, 113, 131],
        [  0, 113, 131],
        [  0, 112, 130]],

       ...,

       [[ 43,  93,  79],
        [ 29,  80,  68],
        [ 27,  79,  68],
        ...,
        [161, 151,  82],
        [179, 170,  99],
        [228, 219, 146]],

       [[103, 142, 118],
        [ 77, 118,  95],
        [ 67, 108,  87],
        ...,
        [164, 155,  92],
        [148, 139,  75],
        [185, 177, 111]],

       [[160, 188, 155],
        [136, 166, 136],
        [118, 150, 120],
        ...,
        [176, 167, 112],
        [150, 141,  84],
        [106,  97,  38]]], dtype=uint8)]"
Image_1858.jpg,1288,646,184,136,2304,1536,1472,782,184,daskShared_local/images/Image_1858.jpg,1858,"[array([[[  0, 106, 148],
        [  0, 106, 148],
        [  0, 106, 148],
        ...,
        [  3, 107, 146],
        [  3, 107, 146],
        [  1, 105, 144]],

       [[  2, 108, 150],
        [  1, 107, 149],
        [  1, 107, 149],
        ...,
        [  3, 107, 146],
        [  3, 107, 146],
        [  1, 105, 144]],

       [[  4, 105, 155],
        [  3, 105, 155],
        [  1, 105, 154],
        ...,
        [  2, 105, 144],
        [  2, 104, 144],
        [  2, 104, 144]],

       ...,

       [[136, 182, 150],
        [134, 178, 146],
        [160, 201, 178],
        ...,
        [ 24,  19,  61],
        [ 30,  23,  43],
        [ 33,  31,  29]],

       [[159, 199, 169],
        [169, 207, 182],
        [177, 213, 198],
        ...,
        [ 29,  29,  61],
        [ 31,  27,  45],
        [ 32,  26,  35]],

       [[182, 215, 198],
        [178, 210, 200],
        [178, 212, 210],
        ...,
        [ 30,  36,  59],
        [ 36,  31,  50],
        [ 34,  18,  36]]], dtype=uint8)]"
Image_1859.jpg,192,107,349,264,1024,670,541,371,349,daskShared_local/images/Image_1859.jpg,1859,"[array([[[ 37,  47,  51],
        [ 33,  44,  51],
        [ 25,  38,  51],
        ...,
        [ 20,  85, 106],
        [  6,  69,  86],
        [ 15,  76,  88]],

       [[ 24,  33,  40],
        [ 23,  36,  46],
        [ 30,  43,  58],
        ...,
        [ 29,  97, 120],
        [ 11,  75,  96],
        [ 28,  87, 106]],

       [[ 29,  38,  48],
        [ 25,  37,  50],
        [ 33,  48,  64],
        ...,
        [ 53, 129, 149],
        [ 38, 106, 127],
        [ 34,  94, 114]],

       ...,

       [[ 23,  25,  52],
        [ 11,  28,  89],
        [  2,  50, 113],
        ...,
        [ 86, 196, 219],
        [107, 217, 238],
        [ 94, 198, 218]],

       [[ 21,  55,  78],
        [ 18,  64, 112],
        [ 50, 121, 163],
        ...,
        [132, 216, 232],
        [146, 217, 227],
        [168, 219, 220]],

       [[ 45, 146, 152],
        [ 47, 149, 173],
        [ 42, 154, 166],
        ...,
        [ 96, 191, 205],
        [152, 226, 230],
        [187, 229, 226]]], dtype=uint8)]"
Image_186.jpg,430,139,220,217,1024,686,650,356,220,daskShared_local/images/Image_186.jpg,186,"[array([[[ 31, 186, 240],
        [ 29, 186, 240],
        [ 16, 183, 236],
        ...,
        [  0, 158, 219],
        [  0, 156, 217],
        [  0, 156, 217]],

       [[ 33, 187, 241],
        [ 32, 187, 241],
        [ 23, 183, 237],
        ...,
        [  0, 157, 218],
        [  0, 156, 217],
        [  0, 156, 217]],

       [[ 30, 184, 238],
        [ 30, 184, 238],
        [ 28, 184, 239],
        ...,
        [  1, 156, 218],
        [  0, 156, 217],
        [  0, 156, 217]],

       ...,

       [[189, 186, 190],
        [185, 180, 183],
        [191, 177, 173],
        ...,
        [  2, 115, 183],
        [  2, 113, 182],
        [  2, 113, 182]],

       [[197, 196, 201],
        [203, 201, 204],
        [205, 192, 190],
        ...,
        [  1, 114, 182],
        [  2, 113, 182],
        [  2, 113, 182]],

       [[209, 207, 208],
        [216, 214, 216],
        [201, 192, 195],
        ...,
        [  1, 114, 182],
        [  3, 114, 183],
        [  2, 113, 182]]], dtype=uint8)]"
Image_1860.jpg,250,219,130,142,775,518,380,361,142,daskShared_local/images/Image_1860.jpg,1860,"[array([[[215, 200, 187],
        [200, 183, 171],
        [187, 167, 155],
        ...,
        [119,  86,  55],
        [113,  79,  41],
        [115,  81,  44]],

       [[199, 183, 169],
        [188, 169, 156],
        [173, 152, 139],
        ...,
        [128,  96,  64],
        [120,  86,  48],
        [118,  84,  47]],

       [[180, 161, 146],
        [173, 152, 137],
        [159, 135, 121],
        ...,
        [133, 101,  69],
        [131,  97,  59],
        [129,  95,  57]],

       ...,

       [[139, 106,  56],
        [158, 125,  75],
        [175, 143,  95],
        ...,
        [205, 165, 128],
        [205, 166, 130],
        [209, 170, 134]],

       [[143, 111,  60],
        [159, 127,  77],
        [174, 142,  94],
        ...,
        [192, 151, 114],
        [189, 149, 114],
        [196, 156, 120]],

       [[152, 119,  68],
        [164, 132,  82],
        [175, 143,  95],
        ...,
        [180, 138, 102],
        [176, 136, 100],
        [182, 142, 107]]], dtype=uint8)]"
Image_1861.jpg,313,290,177,144,966,642,490,434,177,daskShared_local/images/Image_1861.jpg,1861,"[array([[[ 40,  73,  49],
        [ 64,  86,  57],
        [111, 123,  91],
        ...,
        [ 29,  53,  63],
        [ 50,  66,  86],
        [ 38,  57,  74]],

       [[ 71, 102,  93],
        [ 72,  97,  77],
        [ 85, 102,  79],
        ...,
        [ 23,  52,  60],
        [ 29,  48,  62],
        [ 21,  42,  54]],

       [[ 73,  99,  83],
        [ 94, 119,  92],
        [ 98, 122,  93],
        ...,
        [ 10,  37,  49],
        [  9,  37,  48],
        [ 16,  34,  46]],

       ...,

       [[ 13, 199, 207],
        [ 19, 201, 210],
        [ 24, 200, 211],
        ...,
        [ 59, 229, 240],
        [ 53, 228, 237],
        [ 55, 231, 239]],

       [[ 14, 198, 206],
        [ 23, 204, 213],
        [ 33, 209, 219],
        ...,
        [ 67, 235, 246],
        [ 58, 230, 240],
        [ 58, 232, 241]],

       [[ 18, 199, 208],
        [ 25, 204, 214],
        [ 33, 208, 219],
        ...,
        [ 73, 240, 251],
        [ 68, 237, 247],
        [ 66, 237, 247]]], dtype=uint8)]"
Image_1862.jpg,732,347,177,172,1600,1000,909,519,177,daskShared_local/images/Image_1862.jpg,1862,"[array([[[  0,  79, 161],
        [  0,  79, 161],
        [  0,  79, 161],
        ...,
        [  1,  77, 161],
        [  1,  77, 161],
        [  1,  77, 161]],

       [[  0,  79, 161],
        [  0,  79, 161],
        [  0,  79, 161],
        ...,
        [  1,  77, 161],
        [  1,  77, 161],
        [  1,  77, 161]],

       [[  0,  79, 161],
        [  0,  79, 161],
        [  0,  79, 161],
        ...,
        [  1,  77, 161],
        [  1,  77, 161],
        [  1,  77, 161]],

       ...,

       [[166, 189, 176],
        [187, 219, 203],
        [173, 213, 196],
        ...,
        [229, 211, 195],
        [227, 204, 186],
        [237, 209, 188]],

       [[187, 209, 197],
        [184, 212, 198],
        [156, 190, 173],
        ...,
        [232, 213, 196],
        [225, 201, 182],
        [225, 195, 174]],

       [[169, 190, 180],
        [186, 208, 197],
        [174, 198, 185],
        ...,
        [244, 224, 208],
        [238, 215, 193],
        [237, 208, 184]]], dtype=uint8)]"
Image_1863.jpg,415,323,123,128,800,600,538,451,128,daskShared_local/images/Image_1863.jpg,1863,"[array([[[219, 211, 186],
        [214, 207, 184],
        [200, 194, 174],
        ...,
        [  5,  91, 102],
        [  6,  92, 102],
        [  6,  92, 102]],

       [[219, 215, 189],
        [215, 211, 186],
        [203, 200, 178],
        ...,
        [  5,  90, 101],
        [  6,  91, 102],
        [  6,  91, 102]],

       [[217, 217, 189],
        [215, 216, 188],
        [207, 210, 182],
        ...,
        [  5,  89, 100],
        [  5,  89, 100],
        [  6,  90, 101]],

       ...,

       [[ 37,  53,  53],
        [ 36,  52,  52],
        [ 35,  51,  51],
        ...,
        [ 32,  99,  53],
        [ 35, 105,  51],
        [ 38, 110,  52]],

       [[ 36,  52,  52],
        [ 36,  52,  52],
        [ 35,  51,  51],
        ...,
        [ 33, 103,  61],
        [ 38, 110,  62],
        [ 42, 116,  64]],

       [[ 36,  52,  52],
        [ 36,  52,  52],
        [ 35,  51,  51],
        ...,
        [ 34, 105,  67],
        [ 41, 113,  69],
        [ 45, 119,  72]]], dtype=uint8)]"
Image_1864.jpg,699,305,496,473,1920,1080,1195,778,496,daskShared_local/images/Image_1864.jpg,1864,"[array([[[ 48,  65,  52],
        [ 46,  65,  53],
        [ 42,  66,  53],
        ...,
        [ 45,  70,  71],
        [ 38,  62,  66],
        [ 35,  62,  64]],

       [[ 47,  65,  52],
        [ 46,  69,  56],
        [ 46,  69,  59],
        ...,
        [ 54,  76,  77],
        [ 48,  75,  76],
        [ 33,  67,  66]],

       [[ 44,  66,  53],
        [ 46,  71,  59],
        [ 45,  68,  58],
        ...,
        [ 55,  78,  78],
        [ 40,  74,  73],
        [ 29,  76,  70]],

       ...,

       [[ 28,  95, 147],
        [ 28,  94, 146],
        [ 28,  95, 146],
        ...,
        [ 24,  37,  36],
        [ 22,  34,  33],
        [ 27,  39,  37]],

       [[ 27,  94, 146],
        [ 28,  93, 147],
        [ 28,  95, 143],
        ...,
        [ 18,  34,  34],
        [ 20,  34,  34],
        [ 24,  37,  35]],

       [[ 30,  96, 148],
        [ 28,  94, 147],
        [ 28,  94, 142],
        ...,
        [ 17,  35,  33],
        [ 20,  35,  34],
        [ 17,  32,  29]]], dtype=uint8)]"
Image_1865.jpg,163,180,177,129,728,500,340,309,177,daskShared_local/images/Image_1865.jpg,1865,"[array([[[  1,  71, 219],
        [  1,  71, 219],
        [  1,  71, 218],
        ...,
        [  1,  78, 226],
        [  0,  78, 226],
        [  1,  79, 227]],

       [[  1,  71, 219],
        [  1,  71, 219],
        [  1,  71, 218],
        ...,
        [  0,  78, 226],
        [  0,  78, 226],
        [  1,  80, 225]],

       [[  1,  71, 219],
        [  2,  72, 219],
        [  2,  72, 219],
        ...,
        [  0,  78, 226],
        [  0,  79, 224],
        [  0,  79, 224]],

       ...,

       [[ 22, 142, 147],
        [ 15, 132, 143],
        [ 16, 130, 146],
        ...,
        [245, 242, 212],
        [224, 203, 157],
        [203, 164, 149]],

       [[ 19, 132, 138],
        [ 17, 132, 141],
        [ 18, 135, 143],
        ...,
        [246, 245, 222],
        [229, 214, 175],
        [198, 153, 108]],

       [[ 24, 127, 138],
        [ 26, 133, 143],
        [ 24, 137, 144],
        ...,
        [237, 235, 216],
        [220, 202, 165],
        [204, 161,  99]]], dtype=uint8)]"
Image_1866.jpg,795,335,165,118,1536,1024,960,453,165,daskShared_local/images/Image_1866.jpg,1866,"[array([[[  0,  19,  33],
        [  1,  22,  35],
        [  2,  24,  37],
        ...,
        [ 46, 123, 213],
        [ 46, 123, 213],
        [ 46, 123, 213]],

       [[  4,  23,  37],
        [  3,  25,  38],
        [  3,  25,  38],
        ...,
        [ 46, 123, 213],
        [ 46, 123, 213],
        [ 46, 123, 213]],

       [[ 10,  29,  44],
        [ 10,  30,  43],
        [  8,  30,  42],
        ...,
        [ 46, 123, 213],
        [ 46, 123, 213],
        [ 46, 123, 213]],

       ...,

       [[ 15, 117, 202],
        [ 17, 116, 202],
        [ 19, 114, 201],
        ...,
        [ 11, 114, 205],
        [ 10, 113, 205],
        [ 10, 114, 205]],

       [[ 14, 115, 200],
        [ 17, 115, 201],
        [ 20, 115, 201],
        ...,
        [ 10, 115, 204],
        [  8, 114, 204],
        [  7, 113, 203]],

       [[ 13, 114, 198],
        [ 16, 115, 200],
        [ 19, 116, 202],
        ...,
        [  8, 115, 203],
        [  6, 114, 202],
        [  5, 112, 201]]], dtype=uint8)]"
Image_1867.jpg,1811,2604,486,365,2720,4080,2297,2969,486,daskShared_local/images/Image_1867.jpg,1867,"[array([[[137, 118,  96],
        [110,  97,  85],
        [ 68,  64,  55],
        ...,
        [  2, 120, 191],
        [  9, 126, 198],
        [  4, 119, 192]],

       [[166, 149, 125],
        [128, 117, 102],
        [ 90,  86,  75],
        ...,
        [  4, 121, 192],
        [  2, 117, 189],
        [  9, 125, 198]],

       [[183, 169, 145],
        [149, 140, 123],
        [146, 145, 130],
        ...,
        [ 10, 128, 199],
        [  4, 120, 192],
        [  6, 122, 194]],

       ...,

       [[  6, 116, 190],
        [  4, 114, 188],
        [  4, 112, 186],
        ...,
        [  4, 115, 191],
        [  7, 118, 194],
        [  3, 110, 185]],

       [[  3, 112, 186],
        [  8, 117, 191],
        [  5, 116, 190],
        ...,
        [  5, 115, 190],
        [  2, 110, 185],
        [  5, 115, 190]],

       [[  5, 115, 189],
        [  4, 113, 187],
        [  3, 113, 187],
        ...,
        [  4, 114, 189],
        [  5, 114, 189],
        [  7, 117, 192]]], dtype=uint8)]"
Image_1868.jpg,80,91,117,121,637,450,197,212,121,daskShared_local/images/Image_1868.jpg,1868,"[array([[[  0, 169, 254],
        [  0, 169, 254],
        [  0, 169, 254],
        ...,
        [  0, 169, 252],
        [  0, 169, 253],
        [  0, 169, 253]],

       [[  1, 169, 254],
        [  1, 169, 254],
        [  1, 169, 254],
        ...,
        [  0, 169, 252],
        [  0, 169, 253],
        [  0, 168, 253]],

       [[  2, 168, 254],
        [  2, 168, 254],
        [  2, 168, 254],
        ...,
        [  0, 169, 252],
        [  1, 168, 253],
        [  1, 167, 253]],

       ...,

       [[  3, 179, 255],
        [  3, 180, 255],
        [  4, 181, 255],
        ...,
        [115, 145, 119],
        [107, 134, 111],
        [104, 130, 108]],

       [[  4, 180, 255],
        [  4, 180, 255],
        [  5, 182, 255],
        ...,
        [105, 139, 114],
        [ 94, 127, 104],
        [ 90, 123, 100]],

       [[  4, 180, 255],
        [  4, 181, 255],
        [  5, 182, 255],
        ...,
        [101, 137, 112],
        [ 89, 125, 101],
        [ 85, 120,  97]]], dtype=uint8)]"
Image_1869.jpg,282,128,101,113,775,518,383,241,113,daskShared_local/images/Image_1869.jpg,1869,"[array([[[ 83, 160, 180],
        [ 83, 160, 180],
        [ 83, 160, 180],
        ...,
        [103, 169, 187],
        [103, 170, 187],
        [103, 170, 187]],

       [[ 84, 161, 181],
        [ 84, 161, 181],
        [ 84, 161, 181],
        ...,
        [104, 170, 187],
        [103, 170, 187],
        [103, 169, 186]],

       [[ 87, 164, 184],
        [ 87, 164, 184],
        [ 87, 164, 184],
        ...,
        [108, 175, 191],
        [103, 170, 186],
        [101, 168, 185]],

       ...,

       [[177, 154, 140],
        [173, 151, 137],
        [160, 138, 124],
        ...,
        [ 82,  64,  66],
        [ 70,  51,  54],
        [ 68,  49,  51]],

       [[177, 148, 126],
        [176, 147, 126],
        [173, 145, 124],
        ...,
        [ 50,  35,  28],
        [ 59,  41,  39],
        [ 61,  42,  42]],

       [[177, 146, 122],
        [177, 146, 123],
        [177, 147, 124],
        ...,
        [ 42,  28,  18],
        [ 56,  38,  36],
        [ 60,  40,  40]]], dtype=uint8)]"
Image_187.jpg,454,233,157,158,900,586,611,391,158,daskShared_local/images/Image_187.jpg,187,"[array([[[  4, 175, 205],
        [  3, 177, 207],
        [ 12, 174, 212],
        ...,
        [ 97, 203, 225],
        [ 98, 203, 225],
        [ 99, 204, 226]],

       [[ 29, 169, 198],
        [ 19, 164, 193],
        [ 11, 163, 197],
        ...,
        [ 96, 203, 226],
        [ 97, 203, 226],
        [ 98, 203, 227]],

       [[110, 196, 224],
        [102, 190, 220],
        [ 79, 187, 219],
        ...,
        [ 94, 202, 226],
        [ 95, 203, 226],
        [ 95, 203, 226]],

       ...,

       [[  0,  50,  43],
        [  0,  44,  37],
        [  0,  47,  41],
        ...,
        [  1, 163, 209],
        [  1, 163, 209],
        [  1, 163, 209]],

       [[  1,  34,  33],
        [  2,  33,  30],
        [  1,  46,  41],
        ...,
        [  1, 163, 209],
        [  1, 163, 209],
        [  1, 163, 209]],

       [[  4,  27,  29],
        [  5,  29,  31],
        [  3,  46,  42],
        ...,
        [  1, 163, 209],
        [  1, 163, 209],
        [  1, 163, 209]]], dtype=uint8)]"
Image_1870.jpg,610,319,168,125,1440,960,778,444,168,daskShared_local/images/Image_1870.jpg,1870,"[array([[[  0, 145, 205],
        [  0, 146, 206],
        [  0, 146, 206],
        ...,
        [  0, 145, 214],
        [  0, 144, 214],
        [  1, 145, 215]],

       [[  0, 146, 206],
        [  0, 146, 206],
        [  0, 146, 206],
        ...,
        [  0, 145, 214],
        [  0, 144, 214],
        [  1, 145, 215]],

       [[  0, 146, 206],
        [  0, 146, 206],
        [  1, 147, 207],
        ...,
        [  1, 145, 214],
        [  1, 145, 214],
        [  2, 146, 214]],

       ...,

       [[ 77,  79,  63],
        [ 66,  73,  57],
        [ 64,  74,  63],
        ...,
        [  2,  76, 113],
        [  0,  76, 113],
        [  0,  77, 114]],

       [[ 79,  78,  61],
        [ 56,  59,  43],
        [ 38,  44,  34],
        ...,
        [  1,  75, 112],
        [  0,  75, 112],
        [  0,  76, 114]],

       [[ 44,  42,  29],
        [ 27,  29,  15],
        [ 10,  13,   6],
        ...,
        [  0,  74, 111],
        [  0,  75, 112],
        [  0,  75, 114]]], dtype=uint8)]"
Image_1871.jpg,452,152,137,107,1024,512,589,259,137,daskShared_local/images/Image_1871.jpg,1871,"[array([[[  0, 133, 190],
        [  0, 134, 190],
        [  0, 134, 190],
        ...,
        [  1, 169, 213],
        [  1, 169, 213],
        [  1, 169, 213]],

       [[  0, 133, 190],
        [  0, 134, 190],
        [  0, 134, 190],
        ...,
        [  1, 168, 212],
        [  0, 168, 211],
        [  0, 168, 211]],

       [[  0, 134, 190],
        [  0, 134, 190],
        [  0, 134, 190],
        ...,
        [  0, 166, 210],
        [  0, 166, 210],
        [  0, 166, 210]],

       ...,

       [[143, 130,  95],
        [119, 109,  75],
        [ 88,  82,  51],
        ...,
        [  1, 145, 198],
        [  1, 145, 198],
        [  1, 145, 198]],

       [[176, 163, 128],
        [146, 135, 101],
        [104,  96,  66],
        ...,
        [  1, 145, 198],
        [  1, 145, 198],
        [  1, 145, 198]],

       [[190, 176, 142],
        [159, 148, 115],
        [115, 107,  77],
        ...,
        [  1, 145, 198],
        [  1, 145, 198],
        [  1, 145, 198]]], dtype=uint8)]"
Image_1872.jpg,111,82,86,55,475,264,197,137,86,daskShared_local/images/Image_1872.jpg,1872,"[array([[[22, 41, 57],
        [21, 42, 58],
        [24, 41, 54],
        ...,
        [21, 37, 60],
        [21, 37, 61],
        [21, 37, 61]],

       [[22, 41, 57],
        [21, 42, 59],
        [24, 40, 54],
        ...,
        [21, 37, 61],
        [21, 37, 62],
        [21, 37, 62]],

       [[22, 41, 56],
        [21, 41, 57],
        [24, 41, 54],
        ...,
        [20, 36, 59],
        [20, 36, 60],
        [20, 36, 60]],

       ...,

       [[11, 19, 28],
        [11, 19, 28],
        [11, 19, 27],
        ...,
        [46, 55, 62],
        [45, 54, 61],
        [45, 54, 61]],

       [[12, 21, 29],
        [13, 22, 29],
        [12, 21, 29],
        ...,
        [44, 55, 58],
        [42, 53, 56],
        [43, 53, 57]],

       [[12, 21, 29],
        [12, 21, 29],
        [12, 20, 28],
        ...,
        [45, 55, 59],
        [43, 53, 58],
        [44, 54, 58]]], dtype=uint8)]"
Image_1873.jpg,586,176,174,162,1000,665,760,338,174,daskShared_local/images/Image_1873.jpg,1873,"[array([[[ 40, 133, 200],
        [ 40, 133, 200],
        [ 37, 134, 199],
        ...,
        [ 29, 129, 197],
        [ 27, 130, 197],
        [ 13, 128, 195]],

       [[ 36, 132, 201],
        [ 35, 133, 201],
        [ 32, 133, 200],
        ...,
        [ 24, 130, 197],
        [ 27, 130, 196],
        [ 24, 129, 196]],

       [[ 36, 133, 201],
        [ 37, 134, 200],
        [ 33, 133, 200],
        ...,
        [ 25, 130, 196],
        [ 26, 130, 194],
        [ 27, 130, 196]],

       ...,

       [[ 19,  85, 103],
        [  4,  64,  76],
        [ 10,  71,  83],
        ...,
        [  1,  57,  71],
        [  2,  61,  72],
        [  2,  63,  75]],

       [[ 16,  82,  97],
        [  5,  69,  79],
        [ 15,  75,  85],
        ...,
        [  1,  51,  64],
        [  1,  55,  68],
        [  2,  58,  70]],

       [[  7,  73,  85],
        [ 10,  73,  81],
        [ 10,  70,  77],
        ...,
        [  1,  47,  60],
        [  2,  48,  60],
        [  3,  53,  64]]], dtype=uint8)]"
Image_1874.jpg,786,554,1226,1461,3072,2304,2012,2015,1461,daskShared_local/images/Image_1874.jpg,1874,"[array([[[ 81,  73,  66],
        [ 78,  69,  66],
        [ 77,  67,  66],
        ...,
        [ 63,  43,  47],
        [ 68,  45,  53],
        [ 78,  56,  67]],

       [[ 80,  70,  67],
        [ 77,  67,  65],
        [ 76,  68,  67],
        ...,
        [ 74,  49,  54],
        [ 69,  46,  53],
        [ 72,  50,  60]],

       [[ 82,  72,  70],
        [ 79,  69,  67],
        [ 77,  69,  68],
        ...,
        [ 88,  59,  67],
        [ 72,  47,  55],
        [ 72,  48,  58]],

       ...,

       [[  6, 113, 120],
        [  6, 113, 120],
        [  7, 114, 122],
        ...,
        [ 11,  97, 110],
        [  6,  94, 107],
        [ 11,  96, 114]],

       [[  5, 112, 122],
        [  5, 112, 121],
        [  7, 113, 123],
        ...,
        [ 10,  94, 108],
        [  8,  96, 113],
        [ 16, 105, 122]],

       [[  5, 113, 123],
        [  5, 111, 121],
        [  6, 111, 122],
        ...,
        [  8,  92, 109],
        [ 11, 102, 115],
        [ 18, 113, 125]]], dtype=uint8)]"
Image_1875.jpg,198,343,302,181,1024,768,500,524,302,daskShared_local/images/Image_1875.jpg,1875,"[array([[[ 80, 125, 143],
        [ 64, 111, 132],
        [ 98, 147, 170],
        ...,
        [ 50,  77,  93],
        [ 55,  79,  96],
        [ 67,  91, 108]],

       [[ 56,  94, 110],
        [ 50,  87, 109],
        [ 56,  95, 119],
        ...,
        [ 34,  71,  85],
        [ 39,  74,  86],
        [ 49,  82,  95]],

       [[ 55,  85,  99],
        [ 69, 100, 120],
        [ 66,  96, 122],
        ...,
        [ 88, 133, 146],
        [100, 144, 153],
        [ 78, 116, 126]],

       ...,

       [[155, 210, 219],
        [135, 194, 187],
        [124, 184, 163],
        ...,
        [ 19,  10,  26],
        [ 22,  13,  29],
        [ 27,  19,  34]],

       [[152, 208, 202],
        [143, 199, 183],
        [125, 179, 154],
        ...,
        [ 16,   7,  19],
        [ 19,  12,  22],
        [ 29,  24,  31]],

       [[153, 210, 194],
        [133, 186, 164],
        [125, 175, 150],
        ...,
        [ 18,  15,  19],
        [ 13,  17,  15],
        [ 13,  17,  15]]], dtype=uint8)]"
Image_1876.jpg,500,142,207,147,800,600,707,289,207,daskShared_local/images/Image_1876.jpg,1876,"[array([[[  6,  47,  65],
        [ 10,  46,  60],
        [ 13,  43,  52],
        ...,
        [  4,  11,  15],
        [ 14,  21,  27],
        [ 18,  27,  32]],

       [[  9,  47,  68],
        [ 10,  45,  61],
        [ 12,  41,  53],
        ...,
        [  5,  11,  17],
        [ 13,  20,  26],
        [ 15,  22,  28]],

       [[  8,  45,  66],
        [  5,  40,  59],
        [  5,  34,  52],
        ...,
        [ 10,  16,  22],
        [ 14,  21,  27],
        [ 12,  19,  25]],

       ...,

       [[207, 186, 139],
        [188, 164, 116],
        [196, 166, 117],
        ...,
        [ 18,  47,  54],
        [ 38,  63,  69],
        [ 41,  62,  66]],

       [[202, 185, 148],
        [199, 177, 139],
        [191, 161, 121],
        ...,
        [ 23,  45,  53],
        [ 38,  58,  62],
        [ 42,  58,  59]],

       [[171, 160, 128],
        [198, 179, 143],
        [197, 169, 126],
        ...,
        [ 28,  43,  50],
        [ 37,  48,  52],
        [ 38,  48,  49]]], dtype=uint8)]"
Image_1877.jpg,109,112,498,274,800,533,607,386,498,daskShared_local/images/Image_1877.jpg,1877,"[array([[[  3,  12,  61],
        [  4,  15,  63],
        [  4,  16,  64],
        ...,
        [  5,  23,  83],
        [  6,  23,  85],
        [  8,  22,  87]],

       [[  3,  11,  60],
        [  6,  14,  63],
        [  5,  14,  63],
        ...,
        [  7,  23,  85],
        [  8,  21,  86],
        [  8,  21,  89]],

       [[  3,  11,  60],
        [  3,  10,  60],
        [  4,  10,  59],
        ...,
        [ 10,  23,  85],
        [ 11,  22,  87],
        [  9,  20,  88]],

       ...,

       [[  8,  21,  66],
        [ 10,  21,  69],
        [ 11,  24,  78],
        ...,
        [120, 172, 196],
        [ 97, 151, 189],
        [ 80, 130, 176]],

       [[  9,  21,  66],
        [ 12,  23,  72],
        [ 10,  26,  77],
        ...,
        [ 63, 110, 161],
        [ 36,  70, 128],
        [ 18,  42,  97]],

       [[ 12,  22,  68],
        [ 12,  24,  70],
        [ 13,  28,  76],
        ...,
        [ 21,  41,  96],
        [ 17,  25,  72],
        [ 18,  21,  57]]], dtype=uint8)]"
Image_1878.jpg,127,391,350,271,1715,1286,477,662,350,daskShared_local/images/Image_1878.jpg,1878,"[array([[[155, 170, 167],
        [158, 173, 170],
        [160, 173, 166],
        ...,
        [ 81,  74,  86],
        [ 91,  81,  88],
        [ 90,  82,  87]],

       [[154, 173, 169],
        [156, 170, 167],
        [155, 171, 162],
        ...,
        [ 86,  82,  81],
        [ 85,  82,  79],
        [ 83,  79,  76]],

       [[152, 172, 168],
        [156, 170, 167],
        [157, 172, 165],
        ...,
        [ 74,  76,  71],
        [ 75,  75,  72],
        [ 77,  76,  72]],

       ...,

       [[140, 147, 152],
        [148, 152, 170],
        [154, 153, 191],
        ...,
        [188, 189, 210],
        [187, 191, 214],
        [188, 187, 219]],

       [[153, 147, 147],
        [156, 145, 154],
        [155, 156, 187],
        ...,
        [185, 193, 199],
        [190, 197, 199],
        [196, 193, 198]],

       [[173, 158, 147],
        [176, 157, 154],
        [172, 156, 156],
        ...,
        [179, 191, 197],
        [179, 195, 196],
        [182, 202, 197]]], dtype=uint8)]"
Image_1879.jpg,323,292,132,94,1280,720,455,386,132,daskShared_local/images/Image_1879.jpg,1879,"[array([[[  1,  61, 133],
        [  1,  61, 133],
        [  1,  61, 133],
        ...,
        [  0,  61, 136],
        [  0,  61, 136],
        [  0,  61, 136]],

       [[  1,  61, 133],
        [  1,  61, 133],
        [  1,  61, 133],
        ...,
        [  0,  61, 136],
        [  0,  61, 136],
        [  0,  61, 136]],

       [[  1,  61, 133],
        [  1,  61, 133],
        [  1,  61, 133],
        ...,
        [  0,  61, 136],
        [  0,  61, 136],
        [  0,  61, 136]],

       ...,

       [[ 26, 101, 130],
        [ 26, 101, 130],
        [ 26, 101, 131],
        ...,
        [ 16,  94, 132],
        [ 16,  94, 132],
        [ 16,  94, 132]],

       [[ 27, 102, 130],
        [ 27, 102, 130],
        [ 27, 102, 131],
        ...,
        [ 16,  94, 132],
        [ 16,  94, 132],
        [ 16,  94, 132]],

       [[ 28, 102, 131],
        [ 28, 102, 131],
        [ 28, 102, 131],
        ...,
        [ 16,  94, 132],
        [ 16,  94, 132],
        [ 16,  94, 132]]], dtype=uint8)]"
Image_188.jpg,1748,563,1376,1545,4631,3087,3124,2108,1545,daskShared_local/images/Image_188.jpg,188,"[array([[[ 21,  91, 239],
        [ 21,  91, 239],
        [ 21,  91, 239],
        ...,
        [  0,  58, 194],
        [  0,  58, 194],
        [  0,  58, 194]],

       [[ 21,  90, 238],
        [ 20,  90, 238],
        [ 21,  89, 238],
        ...,
        [  0,  58, 193],
        [  0,  58, 193],
        [  0,  57, 192]],

       [[ 21,  89, 238],
        [ 21,  89, 238],
        [ 22,  89, 238],
        ...,
        [  0,  58, 192],
        [  0,  57, 191],
        [  0,  56, 191]],

       ...,

       [[ 99,  92,  84],
        [124, 131, 110],
        [124, 126,  93],
        ...,
        [ 32,  34,  19],
        [ 33,  36,  20],
        [ 32,  36,  19]],

       [[112, 111, 114],
        [119, 126, 101],
        [ 93,  87,  67],
        ...,
        [ 31,  36,  19],
        [ 36,  42,  24],
        [ 32,  39,  21]],

       [[112, 111, 106],
        [106, 108,  78],
        [ 66,  56,  46],
        ...,
        [ 28,  34,  18],
        [ 37,  44,  25],
        [ 33,  41,  23]]], dtype=uint8)]"
Image_1880.jpg,304,18,653,555,1190,595,957,573,653,daskShared_local/images/Image_1880.jpg,1880,"[array([[[181, 202, 208],
        [175, 202, 206],
        [178, 204, 208],
        ...,
        [205, 217, 207],
        [205, 217, 207],
        [205, 217, 207]],

       [[196, 216, 220],
        [186, 208, 213],
        [189, 210, 216],
        ...,
        [204, 217, 207],
        [205, 217, 207],
        [204, 216, 206]],

       [[196, 215, 222],
        [195, 216, 222],
        [194, 215, 222],
        ...,
        [204, 218, 207],
        [205, 218, 207],
        [205, 217, 206]],

       ...,

       [[155,   6,  52],
        [172,  20,  70],
        [164,  19,  66],
        ...,
        [132,  60,  48],
        [140,  67,  55],
        [147,  77,  72]],

       [[162,  32,  73],
        [180,  55,  96],
        [159,  33,  70],
        ...,
        [130,  54,  43],
        [136,  64,  46],
        [144,  75,  67]],

       [[175,  52,  97],
        [186,  72, 115],
        [175,  64, 101],
        ...,
        [132,  59,  47],
        [134,  64,  45],
        [141,  73,  64]]], dtype=uint8)]"
Image_1881.jpg,1633,526,816,671,4100,2660,2449,1197,816,daskShared_local/images/Image_1881.jpg,1881,"[array([[[195, 182, 165],
        [193, 180, 164],
        [197, 184, 170],
        ...,
        [168, 154, 143],
        [161, 148, 134],
        [161, 149, 134]],

       [[194, 180, 168],
        [192, 178, 164],
        [198, 185, 169],
        ...,
        [163, 150, 133],
        [163, 150, 134],
        [165, 152, 135]],

       [[193, 179, 170],
        [192, 178, 168],
        [192, 178, 165],
        ...,
        [169, 157, 139],
        [170, 158, 144],
        [164, 153, 136]],

       ...,

       [[ 53,  38,  33],
        [ 53,  38,  33],
        [ 52,  37,  32],
        ...,
        [216, 226, 229],
        [220, 229, 237],
        [230, 239, 249]],

       [[ 55,  40,  35],
        [ 54,  39,  34],
        [ 53,  38,  33],
        ...,
        [216, 223, 231],
        [226, 235, 237],
        [227, 235, 244]],

       [[ 56,  41,  36],
        [ 55,  40,  35],
        [ 54,  39,  34],
        ...,
        [217, 222, 232],
        [225, 233, 234],
        [230, 237, 247]]], dtype=uint8)]"
Image_1882.jpg,316,124,218,204,770,422,534,328,218,daskShared_local/images/Image_1882.jpg,1882,"[array([[[205, 152, 101],
        [195, 145,  75],
        [203, 154,  78],
        ...,
        [ 44, 139, 225],
        [ 36, 125, 215],
        [ 26, 114, 204]],

       [[182, 125,  79],
        [192, 142,  81],
        [221, 174, 110],
        ...,
        [ 31, 121, 209],
        [ 27, 115, 205],
        [ 27, 112, 203]],

       [[192, 136,  97],
        [224, 178, 129],
        [239, 199, 151],
        ...,
        [ 24, 112, 201],
        [ 29, 114, 205],
        [ 35, 117, 209]],

       ...,

       [[ 56,  80,  56],
        [ 56,  80,  60],
        [ 54,  78,  62],
        ...,
        [ 27,  47,  66],
        [  7,  29,  47],
        [  0,  21,  38]],

       [[ 56,  80,  56],
        [ 55,  80,  60],
        [ 53,  78,  64],
        ...,
        [ 11,  33,  51],
        [  2,  24,  42],
        [  0,  24,  41]],

       [[ 56,  80,  56],
        [ 54,  79,  59],
        [ 51,  78,  63],
        ...,
        [  5,  27,  46],
        [ 18,  43,  60],
        [ 33,  59,  76]]], dtype=uint8)]"
Image_1883.jpg,433,203,206,191,900,600,639,394,206,daskShared_local/images/Image_1883.jpg,1883,"[array([[[  4, 131, 234],
        [  4, 131, 234],
        [  4, 131, 236],
        ...,
        [  0,  88, 208],
        [  0,  89, 207],
        [  2,  91, 209]],

       [[  4, 131, 236],
        [  3, 132, 236],
        [  3, 132, 236],
        ...,
        [  0,  89, 209],
        [  1,  90, 210],
        [  2,  91, 211]],

       [[  3, 132, 236],
        [  3, 132, 236],
        [  0, 131, 235],
        ...,
        [  1,  90, 210],
        [  1,  90, 210],
        [  1,  90, 210]],

       ...,

       [[200, 179, 117],
        [183, 166, 105],
        [157, 144,  84],
        ...,
        [ 20,  57, 102],
        [  6,  52, 125],
        [  7,  61, 158]],

       [[147, 126,  50],
        [146, 127,  52],
        [146, 130,  56],
        ...,
        [  3,  49, 133],
        [  2,  54, 156],
        [  1,  57, 167]],

       [[224, 204, 133],
        [178, 159,  89],
        [168, 151,  82],
        ...,
        [  9,  56, 145],
        [  1,  51, 156],
        [  0,  52, 165]]], dtype=uint8)]"
Image_1884.jpg,106,110,134,125,500,375,240,235,134,daskShared_local/images/Image_1884.jpg,1884,"[array([[[ 70, 137, 163],
        [ 68, 135, 161],
        [ 62, 129, 155],
        ...,
        [ 22,  71, 104],
        [ 23,  72, 106],
        [ 24,  72, 107]],

       [[ 78, 145, 171],
        [ 76, 143, 169],
        [ 70, 137, 163],
        ...,
        [ 24,  73, 106],
        [ 26,  75, 109],
        [ 27,  76, 110]],

       [[ 86, 153, 179],
        [ 84, 151, 177],
        [ 78, 145, 171],
        ...,
        [ 28,  77, 109],
        [ 30,  79, 112],
        [ 32,  81, 113]],

       ...,

       [[ 31, 129, 154],
        [ 31, 129, 154],
        [ 33, 131, 156],
        ...,
        [203, 199, 204],
        [207, 203, 208],
        [209, 204, 209]],

       [[ 28, 125, 150],
        [ 29, 126, 151],
        [ 31, 128, 153],
        ...,
        [199, 193, 195],
        [201, 194, 197],
        [202, 195, 197]],

       [[ 27, 123, 148],
        [ 28, 124, 149],
        [ 29, 126, 151],
        ...,
        [195, 188, 189],
        [196, 187, 189],
        [196, 187, 188]]], dtype=uint8)]"
Image_1885.jpg,332,280,244,208,750,740,576,488,244,daskShared_local/images/Image_1885.jpg,1885,"[array([[[ 78, 220, 243],
        [ 79, 217, 241],
        [ 82, 216, 241],
        ...,
        [ 10, 195, 215],
        [ 10, 195, 215],
        [ 11, 196, 216]],

       [[ 61, 216, 238],
        [ 61, 210, 234],
        [ 61, 207, 231],
        ...,
        [ 10, 194, 214],
        [  8, 192, 213],
        [  8, 192, 212]],

       [[ 40, 208, 227],
        [ 44, 204, 226],
        [ 45, 201, 224],
        ...,
        [ 13, 195, 216],
        [ 12, 194, 215],
        [ 12, 194, 215]],

       ...,

       [[108, 187, 181],
        [111, 187, 182],
        [110, 185, 181],
        ...,
        [120, 173, 163],
        [120, 174, 164],
        [113, 169, 158]],

       [[106, 184, 166],
        [107, 184, 168],
        [109, 184, 170],
        ...,
        [128, 182, 173],
        [126, 182, 172],
        [121, 179, 169]],

       [[105, 179, 148],
        [108, 180, 152],
        [114, 185, 159],
        ...,
        [136, 189, 184],
        [133, 190, 184],
        [131, 188, 181]]], dtype=uint8)]"
Image_1886.jpg,630,443,210,196,1024,672,840,639,210,daskShared_local/images/Image_1886.jpg,1886,"[array([[[ 93,  92, 100],
        [100,  97, 104],
        [104, 101, 108],
        ...,
        [ 72,  91,  97],
        [ 55,  73,  77],
        [ 41,  57,  57]],

       [[ 85,  84,  92],
        [ 96,  93, 102],
        [107, 104, 111],
        ...,
        [ 82, 105, 114],
        [ 69,  90,  97],
        [ 55,  76,  80]],

       [[ 77,  75,  86],
        [ 86,  83,  93],
        [ 97,  94, 103],
        ...,
        [ 95, 123, 134],
        [ 90, 115, 126],
        [ 83, 108, 116]],

       ...,

       [[ 38,  85, 140],
        [ 39,  86, 139],
        [ 36,  83, 136],
        ...,
        [  8, 112, 225],
        [  9, 113, 224],
        [  8, 114, 224]],

       [[ 39,  88, 146],
        [ 39,  88, 145],
        [ 38,  86, 144],
        ...,
        [ 12, 114, 225],
        [ 10, 114, 225],
        [ 11, 115, 226]],

       [[ 41,  91, 152],
        [ 41,  91, 150],
        [ 39,  89, 148],
        ...,
        [ 13, 115, 226],
        [ 11, 115, 226],
        [ 12, 117, 226]]], dtype=uint8)]"
Image_1887.jpg,317,114,214,304,1000,667,531,418,304,daskShared_local/images/Image_1887.jpg,1887,"[array([[[196, 174, 146],
        [178, 150, 120],
        [182, 149, 116],
        ...,
        [131, 121, 108],
        [118, 108,  95],
        [114, 103,  91]],

       [[195, 164, 131],
        [208, 188, 162],
        [208, 205, 194],
        ...,
        [159, 147, 133],
        [167, 155, 141],
        [157, 145, 131]],

       [[197, 192, 189],
        [147, 155, 169],
        [ 89, 113, 144],
        ...,
        [145, 132, 116],
        [118, 105,  89],
        [108,  95,  79]],

       ...,

       [[ 57, 132, 183],
        [ 57, 132, 182],
        [ 56, 131, 181],
        ...,
        [ 52,  48,  31],
        [ 42,  38,  25],
        [ 42,  34,  20]],

       [[ 56, 132, 181],
        [ 54, 131, 180],
        [ 53, 131, 179],
        ...,
        [ 34,  33,  18],
        [ 36,  29,  12],
        [ 48,  36,  17]],

       [[ 58, 129, 183],
        [ 54, 127, 180],
        [ 50, 127, 179],
        ...,
        [ 62,  61,  40],
        [ 49,  42,  24],
        [ 51,  36,  25]]], dtype=uint8)]"
Image_1888.jpg,396,6,82,59,530,180,478,65,82,daskShared_local/images/Image_1888.jpg,1888,"[array([[[ 15,  43,  87],
        [ 17,  46,  89],
        [ 14,  39,  84],
        ...,
        [ 30,  56,  70],
        [ 36,  62,  78],
        [ 34,  60,  75]],

       [[ 20,  47,  90],
        [ 21,  50,  92],
        [ 17,  43,  86],
        ...,
        [ 23,  50,  66],
        [ 26,  53,  71],
        [ 25,  52,  69]],

       [[ 12,  40,  84],
        [ 14,  43,  86],
        [ 11,  37,  81],
        ...,
        [ 36,  61,  73],
        [ 44,  69,  84],
        [ 41,  65,  80]],

       ...,

       [[140, 133, 102],
        [122, 124, 103],
        [164, 144, 100],
        ...,
        [ 43,  35,  48],
        [ 42,  32,  48],
        [ 42,  33,  48]],

       [[ 82,  98,  99],
        [ 56,  79,  93],
        [119, 125, 108],
        ...,
        [ 41,  34,  46],
        [ 42,  34,  47],
        [ 42,  34,  47]],

       [[115, 118, 101],
        [ 94, 105,  99],
        [145, 136, 104],
        ...,
        [ 42,  34,  47],
        [ 42,  33,  48],
        [ 42,  33,  48]]], dtype=uint8)]"
Image_1889.jpg,748,266,366,305,1200,906,1114,571,366,daskShared_local/images/Image_1889.jpg,1889,"[array([[[115, 105, 115],
        [117, 109, 121],
        [110, 104, 117],
        ...,
        [ 18,  48,  72],
        [ 19,  47,  71],
        [ 21,  49,  73]],

       [[104,  94, 103],
        [100,  90, 101],
        [ 92,  84,  97],
        ...,
        [ 17,  48,  72],
        [ 16,  44,  68],
        [ 20,  47,  72]],

       [[ 91,  81,  90],
        [ 96,  85,  95],
        [ 87,  77,  87],
        ...,
        [ 21,  52,  73],
        [ 20,  48,  72],
        [ 20,  49,  73]],

       ...,

       [[ 68,  83,  98],
        [ 70,  82,  98],
        [ 67,  90, 105],
        ...,
        [ 19,  57,  76],
        [ 20,  54,  73],
        [ 32,  59,  79]],

       [[104, 115, 130],
        [ 73,  82,  97],
        [ 64,  90, 106],
        ...,
        [ 12,  53,  71],
        [ 18,  52,  71],
        [ 26,  51,  71]],

       [[118, 131, 146],
        [ 77,  88, 104],
        [ 55,  82,  99],
        ...,
        [ 12,  54,  71],
        [ 17,  51,  69],
        [ 22,  48,  67]]], dtype=uint8)]"
Image_189.png,243,33,81,85,589,295,324,118,85,daskShared_local/images/Image_189.png,189,"[array([[[  0, 173, 192],
        [  0, 175, 192],
        [  0, 170, 192],
        ...,
        [  0, 169, 192],
        [  0, 170, 194],
        [  0, 170, 193]],

       [[  0, 173, 192],
        [  0, 175, 192],
        [  0, 170, 193],
        ...,
        [  0, 170, 192],
        [  0, 170, 196],
        [  0, 170, 195]],

       [[  0, 173, 191],
        [  0, 174, 191],
        [  0, 170, 190],
        ...,
        [  0, 169, 190],
        [  0, 169, 192],
        [  0, 169, 191]],

       ...,

       [[ 48,  29,  29],
        [ 51,  31,  30],
        [ 43,  26,  26],
        ...,
        [124,  90,  89],
        [156, 117, 114],
        [145, 108, 106]],

       [[ 56,  35,  37],
        [ 62,  38,  40],
        [ 45,  29,  31],
        ...,
        [173, 147, 147],
        [198, 171, 171],
        [190, 163, 163]],

       [[ 54,  33,  34],
        [ 58,  35,  37],
        [ 44,  28,  29],
        ...,
        [157, 128, 128],
        [184, 153, 152],
        [175, 145, 144]]], dtype=uint8)]"
Image_1890.jpg,280,133,152,110,800,505,432,243,152,daskShared_local/images/Image_1890.jpg,1890,"[array([[[ 65,  82,  72],
        [ 59,  76,  65],
        [ 56,  71,  60],
        ...,
        [ 32,  48,  54],
        [ 28,  43,  51],
        [ 26,  40,  48]],

       [[ 63,  79,  68],
        [ 57,  72,  61],
        [ 56,  70,  58],
        ...,
        [ 29,  46,  52],
        [ 28,  44,  52],
        [ 28,  43,  52]],

       [[ 59,  75,  64],
        [ 54,  69,  56],
        [ 54,  67,  55],
        ...,
        [ 25,  42,  48],
        [ 28,  46,  53],
        [ 31,  48,  57]],

       ...,

       [[ 97,  97,  65],
        [102, 103,  69],
        [107, 110,  75],
        ...,
        [186, 178, 153],
        [172, 162, 138],
        [157, 144, 121]],

       [[ 86,  85,  54],
        [ 90,  91,  58],
        [ 94,  97,  64],
        ...,
        [171, 165, 138],
        [160, 152, 126],
        [153, 143, 117]],

       [[ 80,  79,  48],
        [ 81,  82,  50],
        [ 83,  86,  53],
        ...,
        [155, 150, 122],
        [155, 148, 120],
        [161, 152, 125]]], dtype=uint8)]"
Image_1891.jpg,431,216,117,183,900,600,548,399,183,daskShared_local/images/Image_1891.jpg,1891,"[array([[[  7, 108, 164],
        [  7, 108, 164],
        [  5, 108, 163],
        ...,
        [  5, 119, 169],
        [  4, 118, 168],
        [  4, 118, 168]],

       [[  7, 108, 164],
        [  7, 108, 164],
        [  5, 108, 163],
        ...,
        [  5, 119, 169],
        [  4, 118, 168],
        [  4, 118, 168]],

       [[  7, 108, 164],
        [  7, 108, 164],
        [  5, 108, 163],
        ...,
        [  5, 119, 169],
        [  4, 118, 168],
        [  4, 118, 168]],

       ...,

       [[119, 103,  67],
        [127, 111,  75],
        [128, 113,  79],
        ...,
        [  4,  92, 140],
        [  4,  92, 140],
        [  4,  92, 140]],

       [[171, 155, 119],
        [168, 152, 116],
        [152, 139, 101],
        ...,
        [  4,  92, 140],
        [  4,  92, 140],
        [  4,  92, 140]],

       [[223, 207, 171],
        [194, 178, 142],
        [145, 135,  92],
        ...,
        [  4,  92, 140],
        [  4,  92, 140],
        [  4,  92, 140]]], dtype=uint8)]"
Image_1892.jpg,743,164,251,170,1050,700,994,334,251,daskShared_local/images/Image_1892.jpg,1892,"[array([[[  9, 173, 151],
        [ 11, 181, 162],
        [  1, 175, 153],
        ...,
        [ 21,  55,  39],
        [ 59,  85,  61],
        [ 73,  90,  64]],

       [[  7, 138, 125],
        [  3, 166, 149],
        [  3, 170, 149],
        ...,
        [ 45,  68,  57],
        [ 12,  41,  23],
        [ 55,  78,  55]],

       [[  1, 124, 112],
        [  1, 131, 123],
        [  3, 147, 133],
        ...,
        [ 79,  85,  70],
        [ 37,  44,  40],
        [ 44,  47,  47]],

       ...,

       [[ 30,  46,  52],
        [ 34,  49,  54],
        [ 37,  52,  57],
        ...,
        [ 66, 167, 173],
        [ 49, 172, 165],
        [ 56, 165, 161]],

       [[ 21,  41,  45],
        [ 30,  45,  50],
        [ 33,  48,  53],
        ...,
        [ 57, 155, 165],
        [ 45, 155, 157],
        [ 40, 158, 155]],

       [[ 36,  52,  55],
        [ 32,  45,  51],
        [ 34,  47,  53],
        ...,
        [ 28, 146, 148],
        [ 28, 127, 132],
        [ 26, 122, 126]]], dtype=uint8)]"
Image_1893.jpg,359,105,298,279,1024,670,657,384,298,daskShared_local/images/Image_1893.jpg,1893,"[array([[[  1,  66, 107],
        [  1,  63, 107],
        [  1,  67, 114],
        ...,
        [  3,  19,  44],
        [  5,  21,  46],
        [  8,  19,  47]],

       [[  4,  66, 109],
        [  1,  61, 107],
        [  1,  63, 109],
        ...,
        [ 12,  27,  51],
        [  0,  14,  37],
        [  7,  18,  45]],

       [[  7,  66, 113],
        [  5,  66, 113],
        [  2,  62, 108],
        ...,
        [  8,  22,  41],
        [  3,  14,  32],
        [ 10,  21,  46]],

       ...,

       [[ 39,  92,  57],
        [ 13,  56,  19],
        [ 24,  62,  14],
        ...,
        [  7,  26,  33],
        [  8,  28,  36],
        [ 12,  30,  37]],

       [[ 23,  78,  47],
        [ 10,  48,  17],
        [ 53,  86,  39],
        ...,
        [  5,  25,  32],
        [  4,  26,  34],
        [ 11,  30,  35]],

       [[ 27,  83,  53],
        [ 14,  53,  21],
        [ 50,  82,  36],
        ...,
        [  6,  27,  33],
        [  4,  25,  31],
        [ 11,  29,  34]]], dtype=uint8)]"
Image_1894.jpg,269,334,149,104,900,599,418,438,149,daskShared_local/images/Image_1894.jpg,1894,"[array([[[ 66, 133, 211],
        [ 66, 133, 211],
        [ 66, 133, 211],
        ...,
        [145, 193, 209],
        [179, 213, 211],
        [189, 220, 219]],

       [[ 66, 133, 211],
        [ 66, 133, 211],
        [ 66, 133, 211],
        ...,
        [160, 202, 214],
        [184, 212, 208],
        [189, 215, 210]],

       [[ 66, 133, 211],
        [ 66, 133, 211],
        [ 66, 133, 211],
        ...,
        [176, 209, 216],
        [192, 211, 203],
        [193, 211, 202]],

       ...,

       [[ 46,  85, 164],
        [ 46,  85, 164],
        [ 46,  85, 164],
        ...,
        [ 48,  91, 169],
        [ 47,  90, 168],
        [ 47,  90, 168]],

       [[ 46,  85, 164],
        [ 46,  85, 164],
        [ 46,  85, 164],
        ...,
        [ 47,  90, 168],
        [ 47,  90, 168],
        [ 47,  90, 168]],

       [[ 46,  85, 164],
        [ 46,  85, 164],
        [ 46,  85, 164],
        ...,
        [ 47,  90, 168],
        [ 47,  90, 168],
        [ 47,  90, 168]]], dtype=uint8)]"
Image_1895.jpg,282,167,252,242,1000,541,534,409,252,daskShared_local/images/Image_1895.jpg,1895,"[array([[[  1, 139, 169],
        [ 11, 135, 165],
        [ 26, 130, 161],
        ...,
        [  3, 156, 170],
        [  3, 158, 174],
        [  3, 155, 173]],

       [[  3, 131, 160],
        [ 10, 129, 158],
        [ 21, 126, 156],
        ...,
        [ 24, 165, 188],
        [ 24, 166, 188],
        [ 26, 161, 187]],

       [[ 13, 125, 153],
        [ 13, 123, 151],
        [ 16, 121, 149],
        ...,
        [ 28, 166, 189],
        [ 28, 163, 186],
        [ 31, 161, 184]],

       ...,

       [[  1,  58,  75],
        [  0,  49,  65],
        [  0,  44,  60],
        ...,
        [ 62, 110, 135],
        [104, 144, 168],
        [164, 189, 214]],

       [[  0,  52,  69],
        [  0,  47,  64],
        [  1,  47,  63],
        ...,
        [112, 154, 182],
        [140, 174, 203],
        [145, 172, 201]],

       [[  0,  45,  60],
        [  1,  45,  64],
        [  2,  49,  67],
        ...,
        [108, 143, 175],
        [ 92, 122, 154],
        [ 90, 122, 153]]], dtype=uint8)]"
Image_1896.jpg,385,186,150,123,770,578,535,309,150,daskShared_local/images/Image_1896.jpg,1896,"[array([[[148, 143, 116],
        [146, 141, 116],
        [138, 134, 113],
        ...,
        [ 58,  63,  67],
        [ 61,  67,  71],
        [ 65,  70,  74]],

       [[148, 144, 111],
        [146, 142, 112],
        [139, 136, 111],
        ...,
        [ 59,  65,  70],
        [ 61,  67,  72],
        [ 65,  70,  74]],

       [[141, 137,  99],
        [140, 136, 102],
        [137, 134, 105],
        ...,
        [ 63,  70,  76],
        [ 62,  69,  74],
        [ 64,  70,  75]],

       ...,

       [[129, 133, 134],
        [123, 127, 128],
        [126, 130, 131],
        ...,
        [ 93,  98,  91],
        [ 93, 100,  93],
        [ 71,  81,  73]],

       [[136, 140, 141],
        [128, 132, 133],
        [128, 132, 133],
        ...,
        [ 66,  70,  64],
        [ 54,  60,  55],
        [ 44,  53,  47]],

       [[145, 149, 150],
        [138, 142, 143],
        [138, 142, 143],
        ...,
        [ 50,  54,  50],
        [ 39,  45,  41],
        [ 39,  48,  43]]], dtype=uint8)]"
Image_1897.jpg,295,360,189,154,1024,683,484,514,189,daskShared_local/images/Image_1897.jpg,1897,"[array([[[173, 178, 180],
        [151, 167, 166],
        [157, 171, 171],
        ...,
        [ 81,  86,  87],
        [100, 107,  98],
        [ 81,  89,  66]],

       [[176, 188, 170],
        [147, 158, 145],
        [136, 146, 137],
        ...,
        [ 91,  94,  83],
        [117, 123,  97],
        [ 90,  97,  58]],

       [[197, 208, 191],
        [168, 176, 160],
        [145, 151, 139],
        ...,
        [ 96, 101,  90],
        [133, 138, 114],
        [100, 104,  69]],

       ...,

       [[  0, 104, 131],
        [  0, 106, 132],
        [  0, 106, 132],
        ...,
        [  0, 113, 139],
        [  0, 113, 139],
        [  0, 113, 139]],

       [[  0, 104, 131],
        [  0, 106, 132],
        [  0, 106, 132],
        ...,
        [  0, 113, 139],
        [  0, 113, 139],
        [  0, 113, 139]],

       [[  0, 104, 131],
        [  0, 106, 132],
        [  0, 106, 132],
        ...,
        [  0, 113, 139],
        [  0, 113, 139],
        [  0, 113, 139]]], dtype=uint8)]"
Image_1898.jpg,189,207,483,302,1599,1065,672,509,483,daskShared_local/images/Image_1898.jpg,1898,"[array([[[  4,   0,   1],
        [  4,   0,   1],
        [  4,   0,   1],
        ...,
        [  5,   1,   2],
        [  5,   1,   2],
        [  5,   1,   2]],

       [[  5,   1,   2],
        [  5,   1,   2],
        [  5,   1,   2],
        ...,
        [  5,   1,   2],
        [  5,   1,   2],
        [  5,   1,   2]],

       [[  5,   1,   2],
        [  5,   1,   2],
        [  5,   1,   2],
        ...,
        [  5,   1,   2],
        [  5,   1,   2],
        [  5,   1,   2]],

       ...,

       [[  5,   1,   2],
        [  3,   1,   2],
        [  3,   1,   2],
        ...,
        [ 45,  68,  88],
        [ 94, 108, 135],
        [141, 179, 191]],

       [[  4,   0,   1],
        [  2,   0,   1],
        [  3,   1,   2],
        ...,
        [ 36,  62,  55],
        [103, 113, 116],
        [110, 139, 141]],

       [[  4,   0,   1],
        [  2,   0,   1],
        [  2,   0,   1],
        ...,
        [ 76, 108,  95],
        [ 91, 107,  88],
        [146, 180, 158]]], dtype=uint8)]"
Image_1899.JPG,304,466,1475,1454,2560,1920,1779,1920,1475,daskShared_local/images/Image_1899.JPG,1899,"[array([[[ 73,  66,  32],
        [ 82,  68,  25],
        [ 83,  75,  21],
        ...,
        [172, 143,  94],
        [174, 143, 104],
        [165, 138, 114]],

       [[ 77,  64,  23],
        [ 79,  67,  25],
        [ 77,  72,  29],
        ...,
        [182, 158, 110],
        [181, 158, 119],
        [174, 154, 133]],

       [[ 69,  60,  32],
        [ 69,  64,  34],
        [ 78,  72,  38],
        ...,
        [192, 169, 131],
        [181, 162, 129],
        [168, 152, 122]],

       ...,

       [[ 80,  92,  43],
        [110, 113,  82],
        [109, 115,  79],
        ...,
        [ 92,  97,  28],
        [ 90, 100,  26],
        [ 90, 100,  17]],

       [[ 79,  88,  40],
        [ 98, 109,  76],
        [ 97, 107,  63],
        ...,
        [ 91,  96,  27],
        [ 88,  99,  28],
        [ 90,  99,  28]],

       [[ 77,  84,  43],
        [ 90,  99,  67],
        [ 92, 101,  54],
        ...,
        [ 87, 100,  30],
        [ 89, 100,  27],
        [ 91, 101,  25]]], dtype=uint8)]"
Image_19.jpg,1742,569,1365,1540,4631,3087,3107,2109,1540,daskShared_local/images/Image_19.jpg,19,"[array([[[ 21,  90, 238],
        [ 21,  90, 238],
        [ 20,  90, 238],
        ...,
        [  0,  59, 194],
        [  0,  58, 194],
        [  0,  58, 193]],

       [[ 22,  89, 238],
        [ 21,  89, 238],
        [ 21,  89, 238],
        ...,
        [  0,  58, 193],
        [  0,  58, 193],
        [  0,  58, 192]],

       [[ 22,  89, 238],
        [ 22,  89, 238],
        [ 22,  89, 238],
        ...,
        [  0,  58, 192],
        [  0,  57, 192],
        [  0,  57, 191]],

       ...,

       [[103,  90,  71],
        [ 98,  90,  81],
        [123, 130, 112],
        ...,
        [ 30,  33,  18],
        [ 30,  33,  17],
        [ 32,  35,  19]],

       [[107,  91,  70],
        [109, 103, 104],
        [120, 127, 104],
        ...,
        [ 26,  31,  15],
        [ 29,  34,  18],
        [ 31,  37,  20]],

       [[131, 128,  95],
        [114, 111, 102],
        [110, 113,  84],
        ...,
        [ 24,  29,  12],
        [ 26,  31,  15],
        [ 29,  34,  18]]], dtype=uint8)]"
Image_190.jpg,665,120,188,183,1156,650,853,303,188,daskShared_local/images/Image_190.jpg,190,"[array([[[  0, 140, 167],
        [  0, 139, 169],
        [  0, 139, 169],
        ...,
        [ 67, 155, 176],
        [ 67, 159, 180],
        [ 77, 173, 191]],

       [[  0, 144, 171],
        [  0, 141, 171],
        [  0, 140, 170],
        ...,
        [ 80, 159, 182],
        [ 66, 149, 171],
        [ 81, 169, 189]],

       [[  0, 139, 167],
        [  0, 138, 166],
        [  4, 145, 170],
        ...,
        [ 81, 164, 186],
        [ 65, 156, 177],
        [ 63, 160, 181]],

       ...,

       [[ 76,  72,  44],
        [ 85,  80,  51],
        [113, 107,  79],
        ...,
        [  5, 133, 180],
        [  7, 135, 184],
        [  7, 135, 184]],

       [[ 97,  91,  68],
        [ 97,  90,  64],
        [106,  99,  72],
        ...,
        [  8, 134, 184],
        [  8, 134, 184],
        [  7, 133, 184]],

       [[ 92,  86,  63],
        [106,  98,  75],
        [116, 109,  84],
        ...,
        [  5, 131, 179],
        [  4, 130, 178],
        [  3, 129, 179]]], dtype=uint8)]"
Image_1900.jpg,290,392,194,214,1024,768,484,606,214,daskShared_local/images/Image_1900.jpg,1900,"[array([[[ 52,  31,  26],
        [122, 103,  99],
        [ 94,  75,  71],
        ...,
        [135,  99,  63],
        [103,  68,  37],
        [ 91,  58,  27]],

       [[ 90,  68,  61],
        [ 70,  51,  43],
        [ 59,  41,  30],
        ...,
        [131,  96,  56],
        [ 99,  63,  28],
        [ 83,  48,  18]],

       [[ 98,  84,  71],
        [ 99,  85,  72],
        [105,  88,  73],
        ...,
        [132,  96,  52],
        [118,  80,  42],
        [ 78,  42,  10]],

       ...,

       [[234, 207, 170],
        [228, 201, 165],
        [235, 209, 174],
        ...,
        [201, 169, 121],
        [209, 178, 131],
        [196, 168, 124]],

       [[219, 190, 152],
        [219, 192, 155],
        [225, 201, 166],
        ...,
        [199, 168, 122],
        [199, 169, 120],
        [193, 167, 119]],

       [[226, 196, 160],
        [233, 207, 172],
        [232, 208, 173],
        ...,
        [198, 169, 128],
        [192, 162, 113],
        [194, 164, 112]]], dtype=uint8)]"
Image_1901.jpg,534,232,307,236,986,653,841,468,307,daskShared_local/images/Image_1901.jpg,1901,"[array([[[ 88,  85,  44],
        [109, 106,  65],
        [127, 127,  88],
        ...,
        [ 62, 119, 100],
        [ 62, 119, 100],
        [ 61, 118,  99]],

       [[ 87,  85,  45],
        [ 95,  93,  54],
        [114, 115,  75],
        ...,
        [ 62, 119, 100],
        [ 62, 119, 100],
        [ 61, 118,  99]],

       [[151, 149, 110],
        [164, 162, 124],
        [135, 136,  97],
        ...,
        [ 64, 121, 102],
        [ 64, 121, 102],
        [ 63, 120, 101]],

       ...,

       [[ 75,  93,  51],
        [ 80,  98,  51],
        [ 84, 101,  48],
        ...,
        [ 41,  66,  37],
        [ 43,  68,  38],
        [ 45,  70,  40]],

       [[ 73,  90,  46],
        [ 80,  96,  47],
        [ 85, 102,  44],
        ...,
        [ 42,  67,  37],
        [ 44,  69,  39],
        [ 46,  71,  39]],

       [[ 73,  91,  42],
        [ 82,  99,  43],
        [ 89, 105,  41],
        ...,
        [ 40,  65,  35],
        [ 42,  67,  36],
        [ 42,  68,  34]]], dtype=uint8)]"
Image_1902.jpg,663,234,354,313,2121,1063,1017,547,354,daskShared_local/images/Image_1902.jpg,1902,"[array([[[ 84, 118, 127],
        [107, 138, 145],
        [130, 158, 161],
        ...,
        [140, 167, 176],
        [136, 163, 172],
        [137, 162, 173]],

       [[ 72, 116, 128],
        [ 75, 115, 124],
        [ 81, 117, 124],
        ...,
        [128, 154, 161],
        [128, 153, 160],
        [133, 158, 164]],

       [[ 85, 136, 149],
        [ 76, 124, 136],
        [ 72, 116, 125],
        ...,
        [122, 147, 152],
        [126, 149, 154],
        [128, 149, 154]],

       ...,

       [[ 55, 106, 125],
        [ 53, 104, 123],
        [ 52, 103, 122],
        ...,
        [148, 139, 122],
        [156, 145, 126],
        [141, 129, 107]],

       [[ 53, 104, 123],
        [ 53, 104, 123],
        [ 52, 103, 122],
        ...,
        [162, 155, 138],
        [160, 150, 131],
        [137, 125, 104]],

       [[ 52, 103, 122],
        [ 53, 104, 123],
        [ 53, 104, 123],
        ...,
        [154, 148, 133],
        [157, 150, 132],
        [157, 147, 127]]], dtype=uint8)]"
Image_1903.jpg,1070,1210,946,827,3840,2160,2016,2037,946,daskShared_local/images/Image_1903.jpg,1903,"[array([[[202, 208, 186],
        [206, 203, 169],
        [145, 132, 104],
        ...,
        [ 63,  54,  49],
        [ 72,  60,  53],
        [ 66,  51,  46]],

       [[180, 180, 168],
        [209, 206, 182],
        [208, 198, 168],
        ...,
        [ 54,  48,  41],
        [ 57,  48,  43],
        [ 54,  43,  38]],

       [[123, 121, 115],
        [182, 182, 172],
        [200, 201, 181],
        ...,
        [ 71,  58,  52],
        [ 80,  66,  59],
        [ 85,  68,  61]],

       ...,

       [[  5,  24,  31],
        [  5,  24,  31],
        [  5,  24,  31],
        ...,
        [  3,  17,  25],
        [  2,  15,  22],
        [  4,  15,  20]],

       [[  4,  23,  29],
        [  5,  24,  30],
        [  5,  24,  30],
        ...,
        [  3,  17,  23],
        [  2,  15,  21],
        [  3,  15,  21]],

       [[  4,  23,  29],
        [  4,  23,  29],
        [  4,  23,  29],
        ...,
        [  2,  16,  20],
        [  1,  14,  20],
        [  2,  15,  21]]], dtype=uint8)]"
Image_1904.jpg,70,136,112,105,525,340,182,241,112,daskShared_local/images/Image_1904.jpg,1904,"[array([[[ 32,  85, 101],
        [ 32,  85, 101],
        [ 34,  87, 103],
        ...,
        [ 91, 118,  93],
        [103, 132, 106],
        [106, 135, 109]],

       [[ 31,  84, 100],
        [ 32,  85, 100],
        [ 33,  86, 101],
        ...,
        [ 86, 114,  88],
        [106, 134, 108],
        [110, 139, 112]],

       [[ 29,  82,  96],
        [ 28,  81,  96],
        [ 27,  80,  94],
        ...,
        [ 67,  93,  66],
        [116, 143, 116],
        [128, 154, 127]],

       ...,

       [[ 44,  72,  64],
        [ 43,  71,  63],
        [ 42,  68,  60],
        ...,
        [ 37,  49,  32],
        [ 43,  56,  38],
        [ 44,  57,  39]],

       [[ 22,  42,  36],
        [ 21,  40,  34],
        [ 17,  35,  28],
        ...,
        [ 17,  27,  15],
        [ 40,  53,  37],
        [ 45,  60,  43]],

       [[ 17,  35,  29],
        [ 16,  33,  27],
        [ 11,  27,  21],
        ...,
        [ 13,  22,  11],
        [ 39,  53,  37],
        [ 46,  60,  43]]], dtype=uint8)]"
Image_1905.jpg,558,186,103,69,1000,700,661,255,103,daskShared_local/images/Image_1905.jpg,1905,"[array([[[  2, 160, 231],
        [  2, 160, 231],
        [  1, 159, 230],
        ...,
        [  1, 158, 232],
        [  0, 158, 231],
        [  0, 158, 231]],

       [[  2, 160, 231],
        [  2, 160, 231],
        [  1, 159, 230],
        ...,
        [  1, 158, 232],
        [  0, 158, 231],
        [  0, 158, 231]],

       [[  2, 160, 231],
        [  2, 160, 231],
        [  1, 159, 230],
        ...,
        [  1, 157, 231],
        [  0, 157, 230],
        [  0, 157, 230]],

       ...,

       [[121, 162, 176],
        [121, 162, 176],
        [124, 162, 178],
        ...,
        [  1, 150, 220],
        [  0, 150, 220],
        [  0, 150, 220]],

       [[128, 167, 184],
        [129, 167, 184],
        [135, 171, 189],
        ...,
        [  0, 150, 222],
        [  0, 151, 222],
        [  0, 151, 222]],

       [[129, 167, 185],
        [129, 168, 185],
        [135, 172, 190],
        ...,
        [  0, 151, 222],
        [  0, 151, 222],
        [  0, 151, 222]]], dtype=uint8)]"
Image_1906.jpg,405,42,1082,968,1920,1080,1487,1010,1082,daskShared_local/images/Image_1906.jpg,1906,"[array([[[  0, 124, 156],
        [  0, 123, 154],
        [  0, 123, 153],
        ...,
        [ 34,  84,  80],
        [ 40,  92,  78],
        [ 34,  98,  85]],

       [[  0, 125, 157],
        [  0, 123, 155],
        [  0, 123, 156],
        ...,
        [ 17,  86,  85],
        [ 13,  83,  81],
        [  9,  90,  98]],

       [[  1, 125, 157],
        [  0, 124, 155],
        [  0, 124, 156],
        ...,
        [  5,  96, 100],
        [  1,  71,  78],
        [  2,  73,  80]],

       ...,

       [[103,  94,  57],
        [117, 108,  70],
        [110, 102,  65],
        ...,
        [ 14,  22,  25],
        [ 13,  22,  24],
        [ 13,  21,  24]],

       [[115, 107,  70],
        [104,  96,  59],
        [107,  97,  59],
        ...,
        [ 15,  21,  23],
        [ 14,  21,  23],
        [ 16,  22,  24]],

       [[100,  93,  56],
        [104,  95,  55],
        [131, 117,  73],
        ...,
        [ 16,  20,  21],
        [ 19,  22,  20],
        [ 25,  27,  24]]], dtype=uint8)]"
Image_1907.jpg,285,92,181,161,732,420,466,253,181,daskShared_local/images/Image_1907.jpg,1907,"[array([[[  0, 161, 213],
        [  0, 161, 213],
        [  0, 161, 213],
        ...,
        [  3, 189, 213],
        [  5, 181, 218],
        [  1, 181, 215]],

       [[  0, 161, 213],
        [  0, 161, 213],
        [  0, 161, 213],
        ...,
        [ 45, 192, 225],
        [ 21, 187, 222],
        [  9, 180, 215]],

       [[  0, 160, 212],
        [  0, 160, 212],
        [  0, 160, 212],
        ...,
        [ 75, 197, 235],
        [ 46, 195, 231],
        [ 34, 187, 223]],

       ...,

       [[196, 195, 164],
        [197, 197, 157],
        [195, 195, 147],
        ...,
        [ 25,  67,  42],
        [ 65,  87,  59],
        [105, 124,  87]],

       [[199, 199, 166],
        [201, 199, 160],
        [201, 200, 155],
        ...,
        [ 51, 104,  61],
        [ 96, 120,  78],
        [101, 123,  75]],

       [[189, 189, 146],
        [190, 190, 142],
        [191, 191, 140],
        ...,
        [ 55, 101,  48],
        [ 81, 100,  42],
        [ 80,  97,  34]]], dtype=uint8)]"
Image_1908.jpg,433,366,219,216,1024,683,652,582,219,daskShared_local/images/Image_1908.jpg,1908,"[array([[[168, 158, 147],
        [107,  96,  87],
        [104,  91,  84],
        ...,
        [ 54,  35,  30],
        [ 70,  51,  42],
        [ 76,  54,  43]],

       [[152, 133, 115],
        [122, 103,  89],
        [ 99,  82,  73],
        ...,
        [ 63,  43,  38],
        [ 69,  49,  41],
        [ 63,  41,  31]],

       [[ 99,  76,  55],
        [ 82,  64,  50],
        [ 62,  47,  40],
        ...,
        [ 66,  46,  43],
        [ 61,  40,  35],
        [ 57,  39,  32]],

       ...,

       [[169, 164, 117],
        [173, 166, 123],
        [220, 205, 169],
        ...,
        [246, 217, 185],
        [250, 226, 197],
        [241, 218, 191]],

       [[176, 165, 116],
        [138, 134,  88],
        [201, 190, 155],
        ...,
        [244, 218, 182],
        [244, 213, 179],
        [252, 216, 182]],

       [[162, 139,  91],
        [137, 130,  85],
        [223, 211, 177],
        ...,
        [251, 224, 177],
        [241, 202, 157],
        [232, 182, 139]]], dtype=uint8)]"
Image_1909.jpg,550,97,285,267,1024,770,835,364,285,daskShared_local/images/Image_1909.jpg,1909,"[array([[[  1, 111, 186],
        [  2, 112, 187],
        [  3, 113, 188],
        ...,
        [ 36,  34,  39],
        [ 36,  38,  42],
        [ 37,  41,  44]],

       [[  3, 114, 186],
        [  3, 114, 186],
        [  3, 114, 186],
        ...,
        [ 35,  36,  41],
        [ 32,  38,  44],
        [ 43,  49,  54]],

       [[  3, 114, 186],
        [  3, 114, 186],
        [  2, 113, 185],
        ...,
        [ 32,  35,  42],
        [ 31,  40,  46],
        [ 47,  56,  63]],

       ...,

       [[ 36,  64,  52],
        [ 38,  69,  57],
        [ 52,  87,  72],
        ...,
        [ 31,  29,  32],
        [ 32,  32,  32],
        [ 32,  32,  32]],

       [[ 68,  97,  83],
        [ 34,  66,  53],
        [ 45,  80,  64],
        ...,
        [ 34,  32,  35],
        [ 33,  33,  33],
        [ 33,  33,  33]],

       [[117, 149, 135],
        [ 46,  81,  67],
        [ 39,  76,  59],
        ...,
        [ 34,  32,  35],
        [ 34,  34,  35],
        [ 34,  34,  35]]], dtype=uint8)]"
Image_191.jpg,311,215,192,203,1000,600,503,418,203,daskShared_local/images/Image_191.jpg,191,"[array([[[  1, 146, 193],
        [  1, 146, 193],
        [  1, 146, 193],
        ...,
        [  1, 158, 201],
        [  1, 158, 201],
        [  1, 158, 201]],

       [[  0, 145, 190],
        [  0, 145, 190],
        [  0, 145, 190],
        ...,
        [  2, 160, 207],
        [  2, 160, 207],
        [  2, 160, 207]],

       [[  0, 145, 190],
        [  0, 145, 190],
        [  0, 145, 190],
        ...,
        [  2, 160, 207],
        [  2, 160, 207],
        [  2, 160, 207]],

       ...,

       [[ 56,  33,  26],
        [ 38,  29,  20],
        [ 35,  37,  23],
        ...,
        [239, 221, 171],
        [240, 220, 167],
        [239, 218, 163]],

       [[ 38,  17,  25],
        [ 34,  25,  48],
        [ 34,  34,  40],
        ...,
        [240, 219, 166],
        [240, 219, 166],
        [239, 218, 165]],

       [[ 32,  15,  25],
        [ 33,  26,  44],
        [ 29,  33,  33],
        ...,
        [238, 216, 159],
        [237, 215, 158],
        [237, 215, 158]]], dtype=uint8)]"
Image_1910.jpg,2214,270,631,488,3033,1757,2845,758,631,daskShared_local/images/Image_1910.jpg,1910,"[array([[[  0,  53, 217],
        [  0,  53, 217],
        [  0,  53, 217],
        ...,
        [  0,  53, 217],
        [  0,  53, 217],
        [  0,  53, 217]],

       [[  0,  53, 217],
        [  0,  53, 217],
        [  0,  53, 217],
        ...,
        [  0,  53, 217],
        [  0,  53, 217],
        [  0,  53, 217]],

       [[  0,  53, 217],
        [  0,  53, 217],
        [  0,  53, 217],
        ...,
        [  0,  53, 217],
        [  0,  53, 217],
        [  0,  53, 217]],

       ...,

       [[ 97, 103,  54],
        [ 94, 101,  54],
        [ 95, 101,  56],
        ...,
        [  0,  53, 217],
        [  0,  53, 217],
        [  0,  53, 217]],

       [[ 86,  92,  48],
        [ 79,  84,  43],
        [ 76,  81,  43],
        ...,
        [  0,  53, 217],
        [  0,  53, 217],
        [  0,  53, 217]],

       [[ 76,  81,  41],
        [ 65,  69,  34],
        [ 59,  62,  30],
        ...,
        [  0,  53, 217],
        [  0,  53, 217],
        [  0,  53, 217]]], dtype=uint8)]"
Image_1911.jpg,488,374,216,160,1024,678,704,534,216,daskShared_local/images/Image_1911.jpg,1911,"[array([[[102,  72,  75],
        [ 99,  68,  73],
        [103,  72,  76],
        ...,
        [184, 157,  94],
        [192, 162, 109],
        [168, 139,  96]],

       [[118,  98, 110],
        [102,  86,  96],
        [113,  92, 102],
        ...,
        [191, 168, 109],
        [188, 161, 121],
        [131, 103,  81]],

       [[115,  92, 107],
        [ 90,  74,  84],
        [109,  90, 104],
        ...,
        [190, 163, 127],
        [166, 140, 116],
        [128,  99,  90]],

       ...,

       [[245, 233, 195],
        [242, 228, 190],
        [242, 225, 181],
        ...,
        [243, 223, 170],
        [230, 205, 155],
        [241, 212, 171]],

       [[240, 235, 207],
        [244, 237, 207],
        [244, 232, 198],
        ...,
        [238, 217, 165],
        [231, 203, 153],
        [241, 211, 163]],

       [[237, 226, 195],
        [239, 227, 195],
        [241, 226, 194],
        ...,
        [234, 214, 168],
        [226, 199, 152],
        [248, 211, 167]]], dtype=uint8)]"
Image_1912.jpg,476,123,103,76,685,360,579,199,103,daskShared_local/images/Image_1912.jpg,1912,"[array([[[  0, 110, 151],
        [  0, 110, 151],
        [  1, 110, 151],
        ...,
        [  0, 101, 145],
        [  0, 101, 145],
        [  0, 101, 145]],

       [[  0, 110, 151],
        [  0, 110, 151],
        [  1, 110, 151],
        ...,
        [  0, 101, 145],
        [  0, 101, 145],
        [  0, 101, 145]],

       [[  0, 111, 151],
        [  0, 111, 151],
        [  0, 109, 150],
        ...,
        [  0, 101, 145],
        [  0, 101, 145],
        [  0, 101, 145]],

       ...,

       [[  9,  25,  36],
        [  9,  24,  36],
        [  4,  24,  34],
        ...,
        [  0,  83, 119],
        [  0,  83, 119],
        [  0,  83, 119]],

       [[ 11,  24,  31],
        [ 11,  25,  31],
        [  8,  25,  29],
        ...,
        [  0,  83, 119],
        [  0,  83, 119],
        [  0,  83, 119]],

       [[ 11,  24,  31],
        [ 11,  25,  31],
        [  9,  25,  29],
        ...,
        [  0,  83, 119],
        [  0,  83, 119],
        [  0,  83, 119]]], dtype=uint8)]"
Image_1913.jpg,330,264,130,133,1000,667,460,397,133,daskShared_local/images/Image_1913.jpg,1913,"[array([[[ 10, 209, 226],
        [ 18, 211, 227],
        [ 33, 213, 227],
        ...,
        [ 52, 210, 232],
        [ 62, 212, 233],
        [ 72, 213, 233]],

       [[ 12, 211, 227],
        [ 17, 211, 228],
        [ 23, 211, 228],
        ...,
        [ 69, 211, 232],
        [ 75, 213, 232],
        [ 81, 214, 233]],

       [[ 18, 212, 229],
        [ 22, 212, 230],
        [ 24, 211, 229],
        ...,
        [ 93, 213, 233],
        [ 98, 215, 232],
        [100, 215, 233]],

       ...,

       [[155, 111,  15],
        [134,  89,   9],
        [109,  62,   0],
        ...,
        [ 31, 110, 174],
        [ 48, 120, 182],
        [ 68, 133, 191]],

       [[154, 104,   9],
        [141,  90,   8],
        [128,  76,   9],
        ...,
        [ 23,  96, 159],
        [ 26,  96, 157],
        [ 31, 100, 158]],

       [[151,  97,   5],
        [145,  90,   8],
        [142,  86,  14],
        ...,
        [ 32,  96, 155],
        [ 25,  87, 145],
        [ 18,  83, 140]]], dtype=uint8)]"
Image_1914.jpg,582,54,166,155,930,500,748,209,166,daskShared_local/images/Image_1914.jpg,1914,"[array([[[  8, 147, 206],
        [ 10, 148, 208],
        [ 11, 149, 211],
        ...,
        [  9, 145, 203],
        [  8, 144, 202],
        [  8, 144, 202]],

       [[  8, 146, 208],
        [ 10, 148, 209],
        [ 10, 148, 210],
        ...,
        [  9, 145, 203],
        [  9, 145, 203],
        [  9, 145, 203]],

       [[  9, 147, 209],
        [ 10, 148, 210],
        [  9, 147, 210],
        ...,
        [ 10, 146, 204],
        [ 10, 146, 204],
        [ 10, 146, 204]],

       ...,

       [[223, 223, 223],
        [231, 231, 231],
        [240, 240, 240],
        ...,
        [  7, 136, 201],
        [  7, 136, 201],
        [  6, 135, 200]],

       [[222, 222, 222],
        [231, 231, 231],
        [236, 236, 236],
        ...,
        [  8, 137, 202],
        [  8, 137, 202],
        [  7, 136, 201]],

       [[220, 220, 220],
        [227, 227, 227],
        [232, 232, 232],
        ...,
        [  8, 137, 202],
        [  8, 137, 202],
        [  8, 137, 202]]], dtype=uint8)]"
Image_1915.jpg,1275,635,336,242,2106,1578,1611,877,336,daskShared_local/images/Image_1915.jpg,1915,"[array([[[ 26, 147, 150],
        [ 23, 143, 145],
        [ 22, 143, 145],
        ...,
        [ 21, 139, 140],
        [ 17, 145, 146],
        [ 14, 143, 143]],

       [[ 31, 147, 151],
        [ 26, 144, 146],
        [ 27, 146, 150],
        ...,
        [ 20, 140, 141],
        [ 15, 143, 142],
        [ 16, 144, 143]],

       [[ 30, 146, 146],
        [ 29, 147, 148],
        [ 25, 146, 146],
        ...,
        [ 15, 143, 139],
        [ 13, 136, 138],
        [ 16, 140, 142]],

       ...,

       [[ 31, 151, 146],
        [ 28, 151, 146],
        [ 30, 152, 148],
        ...,
        [ 32, 163, 155],
        [ 30, 162, 156],
        [ 27, 160, 154]],

       [[ 31, 155, 149],
        [ 29, 154, 148],
        [ 30, 156, 150],
        ...,
        [ 26, 167, 154],
        [ 31, 162, 154],
        [ 29, 162, 153]],

       [[ 37, 158, 153],
        [ 33, 155, 150],
        [ 33, 153, 149],
        ...,
        [ 33, 166, 160],
        [ 32, 163, 157],
        [ 30, 161, 155]]], dtype=uint8)]"
Image_1916.jpg,982,267,185,158,1600,1280,1167,425,185,daskShared_local/images/Image_1916.jpg,1916,"[array([[[ 34, 151, 133],
        [ 39, 156, 142],
        [ 38, 156, 137],
        ...,
        [ 32, 141, 129],
        [ 34, 138, 129],
        [ 38, 137, 132]],

       [[ 31, 150, 132],
        [ 35, 155, 140],
        [ 41, 162, 142],
        ...,
        [ 33, 142, 129],
        [ 32, 137, 127],
        [ 35, 136, 130]],

       [[ 41, 150, 112],
        [ 35, 150, 113],
        [ 37, 155, 112],
        ...,
        [ 37, 148, 132],
        [ 35, 133, 124],
        [ 40, 138, 131]],

       ...,

       [[ 64,  76,  61],
        [ 59,  66,  65],
        [ 66,  59,  50],
        ...,
        [ 23, 125,  85],
        [ 49, 149, 111],
        [ 48, 145, 112]],

       [[ 81,  88,  67],
        [ 83,  84,  73],
        [ 95,  84,  69],
        ...,
        [ 22, 122,  82],
        [ 50, 147, 109],
        [ 47, 142, 110]],

       [[104, 103,  78],
        [115, 110,  91],
        [129, 113,  91],
        ...,
        [ 29, 129,  88],
        [ 40, 138,  99],
        [ 46, 141, 107]]], dtype=uint8)]"
Image_1917.jpg,385,182,457,393,1280,854,842,575,457,daskShared_local/images/Image_1917.jpg,1917,"[array([[[104, 134, 160],
        [109, 138, 165],
        [112, 139, 166],
        ...,
        [ 13, 205, 239],
        [ 14, 208, 240],
        [ 14, 209, 241]],

       [[110, 140, 166],
        [111, 140, 166],
        [113, 140, 167],
        ...,
        [ 20, 199, 233],
        [ 15, 202, 236],
        [ 13, 206, 239]],

       [[115, 145, 171],
        [115, 145, 171],
        [117, 144, 171],
        ...,
        [ 36, 197, 228],
        [ 22, 197, 230],
        [ 17, 202, 236]],

       ...,

       [[ 54, 174, 207],
        [ 66, 174, 204],
        [ 91, 186, 213],
        ...,
        [  7, 178, 228],
        [  7, 183, 232],
        [  7, 187, 235]],

       [[ 35, 161, 199],
        [ 49, 162, 196],
        [ 69, 169, 200],
        ...,
        [ 10, 182, 232],
        [  6, 184, 233],
        [  5, 186, 235]],

       [[ 21, 150, 192],
        [ 38, 155, 194],
        [ 56, 159, 194],
        ...,
        [ 10, 184, 234],
        [  8, 186, 236],
        [  6, 187, 237]]], dtype=uint8)]"
Image_1918.jpg,60,123,187,171,600,350,247,294,187,daskShared_local/images/Image_1918.jpg,1918,"[array([[[ 25,  49,  33],
        [ 24,  51,  32],
        [ 23,  52,  32],
        ...,
        [ 46,  34,  46],
        [ 49,  38,  46],
        [ 63,  52,  58]],

       [[ 25,  50,  31],
        [ 24,  51,  32],
        [ 24,  52,  30],
        ...,
        [ 45,  37,  47],
        [ 48,  42,  52],
        [ 60,  56,  63]],

       [[ 25,  50,  31],
        [ 25,  50,  31],
        [ 23,  51,  29],
        ...,
        [ 53,  50,  61],
        [ 54,  52,  62],
        [ 61,  64,  69]],

       ...,

       [[131, 114,  97],
        [140, 126, 108],
        [143, 132, 111],
        ...,
        [125,  79,  59],
        [130,  81,  58],
        [126,  83,  58]],

       [[135, 116, 102],
        [148, 132, 117],
        [149, 137, 120],
        ...,
        [132,  96,  76],
        [135, 100,  74],
        [130,  97,  70]],

       [[157, 139, 125],
        [141, 125, 110],
        [137, 125, 108],
        ...,
        [130, 108,  85],
        [134, 118,  91],
        [136, 118,  90]]], dtype=uint8)]"
Image_1919.jpg,131,94,145,114,500,333,276,208,145,daskShared_local/images/Image_1919.jpg,1919,"[array([[[ 27,  42,  61],
        [ 27,  42,  61],
        [ 27,  43,  61],
        ...,
        [ 24,  42,  64],
        [ 24,  42,  64],
        [ 24,  42,  64]],

       [[ 26,  44,  62],
        [ 27,  44,  62],
        [ 27,  44,  62],
        ...,
        [ 24,  42,  64],
        [ 25,  43,  65],
        [ 26,  44,  66]],

       [[ 25,  44,  61],
        [ 26,  45,  62],
        [ 26,  45,  62],
        ...,
        [ 25,  43,  65],
        [ 26,  44,  66],
        [ 27,  45,  67]],

       ...,

       [[ 23,  42,  57],
        [ 23,  42,  57],
        [ 23,  42,  57],
        ...,
        [116, 133, 125],
        [115, 132, 124],
        [115, 132, 124]],

       [[ 23,  42,  57],
        [ 23,  42,  57],
        [ 23,  42,  57],
        ...,
        [117, 134, 126],
        [116, 133, 125],
        [116, 133, 125]],

       [[ 23,  42,  57],
        [ 23,  42,  57],
        [ 23,  42,  57],
        ...,
        [118, 135, 127],
        [117, 134, 126],
        [117, 134, 126]]], dtype=uint8)]"
Image_192.jpg,232,188,151,154,500,559,383,342,154,daskShared_local/images/Image_192.jpg,192,"[array([[[ 66, 170, 171],
        [ 60, 167, 169],
        [ 59, 167, 170],
        ...,
        [122, 212, 202],
        [126, 214, 205],
        [130, 216, 207]],

       [[ 67, 170, 172],
        [ 64, 167, 170],
        [ 64, 169, 172],
        ...,
        [122, 212, 203],
        [126, 214, 205],
        [131, 214, 206]],

       [[ 68, 170, 172],
        [ 69, 169, 172],
        [ 72, 171, 174],
        ...,
        [118, 210, 201],
        [122, 211, 202],
        [126, 210, 202]],

       ...,

       [[114,  89,  13],
        [111,  89,  12],
        [121, 102,  21],
        ...,
        [157, 138,  60],
        [149, 130,  47],
        [131, 111,  32]],

       [[128,  97,  14],
        [113,  90,  11],
        [113,  94,  16],
        ...,
        [115, 101,  54],
        [121, 104,  54],
        [125, 106,  46]],

       [[136, 105,  17],
        [114,  91,   9],
        [102,  84,   7],
        ...,
        [ 70,  61,  29],
        [106,  93,  55],
        [147, 132,  72]]], dtype=uint8)]"
Image_1920.jpg,400,176,86,71,800,600,486,247,86,daskShared_local/images/Image_1920.jpg,1920,"[array([[[ 75, 132, 154],
        [ 75, 132, 154],
        [ 75, 131, 155],
        ...,
        [ 59, 118, 175],
        [ 59, 118, 175],
        [ 59, 118, 175]],

       [[ 73, 132, 155],
        [ 73, 132, 155],
        [ 73, 131, 156],
        ...,
        [ 59, 118, 175],
        [ 59, 118, 175],
        [ 59, 118, 175]],

       [[ 80, 132, 152],
        [ 80, 132, 152],
        [ 81, 132, 153],
        ...,
        [ 59, 118, 177],
        [ 60, 117, 177],
        [ 60, 118, 177]],

       ...,

       [[ 87,  97, 131],
        [ 85,  94, 130],
        [ 92, 103, 133],
        ...,
        [ 21, 129, 246],
        [ 21, 129, 245],
        [ 21, 129, 245]],

       [[ 86,  93, 139],
        [ 84,  90, 139],
        [ 92,  99, 140],
        ...,
        [ 22, 128, 246],
        [ 22, 128, 245],
        [ 22, 128, 245]],

       [[ 87,  94, 137],
        [ 84,  92, 136],
        [ 92, 100, 138],
        ...,
        [ 22, 128, 246],
        [ 22, 128, 245],
        [ 22, 128, 245]]], dtype=uint8)]"
Image_1921.jpg,878,524,221,187,1920,1200,1099,711,221,daskShared_local/images/Image_1921.jpg,1921,"[array([[[  0, 112, 114],
        [  0, 111, 114],
        [  1, 109, 112],
        ...,
        [  2, 122, 123],
        [  3, 123, 124],
        [  3, 126, 124]],

       [[  3, 112, 115],
        [  4, 113, 116],
        [  2, 111, 114],
        ...,
        [  0, 120, 121],
        [  0, 121, 122],
        [  2, 125, 123]],

       [[  4, 112, 115],
        [  4, 113, 115],
        [  0, 114, 114],
        ...,
        [  3, 123, 124],
        [  3, 124, 125],
        [  1, 124, 122]],

       ...,

       [[106,  96,  71],
        [122, 113,  87],
        [120, 114,  86],
        ...,
        [164, 133,  94],
        [224, 192, 159],
        [208, 177, 149]],

       [[ 86,  76,  52],
        [101,  91,  68],
        [124, 116,  92],
        ...,
        [131,  97,  59],
        [216, 183, 151],
        [210, 178, 152]],

       [[ 91,  81,  58],
        [ 81,  73,  52],
        [121, 113,  91],
        ...,
        [117,  83,  47],
        [158, 127,  96],
        [176, 146, 122]]], dtype=uint8)]"
Image_1922.jpg,167,10,102,100,498,272,269,110,102,daskShared_local/images/Image_1922.jpg,1922,"[array([[[  1,  38,  75],
        [  1,  38,  75],
        [  0,  36,  73],
        ...,
        [  1,  31,  55],
        [  0,  30,  54],
        [  0,  30,  54]],

       [[  1,  38,  75],
        [  1,  38,  75],
        [  0,  36,  73],
        ...,
        [  1,  31,  55],
        [  0,  30,  54],
        [  0,  30,  54]],

       [[  0,  38,  75],
        [  0,  38,  75],
        [  0,  37,  74],
        ...,
        [  3,  31,  54],
        [  1,  30,  54],
        [  1,  30,  54]],

       ...,

       [[108, 119, 120],
        [108, 119, 120],
        [108, 120, 115],
        ...,
        [183, 197, 188],
        [183, 198, 190],
        [183, 198, 191]],

       [[115, 129, 128],
        [116, 130, 128],
        [121, 136, 128],
        ...,
        [192, 207, 198],
        [191, 206, 198],
        [190, 206, 198]],

       [[116, 130, 128],
        [116, 130, 128],
        [122, 137, 129],
        ...,
        [193, 208, 199],
        [191, 206, 198],
        [191, 206, 198]]], dtype=uint8)]"
Image_1923.JPG,475,412,524,309,1600,1467,999,721,524,daskShared_local/images/Image_1923.JPG,1923,"[array([[[ 60,  77,  80],
        [ 62,  79,  78],
        [ 57,  78,  80],
        ...,
        [103, 110,  90],
        [103, 111,  93],
        [ 95, 106,  90]],

       [[ 65,  79,  79],
        [ 62,  80,  78],
        [ 61,  83,  81],
        ...,
        [111, 115,  96],
        [102, 105,  87],
        [100, 106,  91]],

       [[ 64,  81,  83],
        [ 63,  83,  83],
        [ 63,  84,  78],
        ...,
        [113, 114,  99],
        [ 95,  97,  86],
        [ 95, 100,  91]],

       ...,

       [[163, 164, 118],
        [184, 183, 131],
        [205, 201, 148],
        ...,
        [165, 170, 147],
        [168, 173, 150],
        [183, 188, 166]],

       [[178, 179, 139],
        [206, 206, 147],
        [220, 214, 153],
        ...,
        [155, 160, 139],
        [157, 162, 142],
        [146, 150, 132]],

       [[198, 196, 147],
        [213, 212, 153],
        [218, 214, 150],
        ...,
        [143, 146, 129],
        [127, 129, 113],
        [119, 121, 105]]], dtype=uint8)]"
Image_1924.jpg,675,294,283,307,1600,900,958,601,307,daskShared_local/images/Image_1924.jpg,1924,"[array([[[  0, 116, 199],
        [  0, 116, 199],
        [  0, 116, 199],
        ...,
        [  0, 116, 201],
        [  0, 116, 201],
        [  1, 117, 202]],

       [[  0, 116, 199],
        [  0, 116, 199],
        [  0, 116, 199],
        ...,
        [  0, 116, 201],
        [  0, 116, 201],
        [  1, 117, 202]],

       [[  0, 116, 199],
        [  0, 116, 199],
        [  0, 116, 199],
        ...,
        [  0, 116, 200],
        [  0, 116, 200],
        [  1, 117, 201]],

       ...,

       [[138, 126,  88],
        [170, 159, 121],
        [210, 202, 162],
        ...,
        [192, 193, 155],
        [110, 109,  76],
        [156, 154, 126]],

       [[201, 190, 149],
        [195, 187, 147],
        [219, 212, 172],
        ...,
        [179, 179, 140],
        [ 94,  94,  60],
        [124, 123,  93]],

       [[219, 210, 168],
        [197, 189, 149],
        [216, 209, 170],
        ...,
        [157, 153, 114],
        [109, 104,  68],
        [142, 138, 104]]], dtype=uint8)]"
Image_1925.jpg,76,73,88,85,300,260,164,158,88,daskShared_local/images/Image_1925.jpg,1925,"[array([[[  2, 228, 252],
        [  2, 228, 253],
        [  1, 227, 252],
        ...,
        [112, 224, 229],
        [139, 232, 239],
        [132, 230, 236]],

       [[  2, 228, 253],
        [  2, 228, 253],
        [  1, 227, 252],
        ...,
        [ 95, 220, 225],
        [127, 228, 237],
        [119, 226, 234]],

       [[  2, 228, 252],
        [  2, 228, 252],
        [  1, 227, 252],
        ...,
        [163, 235, 239],
        [177, 241, 244],
        [173, 240, 243]],

       ...,

       [[  1, 187, 238],
        [  1, 187, 238],
        [  1, 186, 239],
        ...,
        [  6,  39,  26],
        [  5,  42,  29],
        [  6,  41,  28]],

       [[  1, 187, 238],
        [  1, 187, 238],
        [  0, 186, 238],
        ...,
        [  7,  22,  19],
        [  7,  26,  23],
        [  7,  25,  22]],

       [[  1, 187, 238],
        [  1, 187, 238],
        [  1, 186, 238],
        ...,
        [  7,  26,  21],
        [  7,  30,  25],
        [  7,  29,  24]]], dtype=uint8)]"
Image_1926.jpg,329,276,94,65,800,600,423,341,94,daskShared_local/images/Image_1926.jpg,1926,"[array([[[  1, 160, 254],
        [  1, 160, 254],
        [  1, 160, 254],
        ...,
        [  1, 164, 255],
        [  1, 164, 255],
        [  1, 164, 255]],

       [[  1, 160, 254],
        [  1, 160, 254],
        [  1, 160, 254],
        ...,
        [  1, 164, 255],
        [  1, 164, 255],
        [  1, 164, 255]],

       [[  1, 160, 254],
        [  1, 160, 254],
        [  1, 160, 254],
        ...,
        [  2, 164, 255],
        [  2, 163, 254],
        [  2, 163, 254]],

       ...,

       [[145, 191, 142],
        [146, 192, 143],
        [138, 184, 133],
        ...,
        [ 31,  39,  25],
        [ 33,  41,  26],
        [ 33,  41,  26]],

       [[140, 185, 136],
        [140, 186, 137],
        [133, 177, 127],
        ...,
        [ 32,  40,  27],
        [ 35,  43,  29],
        [ 34,  43,  29]],

       [[140, 186, 136],
        [141, 186, 137],
        [134, 178, 127],
        ...,
        [ 32,  40,  27],
        [ 34,  43,  29],
        [ 34,  42,  29]]], dtype=uint8)]"
Image_1927.jpg,301,236,296,264,1000,664,597,500,296,daskShared_local/images/Image_1927.jpg,1927,"[array([[[194, 198, 201],
        [194, 198, 201],
        [195, 199, 202],
        ...,
        [182, 163, 152],
        [166, 148, 136],
        [165, 145, 134]],

       [[197, 201, 204],
        [197, 201, 204],
        [198, 202, 205],
        ...,
        [180, 159, 148],
        [172, 151, 140],
        [171, 149, 137]],

       [[199, 203, 206],
        [199, 203, 206],
        [198, 203, 206],
        ...,
        [165, 144, 134],
        [169, 148, 138],
        [169, 146, 135]],

       ...,

       [[160, 132,  97],
        [162, 133, 101],
        [160, 132,  94],
        ...,
        [154, 132, 106],
        [152, 130, 104],
        [151, 130, 104]],

       [[156, 127,  98],
        [152, 123,  96],
        [151, 125,  89],
        ...,
        [159, 138, 114],
        [157, 137, 113],
        [154, 134, 110]],

       [[155, 126, 106],
        [150, 121, 104],
        [139, 121,  95],
        ...,
        [170, 150, 126],
        [171, 151, 127],
        [170, 151, 128]]], dtype=uint8)]"
Image_1928.jpg,319,160,165,175,1200,735,484,335,175,daskShared_local/images/Image_1928.jpg,1928,"[array([[[ 98, 184, 201],
        [ 99, 185, 202],
        [102, 187, 205],
        ...,
        [ 14,  29,  60],
        [ 11,  29,  58],
        [  2,  18,  45]],

       [[ 92, 176, 194],
        [ 93, 176, 194],
        [ 95, 179, 197],
        ...,
        [ 20,  35,  62],
        [ 18,  37,  63],
        [ 14,  37,  61]],

       [[ 83, 166, 184],
        [ 82, 165, 183],
        [ 85, 168, 186],
        ...,
        [ 23,  37,  58],
        [ 23,  41,  62],
        [ 20,  43,  63]],

       ...,

       [[165, 208, 199],
        [161, 206, 193],
        [154, 199, 184],
        ...,
        [ 90,  81,  51],
        [128, 120,  79],
        [151, 142,  95]],

       [[158, 201, 192],
        [156, 202, 189],
        [154, 200, 184],
        ...,
        [ 26,  23,   5],
        [ 64,  61,  33],
        [141, 136, 100]],

       [[151, 195, 185],
        [151, 196, 184],
        [152, 198, 183],
        ...,
        [  6,   7,   0],
        [ 20,  20,   9],
        [ 65,  63,  42]]], dtype=uint8)]"
Image_1929.jpg,326,225,811,620,1500,1125,1137,845,811,daskShared_local/images/Image_1929.jpg,1929,"[array([[[ 94, 170, 166],
        [ 95, 170, 166],
        [ 96, 170, 168],
        ...,
        [117, 136, 143],
        [117, 138, 147],
        [117, 140, 150]],

       [[ 94, 171, 167],
        [ 95, 170, 166],
        [ 96, 170, 167],
        ...,
        [117, 134, 143],
        [116, 135, 147],
        [120, 139, 149]],

       [[ 92, 170, 169],
        [ 95, 170, 167],
        [ 97, 170, 168],
        ...,
        [114, 131, 145],
        [115, 131, 143],
        [121, 137, 147]],

       ...,

       [[ 80, 167, 213],
        [ 81, 166, 213],
        [ 83, 168, 212],
        ...,
        [ 92, 136, 141],
        [ 88, 136, 139],
        [ 90, 136, 140]],

       [[ 82, 166, 213],
        [ 82, 166, 212],
        [ 82, 165, 212],
        ...,
        [ 93, 136, 141],
        [ 88, 135, 139],
        [ 92, 136, 139]],

       [[ 82, 167, 215],
        [ 79, 165, 211],
        [ 80, 163, 214],
        ...,
        [ 91, 135, 139],
        [ 90, 134, 138],
        [ 97, 137, 138]]], dtype=uint8)]"
Image_193.png,390,191,309,275,900,600,699,466,309,daskShared_local/images/Image_193.png,193,"[array([[[115, 105, 107],
        [126, 120, 113],
        [135, 136, 131],
        ...,
        [ 25, 149, 179],
        [ 30, 150, 180],
        [ 26, 153, 186]],

       [[131, 113, 106],
        [122, 102,  91],
        [126, 122, 115],
        ...,
        [ 20, 153, 179],
        [ 30, 149, 183],
        [ 24, 147, 187]],

       [[123, 114, 106],
        [118, 101,  96],
        [117, 112, 106],
        ...,
        [ 22, 150, 182],
        [ 20, 151, 178],
        [ 21, 153, 184]],

       ...,

       [[ 21,  81,  83],
        [ 25,  70,  68],
        [ 20,  61,  62],
        ...,
        [ 79, 149, 141],
        [ 88, 146, 140],
        [ 85, 149, 139]],

       [[ 17,  59,  57],
        [ 18,  58,  57],
        [ 25,  54,  56],
        ...,
        [ 82, 148, 140],
        [ 82, 147, 140],
        [ 79, 157, 141]],

       [[ 18,  58,  57],
        [ 20,  57,  56],
        [ 20,  57,  55],
        ...,
        [ 77, 153, 144],
        [ 82, 149, 147],
        [ 87, 154, 144]]], dtype=uint8)]"
Image_1930.jpg,430,207,193,183,1024,683,623,390,193,daskShared_local/images/Image_1930.jpg,1930,"[array([[[121, 114,   0],
        [117, 119,   0],
        [158, 121,  19],
        ...,
        [171, 128,  16],
        [182, 139,  27],
        [190, 146,  37]],

       [[139, 127,  14],
        [139, 130,  14],
        [174, 128,  22],
        ...,
        [188, 145,  30],
        [191, 148,  37],
        [185, 140,  39]],

       [[132, 108,   7],
        [151, 126,  18],
        [181, 131,  10],
        ...,
        [200, 159,  36],
        [170, 128,  11],
        [145, 101,   3]],

       ...,

       [[  1, 197, 209],
        [  1, 197, 209],
        [  5, 197, 210],
        ...,
        [  1, 152, 169],
        [  2, 152, 169],
        [  1, 151, 168]],

       [[  3, 197, 209],
        [  3, 197, 209],
        [  5, 195, 207],
        ...,
        [  2, 154, 168],
        [  1, 153, 167],
        [  0, 152, 166]],

       [[  3, 195, 206],
        [  3, 195, 206],
        [  5, 196, 206],
        ...,
        [  4, 156, 170],
        [  2, 154, 168],
        [  0, 152, 166]]], dtype=uint8)]"
Image_1931.jpg,386,109,172,170,800,600,558,279,172,daskShared_local/images/Image_1931.jpg,1931,"[array([[[228, 235, 194],
        [235, 243, 204],
        [229, 239, 203],
        ...,
        [ 55, 119,  95],
        [ 48, 113,  89],
        [ 43, 110,  87]],

       [[204, 215, 178],
        [210, 223, 186],
        [207, 221, 188],
        ...,
        [ 49, 113,  91],
        [ 46, 112,  89],
        [ 45, 112,  88]],

       [[198, 210, 182],
        [206, 220, 193],
        [205, 221, 194],
        ...,
        [ 52, 118,  94],
        [ 50, 119,  93],
        [ 52, 123,  96]],

       ...,

       [[246, 143,  31],
        [244, 142,  31],
        [242, 140,  32],
        ...,
        [ 88, 111,  85],
        [ 62,  87,  59],
        [ 84, 109,  77]],

       [[239, 137,  26],
        [240, 138,  28],
        [240, 138,  31],
        ...,
        [ 59,  80,  54],
        [ 32,  57,  29],
        [ 41,  68,  35]],

       [[238, 138,  26],
        [240, 139,  30],
        [239, 140,  32],
        ...,
        [ 52,  71,  43],
        [ 32,  56,  27],
        [ 19,  49,  13]]], dtype=uint8)]"
Image_1932.jpg,134,38,137,141,425,282,271,179,141,daskShared_local/images/Image_1932.jpg,1932,"[array([[[  0,  81, 128],
        [  0,  80, 128],
        [  0,  80, 129],
        ...,
        [  0, 121, 168],
        [  0, 121, 169],
        [  1, 122, 169]],

       [[  1,  80, 128],
        [  1,  80, 128],
        [  1,  80, 129],
        ...,
        [  0, 120, 167],
        [  0, 120, 168],
        [  0, 121, 169]],

       [[  1,  79, 127],
        [  1,  79, 127],
        [  1,  79, 128],
        ...,
        [  0, 118, 166],
        [  0, 118, 166],
        [  0, 119, 167]],

       ...,

       [[ 19,  14,  10],
        [ 16,  13,   8],
        [ 12,  11,   5],
        ...,
        [  6,  46,  56],
        [  6,  42,  49],
        [  3,  40,  46]],

       [[ 19,  15,  10],
        [ 16,  14,   9],
        [ 13,  12,   5],
        ...,
        [ 17,  49,  56],
        [ 18,  45,  48],
        [ 20,  46,  45]],

       [[ 18,  14,  10],
        [ 16,  14,   8],
        [ 13,  12,   4],
        ...,
        [ 26,  53,  58],
        [ 28,  49,  48],
        [ 35,  53,  47]]], dtype=uint8)]"
Image_1933.jpg,317,36,139,79,623,200,456,115,139,daskShared_local/images/Image_1933.jpg,1933,"[array([[[  3, 167, 255],
        [  3, 167, 255],
        [  3, 167, 255],
        ...,
        [  2, 130, 255],
        [  2, 130, 255],
        [  2, 130, 255]],

       [[  3, 167, 255],
        [  3, 167, 255],
        [  3, 167, 255],
        ...,
        [  2, 130, 255],
        [  2, 130, 255],
        [  2, 130, 255]],

       [[  2, 166, 255],
        [  2, 166, 255],
        [  2, 166, 255],
        ...,
        [  2, 130, 255],
        [  2, 130, 255],
        [  2, 130, 255]],

       ...,

       [[ 55,  99,  66],
        [ 57, 101,  69],
        [ 65, 109,  76],
        ...,
        [  1,  90, 255],
        [  2,  90, 255],
        [  3,  90, 255]],

       [[ 54,  99,  68],
        [ 55, 100,  69],
        [ 61, 106,  77],
        ...,
        [  4,  90, 255],
        [  3,  90, 255],
        [  2,  91, 255]],

       [[ 57, 102,  73],
        [ 55, 100,  72],
        [ 55, 101,  75],
        ...,
        [  8,  93, 254],
        [  5,  93, 255],
        [  3,  93, 255]]], dtype=uint8)]"
Image_1934.jpg,71,181,222,156,600,600,293,337,222,daskShared_local/images/Image_1934.jpg,1934,"[array([[[141, 159, 161],
        [139, 156, 154],
        [145, 156, 148],
        ...,
        [139, 153, 135],
        [142, 157, 138],
        [142, 157, 138]],

       [[147, 166, 160],
        [142, 157, 152],
        [148, 156, 147],
        ...,
        [144, 158, 143],
        [139, 155, 140],
        [136, 153, 135]],

       [[165, 183, 169],
        [160, 175, 165],
        [156, 166, 156],
        ...,
        [146, 163, 148],
        [138, 154, 141],
        [136, 153, 138]],

       ...,

       [[175, 167, 131],
        [171, 165, 128],
        [169, 165, 124],
        ...,
        [133, 113,  75],
        [132, 113,  75],
        [130, 112,  75]],

       [[167, 161, 127],
        [165, 159, 127],
        [162, 157, 120],
        ...,
        [129, 112,  73],
        [130, 111,  73],
        [130, 112,  74]],

       [[153, 153, 119],
        [148, 147, 119],
        [144, 143, 114],
        ...,
        [128, 110,  72],
        [130, 112,  74],
        [129, 111,  71]]], dtype=uint8)]"
Image_1935.jpg,797,237,229,202,1400,787,1026,439,229,daskShared_local/images/Image_1935.jpg,1935,"[array([[[ 80, 140, 210],
        [ 80, 140, 210],
        [ 81, 141, 211],
        ...,
        [ 92, 159, 230],
        [ 91, 158, 229],
        [ 90, 158, 229]],

       [[ 82, 142, 212],
        [ 82, 142, 212],
        [ 82, 142, 212],
        ...,
        [ 90, 157, 228],
        [ 90, 158, 229],
        [ 90, 158, 229]],

       [[ 83, 143, 213],
        [ 84, 144, 214],
        [ 82, 142, 212],
        ...,
        [ 90, 157, 228],
        [ 90, 158, 229],
        [ 90, 158, 229]],

       ...,

       [[212, 177, 155],
        [200, 164, 142],
        [195, 161, 137],
        ...,
        [ 44,  86,  92],
        [ 46,  85, 100],
        [ 49,  87, 102]],

       [[199, 164, 142],
        [199, 163, 141],
        [200, 165, 140],
        ...,
        [ 53,  96, 102],
        [ 55,  97, 109],
        [ 58,  99, 112]],

       [[193, 158, 136],
        [231, 195, 173],
        [242, 209, 184],
        ...,
        [ 67, 110, 116],
        [ 67, 111, 121],
        [ 65, 109, 120]]], dtype=uint8)]"
Image_1936.jpg,419,347,297,236,1536,1024,716,583,297,daskShared_local/images/Image_1936.jpg,1936,"[array([[[  9, 131, 242],
        [  9, 131, 242],
        [  9, 131, 242],
        ...,
        [ 20, 187, 253],
        [ 17, 181, 250],
        [ 11, 173, 245]],

       [[ 16, 138, 249],
        [ 16, 138, 249],
        [ 16, 138, 249],
        ...,
        [ 22, 190, 254],
        [ 19, 185, 254],
        [ 13, 176, 247]],

       [[ 10, 139, 243],
        [ 13, 142, 245],
        [ 17, 146, 248],
        ...,
        [ 14, 178, 244],
        [ 15, 178, 245],
        [ 12, 175, 243]],

       ...,

       [[ 11,  63, 210],
        [ 12,  64, 212],
        [  7,  61, 211],
        ...,
        [ 28,  24,  33],
        [ 18,  37,  25],
        [  4,  37,  17]],

       [[  2,  54, 189],
        [ 10,  63, 205],
        [  8,  60, 210],
        ...,
        [ 43,  29,  27],
        [ 37,  37,  22],
        [ 16,  38,  28]],

       [[  1,  50, 178],
        [ 10,  62, 201],
        [ 12,  63, 212],
        ...,
        [ 12,  55,  42],
        [ 18,  63,  48],
        [  8,  60,  51]]], dtype=uint8)]"
Image_1937.jpg,358,138,250,195,869,574,608,333,250,daskShared_local/images/Image_1937.jpg,1937,"[array([[[ 77, 172, 240],
        [ 75, 170, 240],
        [ 73, 171, 243],
        ...,
        [ 80, 165, 242],
        [ 81, 167, 243],
        [ 82, 168, 245]],

       [[ 68, 168, 235],
        [ 79, 171, 239],
        [ 73, 169, 239],
        ...,
        [ 83, 165, 241],
        [ 84, 166, 242],
        [ 85, 167, 243]],

       [[ 59, 174, 238],
        [ 74, 176, 242],
        [ 78, 171, 240],
        ...,
        [ 83, 165, 241],
        [ 83, 165, 241],
        [ 83, 165, 241]],

       ...,

       [[  9,  18,  15],
        [  4,  11,   9],
        [ 11,  19,  17],
        ...,
        [  2, 104, 179],
        [  2, 104, 179],
        [  2, 104, 179]],

       [[  7,  12,  14],
        [  5,  21,  17],
        [  5,  39,  28],
        ...,
        [  2, 104, 179],
        [  2, 104, 179],
        [  2, 104, 179]],

       [[  0,  22,  11],
        [  1,  33,  16],
        [  6,  60,  37],
        ...,
        [  1, 103, 178],
        [  1, 103, 178],
        [  1, 103, 178]]], dtype=uint8)]"
Image_1938.jpg,295,171,221,199,1000,664,516,370,221,daskShared_local/images/Image_1938.jpg,1938,"[array([[[  0,  79, 145],
        [  0,  78, 146],
        [  0,  77, 144],
        ...,
        [  1,  98, 168],
        [  0,  98, 169],
        [  0,  99, 167]],

       [[  0,  79, 146],
        [  0,  78, 145],
        [  0,  79, 146],
        ...,
        [  0,  98, 167],
        [  1,  98, 167],
        [  0,  97, 166]],

       [[  0,  79, 146],
        [  1,  80, 146],
        [  0,  79, 145],
        ...,
        [  0,  98, 164],
        [  0,  97, 166],
        [  1,  96, 168]],

       ...,

       [[ 41,  45,  40],
        [ 47,  49,  43],
        [ 45,  51,  43],
        ...,
        [207, 190, 140],
        [201, 184, 131],
        [194, 185, 159]],

       [[ 39,  56,  56],
        [ 49,  62,  54],
        [ 45,  56,  47],
        ...,
        [227, 213, 169],
        [223, 210, 157],
        [203, 196, 168]],

       [[ 30,  48,  55],
        [ 44,  68,  63],
        [ 42,  60,  51],
        ...,
        [231, 216, 171],
        [233, 221, 176],
        [210, 199, 176]]], dtype=uint8)]"
Image_1939.jpg,611,219,382,439,1600,1070,993,658,439,daskShared_local/images/Image_1939.jpg,1939,"[array([[[ 22,  75, 145],
        [ 22,  75, 145],
        [ 22,  75, 145],
        ...,
        [ 28,  69, 133],
        [ 28,  69, 133],
        [ 28,  69, 133]],

       [[ 22,  75, 145],
        [ 22,  75, 145],
        [ 22,  75, 145],
        ...,
        [ 28,  69, 133],
        [ 28,  69, 133],
        [ 28,  69, 133]],

       [[ 20,  76, 145],
        [ 21,  75, 145],
        [ 24,  74, 145],
        ...,
        [ 28,  69, 133],
        [ 28,  69, 133],
        [ 28,  69, 133]],

       ...,

       [[154, 141, 115],
        [177, 161, 128],
        [203, 182, 141],
        ...,
        [217, 176, 100],
        [239, 198, 140],
        [251, 216, 160]],

       [[126, 119,  99],
        [147, 142, 119],
        [172, 166, 137],
        ...,
        [204, 169,  92],
        [189, 155, 102],
        [223, 196, 151]],

       [[117,  90,  72],
        [117,  96,  82],
        [131, 116, 101],
        ...,
        [189, 159, 114],
        [147, 114,  71],
        [193, 157, 112]]], dtype=uint8)]"
Image_194.jpg,279,169,175,165,800,533,454,334,175,daskShared_local/images/Image_194.jpg,194,"[array([[[233, 206, 185],
        [236, 214, 185],
        [237, 216, 185],
        ...,
        [102, 100, 121],
        [ 98,  96, 116],
        [ 73,  72,  90]],

       [[237, 214, 201],
        [240, 219, 199],
        [238, 217, 195],
        ...,
        [ 65,  63,  84],
        [ 86,  85, 103],
        [ 96,  95, 111]],

       [[243, 226, 222],
        [246, 225, 216],
        [242, 220, 210],
        ...,
        [ 26,  25,  43],
        [ 48,  47,  64],
        [ 88,  87, 103]],

       ...,

       [[168, 132, 118],
        [173, 146, 126],
        [172, 147, 125],
        ...,
        [105,  91,  82],
        [103,  89,  80],
        [ 99,  85,  76]],

       [[164, 129, 114],
        [174, 147, 128],
        [171, 146, 126],
        ...,
        [101,  87,  78],
        [ 97,  83,  74],
        [ 93,  79,  70]],

       [[159, 124, 108],
        [182, 154, 135],
        [181, 154, 135],
        ...,
        [104,  90,  81],
        [ 98,  84,  75],
        [ 94,  80,  71]]], dtype=uint8)]"
Image_1940.jpg,453,219,166,186,1200,630,619,405,186,daskShared_local/images/Image_1940.jpg,1940,"[array([[[ 25, 100, 168],
        [ 21,  96, 163],
        [ 19,  94, 161],
        ...,
        [ 62, 102,  94],
        [ 34,  68,  65],
        [ 20,  51,  51]],

       [[ 28, 103, 171],
        [ 27, 102, 169],
        [ 27, 102, 169],
        ...,
        [ 67, 106,  99],
        [ 34,  68,  65],
        [ 21,  51,  51]],

       [[ 28, 103, 171],
        [ 30, 105, 172],
        [ 30, 107, 173],
        ...,
        [ 87, 124, 117],
        [ 32,  64,  61],
        [ 28,  57,  55]],

       ...,

       [[ 46,  95, 110],
        [ 56, 107, 119],
        [ 45,  99, 107],
        ...,
        [ 20,  19,  24],
        [ 21,  20,  25],
        [ 24,  25,  29]],

       [[ 32,  79,  97],
        [ 27,  76,  91],
        [ 16,  67,  79],
        ...,
        [ 24,  23,  28],
        [ 29,  28,  33],
        [ 37,  36,  41]],

       [[ 32,  79,  99],
        [ 27,  74,  90],
        [ 17,  66,  80],
        ...,
        [ 26,  25,  30],
        [ 30,  29,  34],
        [ 42,  41,  46]]], dtype=uint8)]"
Image_1941.jpg,1864,624,1220,1156,4752,3168,3084,1780,1220,daskShared_local/images/Image_1941.jpg,1941,"[array([[[ 66,  70,  51],
        [ 67,  69,  52],
        [ 69,  69,  48],
        ...,
        [ 52, 126, 150],
        [ 55, 128, 151],
        [ 55, 127, 151]],

       [[ 68,  67,  44],
        [ 69,  68,  45],
        [ 69,  67,  41],
        ...,
        [ 51, 124, 149],
        [ 53, 125, 149],
        [ 53, 124, 148]],

       [[ 67,  61,  37],
        [ 67,  61,  36],
        [ 68,  63,  34],
        ...,
        [ 49, 120, 148],
        [ 49, 121, 148],
        [ 50, 121, 149]],

       ...,

       [[ 14, 103, 141],
        [ 24, 105, 142],
        [ 17, 100, 141],
        ...,
        [175, 161, 124],
        [140, 124,  98],
        [100,  86,  75]],

       [[ 39, 120, 149],
        [ 45, 121, 150],
        [ 31, 111, 143],
        ...,
        [186, 174, 135],
        [149, 138, 112],
        [103,  89,  79]],

       [[ 52, 134, 155],
        [ 51, 131, 153],
        [ 46, 126, 150],
        ...,
        [181, 167, 130],
        [147, 133, 111],
        [114,  99,  84]]], dtype=uint8)]"
Image_1942.jpg,415,139,234,233,1024,686,649,372,234,daskShared_local/images/Image_1942.jpg,1942,"[array([[[ 32, 190, 241],
        [ 31, 187, 238],
        [ 31, 187, 238],
        ...,
        [  0, 157, 218],
        [  0, 157, 218],
        [  0, 156, 217]],

       [[ 29, 188, 238],
        [ 30, 186, 237],
        [ 30, 186, 237],
        ...,
        [  1, 156, 218],
        [  1, 156, 218],
        [  0, 156, 217]],

       [[ 26, 187, 236],
        [ 30, 186, 237],
        [ 30, 186, 237],
        ...,
        [  1, 155, 217],
        [  1, 155, 217],
        [  0, 156, 217]],

       ...,

       [[217, 197, 185],
        [204, 179, 171],
        [208, 186, 179],
        ...,
        [  5, 117, 183],
        [  4, 116, 182],
        [  3, 115, 181]],

       [[207, 190, 176],
        [205, 184, 177],
        [201, 182, 176],
        ...,
        [  5, 117, 183],
        [  4, 116, 182],
        [  2, 114, 180]],

       [[233, 220, 207],
        [228, 210, 205],
        [215, 198, 194],
        ...,
        [  4, 116, 182],
        [  4, 116, 182],
        [  2, 115, 181]]], dtype=uint8)]"
Image_1943.jpg,445,235,166,162,900,586,611,397,166,daskShared_local/images/Image_1943.jpg,1943,"[array([[[203, 230, 252],
        [195, 228, 251],
        [190, 228, 251],
        ...,
        [ 96, 202, 224],
        [ 96, 202, 224],
        [ 98, 203, 225]],

       [[182, 221, 223],
        [177, 220, 221],
        [175, 221, 221],
        ...,
        [ 94, 202, 225],
        [ 95, 203, 226],
        [ 97, 203, 226]],

       [[176, 221, 228],
        [173, 221, 225],
        [171, 221, 224],
        ...,
        [ 92, 202, 225],
        [ 93, 202, 225],
        [ 94, 202, 226]],

       ...,

       [[ 23,  78,  74],
        [ 26,  93,  88],
        [ 11,  93,  84],
        ...,
        [  1, 163, 209],
        [  1, 163, 209],
        [  1, 163, 209]],

       [[ 43,  74,  72],
        [ 58, 101,  97],
        [ 33,  96,  86],
        ...,
        [  1, 163, 209],
        [  1, 163, 209],
        [  1, 163, 209]],

       [[ 44,  54,  52],
        [ 94, 118, 115],
        [ 75, 132, 121],
        ...,
        [  1, 163, 209],
        [  1, 163, 209],
        [  1, 163, 209]]], dtype=uint8)]"
Image_1944.png,238,33,87,82,589,295,325,115,87,daskShared_local/images/Image_1944.png,1944,"[array([[[  0, 174, 195],
        [  0, 175, 195],
        [  0, 172, 193],
        ...,
        [  0, 165, 191],
        [  0, 165, 192],
        [  0, 165, 192]],

       [[  0, 174, 195],
        [  0, 175, 196],
        [  0, 172, 194],
        ...,
        [  0, 165, 191],
        [  0, 165, 192],
        [  0, 165, 192]],

       [[  0, 174, 194],
        [  0, 175, 194],
        [  0, 172, 192],
        ...,
        [  0, 164, 190],
        [  0, 165, 192],
        [  0, 164, 191]],

       ...,

       [[ 59,  33,  31],
        [ 62,  35,  32],
        [ 53,  28,  30],
        ...,
        [ 85,  50,  48],
        [ 88,  57,  57],
        [ 87,  55,  55]],

       [[ 52,  28,  30],
        [ 55,  30,  30],
        [ 45,  24,  29],
        ...,
        [ 89,  62,  63],
        [131, 106, 106],
        [120,  94,  94]],

       [[ 54,  30,  30],
        [ 57,  31,  31],
        [ 47,  25,  29],
        ...,
        [ 88,  59,  59],
        [119,  93,  93],
        [111,  83,  83]]], dtype=uint8)]"
Image_1945.jpg,514,243,322,207,1200,900,836,450,322,daskShared_local/images/Image_1945.jpg,1945,"[array([[[ 60, 180, 198],
        [ 50, 175, 188],
        [ 60, 178, 191],
        ...,
        [ 72, 186, 210],
        [ 76, 184, 201],
        [ 83, 188, 204]],

       [[ 57, 181, 202],
        [ 46, 176, 194],
        [ 51, 177, 193],
        ...,
        [ 92, 190, 212],
        [ 80, 187, 211],
        [ 79, 184, 205]],

       [[ 66, 183, 197],
        [ 62, 181, 191],
        [ 72, 182, 198],
        ...,
        [ 95, 191, 213],
        [ 95, 191, 213],
        [ 72, 186, 207]],

       ...,

       [[ 99, 159, 152],
        [118, 162, 159],
        [109, 155, 142],
        ...,
        [133, 202, 214],
        [138, 204, 214],
        [161, 214, 222]],

       [[111, 157, 146],
        [126, 166, 164],
        [118, 159, 152],
        ...,
        [133, 202, 212],
        [118, 194, 208],
        [123, 198, 207]],

       [[115, 159, 149],
        [129, 168, 165],
        [133, 180, 174],
        ...,
        [139, 204, 216],
        [127, 197, 213],
        [130, 199, 210]]], dtype=uint8)]"
Image_1946.jpg,217,190,164,159,500,559,381,349,164,daskShared_local/images/Image_1946.jpg,1946,"[array([[[ 88, 179, 178],
        [ 96, 182, 181],
        [105, 186, 186],
        ...,
        [110, 209, 198],
        [111, 208, 197],
        [111, 207, 196]],

       [[ 89, 173, 171],
        [ 92, 173, 172],
        [ 96, 176, 176],
        ...,
        [114, 209, 199],
        [111, 207, 196],
        [110, 206, 195]],

       [[ 97, 165, 161],
        [ 97, 163, 161],
        [ 97, 164, 165],
        ...,
        [115, 208, 198],
        [108, 205, 193],
        [105, 202, 190]],

       ...,

       [[ 72,  57,   7],
        [ 67,  53,   5],
        [ 69,  55,   9],
        ...,
        [ 51, 112,  60],
        [ 70, 118,  71],
        [ 65, 104,  60]],

       [[ 77,  65,   6],
        [ 63,  49,   2],
        [ 55,  39,   1],
        ...,
        [ 21, 105,  83],
        [ 38,  98,  77],
        [ 34,  77,  55]],

       [[ 89,  80,   2],
        [ 72,  60,   1],
        [ 59,  44,   5],
        ...,
        [ 22, 120, 117],
        [ 27,  94,  90],
        [ 19,  66,  58]]], dtype=uint8)]"
Image_1947.jpg,728,438,469,369,2119,1414,1197,807,469,daskShared_local/images/Image_1947.jpg,1947,"[array([[[ 94, 147, 179],
        [ 92, 147, 178],
        [ 96, 151, 182],
        ...,
        [ 73, 138, 168],
        [ 70, 135, 165],
        [ 72, 137, 167]],

       [[ 93, 146, 178],
        [ 92, 147, 178],
        [ 92, 147, 178],
        ...,
        [ 71, 136, 166],
        [ 69, 134, 164],
        [ 69, 134, 164]],

       [[ 92, 145, 177],
        [ 88, 143, 174],
        [ 91, 146, 177],
        ...,
        [ 79, 144, 174],
        [ 71, 136, 166],
        [ 71, 136, 166]],

       ...,

       [[ 77, 173, 197],
        [ 78, 174, 198],
        [ 78, 174, 198],
        ...,
        [108, 109,  88],
        [100,  91,  58],
        [109,  94,  59]],

       [[ 77, 173, 197],
        [ 76, 172, 196],
        [ 77, 173, 197],
        ...,
        [100,  77,  54],
        [117,  92,  59],
        [128, 109,  72]],

       [[ 77, 173, 197],
        [ 76, 172, 196],
        [ 77, 173, 197],
        ...,
        [ 94,  56,  31],
        [127,  92,  58],
        [118,  94,  57]]], dtype=uint8)]"
Image_1948.jpg,280,159,173,173,800,533,453,332,173,daskShared_local/images/Image_1948.jpg,1948,"[array([[[254, 254, 253],
        [254, 254, 252],
        [254, 253, 251],
        ...,
        [ 64,  74,  92],
        [ 71,  82, 100],
        [ 78,  88, 107]],

       [[255, 243, 223],
        [255, 240, 221],
        [255, 235, 215],
        ...,
        [ 76,  76, 104],
        [ 66,  65,  92],
        [ 62,  61,  87]],

       [[236, 212, 185],
        [234, 209, 182],
        [229, 203, 176],
        ...,
        [ 47,  44,  73],
        [ 56,  53,  82],
        [ 60,  57,  84]],

       ...,

       [[154, 126, 114],
        [156, 128, 116],
        [156, 128, 116],
        ...,
        [ 79,  60,  54],
        [ 81,  62,  56],
        [ 86,  67,  61]],

       [[165, 137, 125],
        [161, 133, 121],
        [155, 127, 115],
        ...,
        [ 76,  57,  49],
        [ 80,  61,  53],
        [ 87,  68,  60]],

       [[138, 110,  98],
        [139, 111,  99],
        [142, 114, 102],
        ...,
        [ 74,  56,  46],
        [ 75,  57,  48],
        [ 80,  62,  52]]], dtype=uint8)]"
Image_1949.jpg,356,97,149,194,728,486,505,291,194,daskShared_local/images/Image_1949.jpg,1949,"[array([[[  1,  64, 253],
        [  2,  66, 252],
        [  0,  63, 252],
        ...,
        [  1, 107, 255],
        [  0, 108, 253],
        [  2, 108, 254]],

       [[  1,  64, 253],
        [  1,  66, 254],
        [  0,  69, 252],
        ...,
        [  1, 105, 254],
        [  1, 107, 255],
        [  0, 106, 254]],

       [[  1,  64, 253],
        [  1,  64, 253],
        [  1,  64, 255],
        ...,
        [  0, 106, 254],
        [  0, 106, 254],
        [  0, 107, 255]],

       ...,

       [[190, 143, 117],
        [187, 134, 103],
        [192, 136, 102],
        ...,
        [177, 191, 181],
        [122, 147, 122],
        [ 99, 115,  79]],

       [[147,  85,  66],
        [135,  72,  53],
        [148,  83,  60],
        ...,
        [194, 207, 196],
        [200, 203, 191],
        [169, 178, 160]],

       [[169, 105,  80],
        [176, 113,  83],
        [179, 118,  85],
        ...,
        [ 97, 114,  79],
        [166, 186, 174],
        [197, 207, 196]]], dtype=uint8)]"
Image_195.jpg,508,246,327,213,1200,900,835,459,327,daskShared_local/images/Image_195.jpg,195,"[array([[[ 61, 183, 201],
        [ 66, 184, 198],
        [ 60, 183, 202],
        ...,
        [ 92, 190, 211],
        [ 98, 191, 216],
        [ 83, 187, 211]],

       [[ 69, 185, 201],
        [ 68, 184, 199],
        [ 63, 182, 197],
        ...,
        [ 88, 189, 205],
        [101, 191, 215],
        [ 84, 189, 206]],

       [[ 66, 182, 199],
        [ 65, 181, 198],
        [ 63, 180, 191],
        ...,
        [ 88, 188, 209],
        [ 92, 190, 210],
        [ 88, 189, 207]],

       ...,

       [[ 95, 147, 138],
        [106, 158, 150],
        [105, 152, 148],
        ...,
        [156, 212, 225],
        [143, 205, 217],
        [140, 203, 214]],

       [[108, 153, 142],
        [143, 173, 165],
        [101, 155, 146],
        ...,
        [158, 210, 226],
        [150, 207, 224],
        [162, 214, 228]],

       [[101, 151, 143],
        [130, 160, 149],
        [146, 167, 158],
        ...,
        [153, 210, 221],
        [146, 208, 223],
        [133, 204, 218]]], dtype=uint8)]"
Image_1950.jpg,35,86,246,170,800,600,281,256,246,daskShared_local/images/Image_1950.jpg,1950,"[array([[[  3, 155, 205],
        [  1, 155, 203],
        [  2, 155, 204],
        ...,
        [ 20, 176, 226],
        [ 16, 171, 221],
        [ 19, 175, 224]],

       [[  8, 158, 209],
        [  5, 156, 205],
        [  3, 153, 202],
        ...,
        [ 16, 173, 224],
        [ 15, 173, 222],
        [ 21, 178, 226]],

       [[  5, 155, 208],
        [  9, 159, 209],
        [  6, 155, 203],
        ...,
        [ 18, 176, 227],
        [ 19, 179, 228],
        [ 21, 181, 228]],

       ...,

       [[ 69, 136, 103],
        [ 63, 133,  97],
        [ 64, 133, 100],
        ...,
        [ 71,  24,  20],
        [ 68,  22,  18],
        [ 59,  13,   6]],

       [[ 69, 134, 103],
        [ 63, 131,  97],
        [ 62, 129,  98],
        ...,
        [ 65,  15,   9],
        [ 70,  21,  16],
        [ 69,  24,  15]],

       [[ 69, 130, 104],
        [ 66, 130, 102],
        [ 65, 127, 101],
        ...,
        [ 67,  17,   7],
        [ 76,  27,  18],
        [ 76,  35,  23]]], dtype=uint8)]"
Image_1951.jpg,311,210,192,201,1000,600,503,411,201,daskShared_local/images/Image_1951.jpg,1951,"[array([[[  1, 146, 193],
        [  1, 146, 193],
        [  1, 146, 193],
        ...,
        [  1, 158, 201],
        [  1, 158, 201],
        [  1, 158, 201]],

       [[  1, 146, 193],
        [  1, 146, 193],
        [  1, 146, 193],
        ...,
        [  1, 158, 201],
        [  1, 158, 201],
        [  1, 158, 201]],

       [[  1, 146, 193],
        [  1, 146, 193],
        [  1, 146, 193],
        ...,
        [  1, 158, 201],
        [  1, 158, 201],
        [  1, 158, 201]],

       ...,

       [[222, 183, 144],
        [224, 187, 115],
        [229, 198,  83],
        ...,
        [249, 224, 160],
        [250, 222, 157],
        [251, 220, 153]],

       [[226, 193, 114],
        [210, 179,  90],
        [207, 175,  89],
        ...,
        [247, 222, 158],
        [249, 222, 155],
        [248, 219, 151]],

       [[209, 181,  71],
        [166, 140,  48],
        [144, 112,  71],
        ...,
        [245, 222, 155],
        [246, 221, 154],
        [246, 219, 148]]], dtype=uint8)]"
Image_1952.jpg,427,151,255,255,1200,822,682,406,255,daskShared_local/images/Image_1952.jpg,1952,"[array([[[  0, 147, 173],
        [  1, 149, 175],
        [  2, 150, 176],
        ...,
        [  0, 160, 188],
        [  0, 161, 189],
        [  0, 163, 190]],

       [[  1, 149, 175],
        [  1, 149, 175],
        [  0, 149, 174],
        ...,
        [  0, 160, 188],
        [  0, 161, 189],
        [  0, 164, 191]],

       [[  0, 150, 175],
        [  0, 150, 175],
        [  0, 149, 174],
        ...,
        [  1, 162, 190],
        [  1, 162, 190],
        [  0, 164, 191]],

       ...,

       [[104, 113,  55],
        [107, 119,  54],
        [106, 122,  53],
        ...,
        [238, 205, 154],
        [241, 206, 143],
        [240, 200, 126]],

       [[ 82,  94,  46],
        [ 91, 105,  50],
        [ 92, 111,  50],
        ...,
        [173, 139,  86],
        [169, 128,  66],
        [167, 120,  45]],

       [[ 69,  86,  43],
        [ 74,  92,  43],
        [ 74,  97,  43],
        ...,
        [110,  80,  34],
        [117,  80,  25],
        [123,  80,   6]]], dtype=uint8)]"
Image_1953.jpg,325,137,274,218,845,563,599,355,274,daskShared_local/images/Image_1953.jpg,1953,"[array([[[ 69, 189, 190],
        [ 70, 190, 189],
        [ 71, 191, 189],
        ...,
        [ 87, 196, 191],
        [ 85, 195, 191],
        [ 84, 195, 192]],

       [[ 71, 191, 192],
        [ 73, 193, 192],
        [ 77, 196, 194],
        ...,
        [ 86, 196, 193],
        [ 87, 197, 194],
        [ 87, 200, 196]],

       [[ 85, 197, 201],
        [ 93, 198, 203],
        [103, 199, 205],
        ...,
        [ 82, 197, 194],
        [ 86, 198, 196],
        [ 91, 200, 200]],

       ...,

       [[ 58, 109,  48],
        [ 57, 112,  49],
        [ 57, 113,  50],
        ...,
        [ 51, 196, 193],
        [ 44, 193, 190],
        [ 38, 190, 188]],

       [[ 51,  96,  37],
        [ 53, 101,  41],
        [ 56, 106,  46],
        ...,
        [ 58, 199, 192],
        [ 56, 198, 192],
        [ 53, 196, 192]],

       [[ 56,  88,  25],
        [ 55,  87,  24],
        [ 61,  93,  30],
        ...,
        [ 65, 202, 192],
        [ 67, 202, 196],
        [ 67, 203, 196]]], dtype=uint8)]"
Image_1954.jpg,425,148,233,186,1000,667,658,334,233,daskShared_local/images/Image_1954.jpg,1954,"[array([[[ 37, 177, 252],
        [ 33, 176, 252],
        [ 30, 175, 251],
        ...,
        [  0, 142, 224],
        [  1, 144, 224],
        [  1, 142, 222]],

       [[ 34, 177, 252],
        [ 32, 175, 252],
        [ 32, 175, 252],
        ...,
        [  1, 143, 222],
        [  0, 141, 223],
        [  0, 143, 222]],

       [[ 25, 173, 251],
        [ 26, 173, 251],
        [ 29, 174, 251],
        ...,
        [  1, 142, 222],
        [  0, 141, 223],
        [  0, 142, 222]],

       ...,

       [[164, 138,  87],
        [154, 128,  81],
        [136, 106,  64],
        ...,
        [  1,  61, 105],
        [  0,  62, 105],
        [  0,  61, 105]],

       [[184, 166, 115],
        [185, 168, 122],
        [164, 136,  88],
        ...,
        [  0,  61, 105],
        [  0,  61, 105],
        [  0,  61, 105]],

       [[213, 203, 154],
        [205, 188, 135],
        [184, 155, 101],
        ...,
        [  0,  61, 105],
        [  0,  61, 105],
        [  0,  61, 105]]], dtype=uint8)]"
Image_1955.png,366,186,332,281,900,600,698,467,332,daskShared_local/images/Image_1955.png,1955,"[array([[[128, 120, 102],
        [138, 121, 104],
        [140, 130, 108],
        ...,
        [ 20, 147, 186],
        [ 10, 151, 184],
        [ 13, 149, 182]],

       [[119, 112, 100],
        [126, 114,  90],
        [142, 116,  94],
        ...,
        [ 17, 149, 184],
        [ 19, 150, 180],
        [ 21, 149, 181]],

       [[119, 113, 105],
        [123, 111,  96],
        [123, 112,  84],
        ...,
        [ 17, 151, 181],
        [ 26, 147, 180],
        [ 22, 150, 185]],

       ...,

       [[ 30,  79,  72],
        [ 26,  75,  66],
        [ 24,  76,  74],
        ...,
        [ 84, 149, 149],
        [ 90, 145, 150],
        [ 90, 149, 147]],

       [[ 37,  88,  77],
        [ 33,  82,  64],
        [ 36,  73,  68],
        ...,
        [ 88, 151, 150],
        [ 94, 146, 141],
        [ 91, 147, 139]],

       [[ 46, 102,  90],
        [ 36,  96,  83],
        [ 41,  87,  72],
        ...,
        [ 95, 161, 151],
        [109, 157, 151],
        [101, 157, 150]]], dtype=uint8)]"
Image_1956.jpg,702,279,450,498,1920,1080,1152,777,498,daskShared_local/images/Image_1956.jpg,1956,"[array([[[  1, 120, 204],
        [  0, 119, 203],
        [  0, 119, 203],
        ...,
        [  1, 116, 199],
        [  1, 116, 199],
        [  1, 116, 199]],

       [[  1, 120, 204],
        [  0, 119, 203],
        [  0, 119, 203],
        ...,
        [  1, 116, 199],
        [  1, 116, 199],
        [  1, 116, 199]],

       [[  0, 119, 203],
        [  0, 119, 203],
        [  0, 119, 203],
        ...,
        [  1, 116, 199],
        [  1, 116, 199],
        [  1, 116, 199]],

       ...,

       [[167, 173, 141],
        [150, 151, 117],
        [180, 178, 141],
        ...,
        [157, 153, 113],
        [175, 171, 127],
        [175, 171, 124]],

       [[106, 114,  88],
        [125, 130,  96],
        [187, 189, 151],
        ...,
        [153, 144, 103],
        [152, 143, 100],
        [156, 147, 103]],

       [[ 73,  83,  58],
        [105, 111,  80],
        [160, 162, 130],
        ...,
        [160, 147, 112],
        [164, 151, 114],
        [166, 153, 115]]], dtype=uint8)]"
Image_1957.jpg,988,147,248,318,1686,1216,1236,465,318,daskShared_local/images/Image_1957.jpg,1957,"[array([[[123, 182, 212],
        [124, 183, 213],
        [124, 183, 213],
        ...,
        [159, 201, 225],
        [159, 201, 225],
        [159, 201, 225]],

       [[122, 181, 211],
        [124, 183, 213],
        [124, 183, 213],
        ...,
        [159, 201, 225],
        [159, 201, 225],
        [159, 201, 225]],

       [[122, 181, 211],
        [124, 183, 213],
        [124, 183, 213],
        ...,
        [159, 201, 225],
        [159, 201, 225],
        [159, 201, 225]],

       ...,

       [[145, 181, 156],
        [167, 207, 188],
        [150, 192, 179],
        ...,
        [ 89, 165, 201],
        [ 89, 165, 201],
        [ 89, 165, 201]],

       [[137, 173, 140],
        [159, 198, 170],
        [163, 204, 182],
        ...,
        [ 90, 166, 202],
        [ 89, 165, 201],
        [ 89, 165, 201]],

       [[139, 168, 135],
        [152, 186, 159],
        [163, 201, 179],
        ...,
        [ 86, 165, 202],
        [ 86, 165, 201],
        [ 85, 164, 200]]], dtype=uint8)]"
Image_1958.jpg,251,382,859,689,1512,1231,1110,1071,859,daskShared_local/images/Image_1958.jpg,1958,"[array([[[ 70,  83,  68],
        [ 72,  84,  69],
        [ 72,  85,  72],
        ...,
        [ 86, 121,  88],
        [ 81, 114,  81],
        [ 77, 110,  79]],

       [[ 68,  82,  68],
        [ 70,  82,  68],
        [ 73,  86,  73],
        ...,
        [ 91, 125,  93],
        [ 82, 116,  84],
        [ 79, 112,  81]],

       [[ 70,  82,  72],
        [ 70,  83,  71],
        [ 73,  86,  75],
        ...,
        [ 98, 131,  99],
        [ 86, 119,  88],
        [ 80, 114,  81]],

       ...,

       [[148, 135, 128],
        [133, 121, 109],
        [132, 116, 102],
        ...,
        [248, 236, 218],
        [248, 239, 222],
        [247, 236, 218]],

       [[116, 112, 108],
        [112, 104,  96],
        [117, 105,  94],
        ...,
        [247, 233, 212],
        [246, 234, 217],
        [245, 234, 213]],

       [[121, 121, 116],
        [110, 105,  95],
        [108, 101,  91],
        ...,
        [248, 237, 218],
        [249, 239, 221],
        [248, 238, 220]]], dtype=uint8)]"
Image_1959.jpg,465,130,288,321,1600,1019,753,451,321,daskShared_local/images/Image_1959.jpg,1959,"[array([[[ 26, 109, 213],
        [ 26, 109, 213],
        [ 26, 109, 213],
        ...,
        [ 28, 116, 213],
        [ 28, 116, 213],
        [ 28, 116, 213]],

       [[ 26, 109, 213],
        [ 26, 109, 213],
        [ 26, 109, 213],
        ...,
        [ 28, 116, 213],
        [ 28, 116, 213],
        [ 28, 116, 213]],

       [[ 26, 109, 213],
        [ 26, 109, 213],
        [ 26, 109, 213],
        ...,
        [ 28, 116, 213],
        [ 28, 116, 213],
        [ 28, 116, 213]],

       ...,

       [[236, 236, 237],
        [244, 244, 244],
        [250, 250, 247],
        ...,
        [ 94,   4,   6],
        [113,  18,  19],
        [143,  26,  33]],

       [[221, 227, 208],
        [238, 240, 218],
        [255, 254, 229],
        ...,
        [ 95,   1,  14],
        [107,   7,  20],
        [141,  15,  30]],

       [[229, 236, 215],
        [237, 237, 214],
        [243, 237, 211],
        ...,
        [102,  28,  35],
        [ 86,   7,  13],
        [121,  13,  23]]], dtype=uint8)]"
Image_196.jpg,688,283,464,498,1920,1080,1152,781,498,daskShared_local/images/Image_196.jpg,196,"[array([[[  0, 118, 202],
        [  0, 118, 202],
        [  0, 119, 203],
        ...,
        [  1, 116, 199],
        [  1, 116, 199],
        [  1, 116, 199]],

       [[  0, 118, 202],
        [  0, 118, 202],
        [  0, 118, 202],
        ...,
        [  2, 117, 200],
        [  2, 117, 200],
        [  2, 117, 200]],

       [[  1, 117, 202],
        [  1, 117, 202],
        [  1, 117, 202],
        ...,
        [  1, 116, 199],
        [  1, 116, 199],
        [  1, 116, 199]],

       ...,

       [[ 78,  80,  68],
        [ 80,  86,  77],
        [ 93, 104,  87],
        ...,
        [143, 133,  97],
        [147, 134,  99],
        [153, 140, 105]],

       [[ 73,  76,  59],
        [ 72,  79,  62],
        [ 77,  89,  66],
        ...,
        [162, 155, 122],
        [140, 132, 100],
        [149, 139, 108]],

       [[ 80,  85,  66],
        [ 67,  77,  58],
        [ 87, 101,  80],
        ...,
        [209, 205, 174],
        [179, 174, 144],
        [164, 158, 129]]], dtype=uint8)]"
Image_1960.jpg,425,166,816,639,1500,1000,1241,805,816,daskShared_local/images/Image_1960.jpg,1960,"[array([[[  3,  55,  65],
        [  3,  55,  65],
        [  2,  54,  64],
        ...,
        [150, 145, 166],
        [105, 107, 141],
        [ 90,  94, 137]],

       [[  3,  55,  66],
        [  3,  55,  66],
        [  2,  54,  65],
        ...,
        [129, 128, 155],
        [100, 103, 140],
        [ 82,  87, 132]],

       [[  3,  55,  66],
        [  2,  54,  65],
        [  2,  54,  65],
        ...,
        [111, 113, 144],
        [ 92,  96, 137],
        [ 78,  83, 129]],

       ...,

       [[194, 195, 200],
        [178, 180, 189],
        [148, 153, 180],
        ...,
        [ 58,  85,  55],
        [ 57,  85,  55],
        [ 55,  85,  55]],

       [[204, 204, 207],
        [194, 194, 200],
        [167, 170, 188],
        ...,
        [ 59,  85,  56],
        [ 57,  86,  56],
        [ 56,  86,  55]],

       [[207, 206, 210],
        [199, 200, 206],
        [180, 182, 196],
        ...,
        [ 60,  86,  57],
        [ 58,  86,  56],
        [ 56,  87,  56]]], dtype=uint8)]"
Image_1961.jpg,618,224,139,106,1000,667,757,330,139,daskShared_local/images/Image_1961.jpg,1961,"[array([[[ 72, 141, 146],
        [ 75, 143, 147],
        [ 79, 146, 149],
        ...,
        [ 48, 128, 141],
        [ 55, 133, 146],
        [ 57, 135, 148]],

       [[ 73, 142, 145],
        [ 76, 144, 147],
        [ 79, 146, 148],
        ...,
        [ 39, 121, 133],
        [ 48, 128, 141],
        [ 53, 132, 145]],

       [[ 76, 144, 146],
        [ 78, 145, 147],
        [ 79, 146, 146],
        ...,
        [ 25, 109, 121],
        [ 38, 119, 132],
        [ 45, 125, 138]],

       ...,

       [[ 95,  97,  72],
        [103, 104,  79],
        [115, 116,  90],
        ...,
        [ 77, 147, 150],
        [ 71, 136, 141],
        [ 66, 128, 134]],

       [[ 95,  96,  72],
        [101, 102,  77],
        [111, 111,  85],
        ...,
        [ 73, 139, 141],
        [ 68, 129, 133],
        [ 64, 121, 127]],

       [[ 93,  94,  70],
        [100, 101,  76],
        [112, 112,  86],
        ...,
        [ 69, 133, 136],
        [ 65, 123, 128],
        [ 61, 116, 122]]], dtype=uint8)]"
Image_1962.jpg,2407,893,634,566,3840,2160,3041,1459,634,daskShared_local/images/Image_1962.jpg,1962,"[array([[[ 82,  57,  41],
        [ 67,  44,  28],
        [ 96,  74,  57],
        ...,
        [  3, 130, 175],
        [  2, 130, 175],
        [  1, 129, 174]],

       [[119,  95,  76],
        [ 86,  62,  45],
        [ 70,  47,  31],
        ...,
        [  2, 130, 174],
        [  1, 130, 173],
        [  1, 130, 174]],

       [[166, 143, 123],
        [153, 131, 112],
        [137, 114,  97],
        ...,
        [  0, 131, 174],
        [  0, 131, 174],
        [  2, 131, 175]],

       ...,

       [[  3, 143, 169],
        [  1, 137, 166],
        [  1, 133, 162],
        ...,
        [  0, 121, 166],
        [  0, 121, 166],
        [  1, 121, 166]],

       [[  3, 142, 168],
        [  3, 139, 167],
        [  1, 135, 164],
        ...,
        [  0, 121, 166],
        [  0, 121, 166],
        [  1, 121, 166]],

       [[  3, 141, 167],
        [  3, 141, 168],
        [  1, 137, 166],
        ...,
        [  0, 121, 166],
        [  0, 121, 166],
        [  0, 121, 166]]], dtype=uint8)]"
Image_1963.jpg,617,316,184,142,1400,933,801,458,184,daskShared_local/images/Image_1963.jpg,1963,"[array([[[  0, 172, 228],
        [  0, 172, 228],
        [  0, 172, 228],
        ...,
        [  2, 208, 248],
        [  2, 208, 248],
        [  2, 208, 247]],

       [[  0, 173, 229],
        [  1, 174, 230],
        [  2, 175, 231],
        ...,
        [  0, 209, 248],
        [  0, 209, 248],
        [  2, 209, 250]],

       [[  0, 173, 229],
        [  0, 173, 229],
        [  1, 174, 230],
        ...,
        [  0, 209, 248],
        [  0, 209, 248],
        [  2, 209, 251]],

       ...,

       [[183, 158, 115],
        [141, 119,  80],
        [197, 178, 144],
        ...,
        [  2, 183, 236],
        [  2, 183, 236],
        [  1, 185, 237]],

       [[146, 117,  78],
        [130, 105,  69],
        [170, 148, 116],
        ...,
        [  2, 183, 236],
        [  2, 183, 236],
        [  1, 185, 237]],

       [[107,  76,  37],
        [104,  74,  40],
        [115,  91,  59],
        ...,
        [  2, 183, 236],
        [  2, 183, 236],
        [  1, 185, 237]]], dtype=uint8)]"
Image_1964.jpg,656,283,297,335,1600,1000,953,618,335,daskShared_local/images/Image_1964.jpg,1964,"[array([[[  0,  70, 165],
        [  0,  70, 165],
        [  0,  71, 161],
        ...,
        [  2,  69, 160],
        [  2,  69, 160],
        [  2,  69, 160]],

       [[  0,  70, 165],
        [  0,  70, 165],
        [  0,  71, 161],
        ...,
        [  2,  69, 160],
        [  2,  69, 160],
        [  2,  69, 160]],

       [[  0,  70, 165],
        [  0,  70, 165],
        [  0,  71, 161],
        ...,
        [  2,  69, 160],
        [  2,  69, 160],
        [  2,  69, 160]],

       ...,

       [[ 70,  86,  57],
        [ 78,  91,  68],
        [ 49,  54,  35],
        ...,
        [138, 122,  86],
        [151, 139, 102],
        [152, 140, 104]],

       [[ 91, 100,  65],
        [100, 105,  83],
        [ 52,  59,  40],
        ...,
        [137, 122,  85],
        [170, 163, 119],
        [174, 170, 123]],

       [[ 82,  87,  49],
        [ 76,  76,  55],
        [ 33,  41,  21],
        ...,
        [119, 107,  73],
        [129, 125,  85],
        [150, 148, 104]]], dtype=uint8)]"
Image_1965.jpg,451,262,160,186,850,567,611,448,186,daskShared_local/images/Image_1965.jpg,1965,"[array([[[ 66,  48,  48],
        [ 53,  39,  45],
        [ 84,  52,  48],
        ...,
        [ 87,  95, 121],
        [ 53,  72, 105],
        [ 65,  78, 115]],

       [[ 72,  42,  47],
        [ 60,  41,  42],
        [ 70,  42,  45],
        ...,
        [ 58,  66, 103],
        [ 53,  74, 113],
        [116, 130, 158]],

       [[ 46,  36,  39],
        [ 56,  41,  41],
        [137,  82,  73],
        ...,
        [ 95,  92, 124],
        [102, 103, 122],
        [146, 125, 122]],

       ...,

       [[ 10, 125, 234],
        [ 10, 125, 234],
        [ 12, 124, 236],
        ...,
        [  9, 127, 233],
        [  8, 126, 232],
        [ 10, 128, 234]],

       [[ 10, 125, 234],
        [ 10, 125, 234],
        [ 11, 123, 235],
        ...,
        [ 10, 128, 234],
        [ 10, 128, 234],
        [ 10, 128, 234]],

       [[  9, 123, 235],
        [  8, 122, 234],
        [  8, 120, 232],
        ...,
        [  9, 127, 233],
        [  9, 127, 233],
        [  8, 126, 232]]], dtype=uint8)]"
Image_1966.jpg,230,437,135,193,2015,1510,365,630,193,daskShared_local/images/Image_1966.jpg,1966,"[array([[[ 29,  25,  14],
        [ 28,  24,  15],
        [ 27,  23,  14],
        ...,
        [ 13,   9,   8],
        [  6,   2,   1],
        [  5,   0,   0]],

       [[ 34,  30,  21],
        [ 36,  32,  23],
        [ 36,  32,  23],
        ...,
        [  8,   4,   3],
        [  7,   3,   2],
        [  5,   0,   0]],

       [[ 27,  24,  15],
        [ 35,  32,  23],
        [ 41,  38,  29],
        ...,
        [  7,   3,   2],
        [ 12,   8,   7],
        [  9,   3,   3]],

       ...,

       [[166, 152, 139],
        [164, 152, 138],
        [167, 156, 144],
        ...,
        [140, 148, 151],
        [139, 144, 148],
        [134, 139, 143]],

       [[145, 133, 119],
        [140, 128, 114],
        [161, 151, 139],
        ...,
        [138, 145, 148],
        [140, 145, 149],
        [146, 151, 155]],

       [[156, 144, 130],
        [147, 135, 121],
        [155, 144, 132],
        ...,
        [149, 156, 159],
        [145, 150, 154],
        [158, 163, 167]]], dtype=uint8)]"
Image_1967.jpg,219,211,133,171,800,600,352,382,171,daskShared_local/images/Image_1967.jpg,1967,"[array([[[ 78, 190, 212],
        [ 77, 189, 211],
        [ 76, 190, 211],
        ...,
        [ 16, 164, 194],
        [ 14, 163, 193],
        [ 14, 164, 191]],

       [[ 78, 190, 212],
        [ 77, 189, 211],
        [ 76, 190, 211],
        ...,
        [ 15, 164, 195],
        [ 13, 164, 193],
        [ 13, 164, 191]],

       [[ 77, 189, 211],
        [ 77, 189, 211],
        [ 75, 189, 210],
        ...,
        [ 14, 164, 195],
        [ 13, 163, 192],
        [ 13, 163, 190]],

       ...,

       [[ 28, 116, 103],
        [ 33, 121, 107],
        [ 38, 126, 111],
        ...,
        [214, 179, 107],
        [221, 179, 112],
        [224, 185, 128]],

       [[ 27, 114,  98],
        [ 33, 121, 105],
        [ 38, 127, 110],
        ...,
        [217, 179, 107],
        [219, 176, 112],
        [227, 189, 140]],

       [[ 23, 110,  93],
        [ 27, 116,  98],
        [ 30, 120, 102],
        ...,
        [215, 176, 100],
        [217, 174, 111],
        [231, 194, 148]]], dtype=uint8)]"
Image_1968.png,368,61,185,144,600,600,553,205,185,daskShared_local/images/Image_1968.png,1968,"[array([[[  0, 104, 246],
        [  0, 105, 247],
        [  0, 106, 248],
        ...,
        [  0, 121, 254],
        [  0, 121, 254],
        [  1, 122, 255]],

       [[  0, 105, 249],
        [  0, 105, 249],
        [  0, 105, 249],
        ...,
        [  0, 119, 255],
        [  0, 119, 255],
        [  2, 120, 254]],

       [[  2, 108, 252],
        [  2, 107, 251],
        [  1, 106, 250],
        ...,
        [  0, 118, 254],
        [  0, 118, 254],
        [  1, 119, 253]],

       ...,

       [[167, 114,  65],
        [176, 126,  17],
        [205, 167,  40],
        ...,
        [235, 246, 219],
        [241, 250, 202],
        [242, 248, 205]],

       [[ 89,  52,  51],
        [141,  97,  36],
        [191, 180, 121],
        ...,
        [225, 249, 213],
        [238, 249, 206],
        [240, 245, 203]],

       [[125,  89,  37],
        [156, 146,  62],
        [188, 221, 210],
        ...,
        [226, 251, 219],
        [240, 248, 205],
        [238, 247, 191]]], dtype=uint8)]"
Image_1969.jpg,421,1028,797,558,4601,3200,1218,1586,797,daskShared_local/images/Image_1969.jpg,1969,"[array([[[ 38, 172, 239],
        [ 33, 170, 234],
        [ 31, 170, 235],
        ...,
        [ 50, 164, 230],
        [ 51, 157, 224],
        [ 53, 152, 216]],

       [[ 32, 160, 235],
        [ 35, 164, 242],
        [ 30, 160, 238],
        ...,
        [ 48, 159, 231],
        [ 54, 160, 230],
        [ 63, 174, 244]],

       [[ 32, 160, 237],
        [ 33, 162, 239],
        [ 31, 158, 234],
        ...,
        [ 51, 163, 238],
        [ 52, 157, 228],
        [ 55, 157, 230]],

       ...,

       [[ 33, 166, 228],
        [ 25, 160, 217],
        [ 26, 164, 215],
        ...,
        [ 46, 155, 212],
        [ 48, 158, 218],
        [ 51, 164, 225]],

       [[ 27, 155, 207],
        [ 25, 149, 204],
        [ 32, 161, 215],
        ...,
        [ 41, 149, 207],
        [ 45, 156, 216],
        [ 40, 152, 209]],

       [[ 26, 152, 211],
        [ 29, 155, 213],
        [ 31, 164, 219],
        ...,
        [ 37, 152, 203],
        [ 48, 167, 222],
        [ 44, 155, 212]]], dtype=uint8)]"
Image_197.jpg,331,137,266,214,845,563,597,351,266,daskShared_local/images/Image_197.jpg,197,"[array([[[121, 212, 219],
        [147, 223, 235],
        [165, 229, 245],
        ...,
        [ 86, 197, 194],
        [ 85, 196, 193],
        [ 86, 197, 194]],

       [[146, 212, 222],
        [167, 222, 233],
        [180, 228, 238],
        ...,
        [ 78, 195, 192],
        [ 80, 196, 193],
        [ 84, 197, 195]],

       [[145, 216, 223],
        [164, 224, 233],
        [177, 230, 238],
        ...,
        [ 73, 193, 191],
        [ 76, 195, 193],
        [ 81, 197, 196]],

       ...,

       [[ 63, 101,  35],
        [ 64,  97,  32],
        [ 63,  93,  31],
        ...,
        [ 49, 196, 188],
        [ 44, 196, 187],
        [ 40, 195, 187]],

       [[ 63, 100,  25],
        [ 63, 103,  27],
        [ 62, 104,  27],
        ...,
        [ 51, 195, 188],
        [ 45, 194, 187],
        [ 37, 192, 184]],

       [[ 57,  97,  18],
        [ 57, 102,  22],
        [ 55, 105,  23],
        ...,
        [ 51, 192, 189],
        [ 44, 191, 187],
        [ 34, 188, 182]]], dtype=uint8)]"
Image_1970.jpg,918,459,741,492,3008,2000,1659,951,741,daskShared_local/images/Image_1970.jpg,1970,"[array([[[148, 187, 194],
        [148, 187, 194],
        [149, 188, 195],
        ...,
        [128, 176, 190],
        [128, 176, 190],
        [128, 176, 190]],

       [[148, 187, 194],
        [148, 187, 194],
        [149, 188, 195],
        ...,
        [128, 176, 190],
        [128, 176, 190],
        [128, 176, 190]],

       [[148, 187, 194],
        [148, 187, 194],
        [149, 188, 195],
        ...,
        [128, 176, 190],
        [128, 176, 190],
        [128, 176, 190]],

       ...,

       [[116, 169, 177],
        [112, 165, 173],
        [100, 150, 157],
        ...,
        [ 42,  51,  58],
        [ 42,  51,  58],
        [ 44,  53,  60]],

       [[114, 167, 175],
        [108, 161, 169],
        [ 96, 146, 153],
        ...,
        [ 47,  56,  63],
        [ 46,  55,  62],
        [ 50,  59,  66]],

       [[113, 166, 174],
        [104, 157, 165],
        [ 94, 146, 153],
        ...,
        [ 57,  66,  73],
        [ 53,  62,  69],
        [ 56,  65,  72]]], dtype=uint8)]"
Image_1971.jpg,388,312,427,253,1904,803,815,565,427,daskShared_local/images/Image_1971.jpg,1971,"[array([[[ 10,  90,  96],
        [ 13,  94, 101],
        [ 12,  92, 105],
        ...,
        [ 98, 189, 197],
        [ 99, 185, 192],
        [125, 192, 204]],

       [[ 52, 104, 110],
        [ 45,  97, 104],
        [ 42,  92, 106],
        ...,
        [139, 224, 233],
        [148, 231, 239],
        [161, 224, 237]],

       [[193, 235, 237],
        [189, 230, 233],
        [188, 229, 232],
        ...,
        [134, 214, 225],
        [128, 206, 216],
        [150, 210, 224]],

       ...,

       [[  7,  39,  90],
        [ 10,  37,  92],
        [  8,  37, 101],
        ...,
        [  0,  53,  86],
        [  2,  67,  94],
        [ 20,  98, 120]],

       [[  3,  37,  86],
        [  6,  37,  86],
        [  4,  34,  89],
        ...,
        [  0,  55,  87],
        [  6,  78, 102],
        [ 34, 121, 140]],

       [[  2,  39,  86],
        [  3,  41,  84],
        [  1,  39,  85],
        ...,
        [  1,  61,  91],
        [ 17,  96, 118],
        [ 38, 131, 148]]], dtype=uint8)]"
Image_1972.jpg,417,3,404,527,1280,720,821,530,527,daskShared_local/images/Image_1972.jpg,1972,"[array([[[162, 230, 239],
        [160, 228, 239],
        [160, 228, 239],
        ...,
        [ 27, 179, 202],
        [ 44, 180, 210],
        [ 62, 183, 214]],

       [[164, 232, 240],
        [161, 230, 239],
        [160, 228, 239],
        ...,
        [ 54, 182, 212],
        [ 71, 186, 216],
        [ 75, 187, 215]],

       [[165, 232, 241],
        [159, 228, 238],
        [158, 228, 239],
        ...,
        [ 84, 191, 216],
        [ 89, 192, 221],
        [ 81, 190, 217]],

       ...,

       [[100,  84,  39],
        [ 96,  81,  43],
        [116,  94,  54],
        ...,
        [  2,  69,  93],
        [  3,  69,  93],
        [  3,  69,  95]],

       [[ 60,  49,  18],
        [ 59,  52,  30],
        [ 96,  81,  46],
        ...,
        [  2,  67,  92],
        [  3,  68,  92],
        [  3,  69,  95]],

       [[ 28,  19,   6],
        [ 31,  31,  21],
        [ 56,  53,  34],
        ...,
        [  1,  66,  92],
        [  2,  66,  93],
        [  4,  67,  93]]], dtype=uint8)]"
Image_1973.jpg,689,185,201,147,1000,600,890,332,201,daskShared_local/images/Image_1973.jpg,1973,"[array([[[  3, 154, 207],
        [  2, 153, 206],
        [  1, 152, 205],
        ...,
        [  4, 144, 203],
        [  1, 141, 200],
        [  1, 141, 200]],

       [[  3, 154, 207],
        [  3, 154, 207],
        [  4, 155, 208],
        ...,
        [  4, 144, 203],
        [  1, 141, 200],
        [  1, 141, 200]],

       [[  5, 153, 199],
        [  0, 151, 196],
        [  1, 152, 197],
        ...,
        [  4, 147, 207],
        [  0, 143, 203],
        [  1, 144, 204]],

       ...,

       [[123, 109,  74],
        [176, 163, 129],
        [202, 191, 161],
        ...,
        [245, 242, 237],
        [227, 225, 210],
        [207, 207, 182]],

       [[171, 163, 116],
        [180, 172, 133],
        [188, 180, 149],
        ...,
        [248, 243, 249],
        [229, 225, 226],
        [201, 198, 193]],

       [[155, 150,  95],
        [147, 142, 100],
        [159, 154, 125],
        ...,
        [231, 224, 240],
        [246, 239, 254],
        [216, 209, 225]]], dtype=uint8)]"
Image_1974.jpg,215,41,206,166,900,521,421,207,206,daskShared_local/images/Image_1974.jpg,1974,"[array([[[ 17,  59, 171],
        [ 17,  59, 171],
        [ 17,  59, 171],
        ...,
        [ 32,  69, 184],
        [ 32,  69, 184],
        [ 32,  69, 184]],

       [[ 17,  59, 171],
        [ 17,  59, 171],
        [ 17,  59, 171],
        ...,
        [ 32,  69, 184],
        [ 32,  69, 184],
        [ 32,  69, 184]],

       [[ 17,  59, 171],
        [ 18,  60, 172],
        [ 17,  59, 171],
        ...,
        [ 32,  69, 184],
        [ 32,  69, 184],
        [ 32,  69, 184]],

       ...,

       [[  2,  52, 139],
        [  0,  54, 142],
        [  0,  54, 142],
        ...,
        [215, 232, 226],
        [221, 237, 234],
        [217, 233, 230]],

       [[  2,  52, 139],
        [  0,  54, 142],
        [  0,  54, 142],
        ...,
        [221, 238, 232],
        [223, 239, 236],
        [216, 232, 229]],

       [[  1,  53, 139],
        [  0,  54, 142],
        [  0,  54, 142],
        ...,
        [223, 240, 234],
        [219, 235, 232],
        [214, 230, 227]]], dtype=uint8)]"
Image_1975.jpg,105,259,165,114,900,600,270,373,165,daskShared_local/images/Image_1975.jpg,1975,"[array([[[  3,  78,  97],
        [  1,  80,  99],
        [  0,  85, 105],
        ...,
        [  1,  89, 106],
        [  3,  92, 108],
        [  2,  91, 107]],

       [[  3,  80,  95],
        [  1,  80,  96],
        [  0,  83, 100],
        ...,
        [  1,  88, 104],
        [  3,  91, 107],
        [  3,  92, 108]],

       [[  3,  82,  91],
        [  1,  80,  90],
        [  0,  79,  90],
        ...,
        [  1,  87, 104],
        [  2,  90, 107],
        [  1,  92, 107]],

       ...,

       [[  0,  66,  78],
        [  0,  66,  78],
        [  1,  66,  78],
        ...,
        [ 16,  43,  38],
        [ 15,  42,  37],
        [ 16,  43,  38]],

       [[  0,  69,  80],
        [  0,  69,  80],
        [  1,  68,  80],
        ...,
        [ 17,  45,  41],
        [ 17,  44,  40],
        [ 17,  44,  39]],

       [[  0,  72,  81],
        [  1,  72,  82],
        [  2,  71,  82],
        ...,
        [ 20,  49,  45],
        [ 19,  48,  44],
        [ 19,  45,  42]]], dtype=uint8)]"
Image_1976.jpg,586,85,224,165,1068,601,810,250,224,daskShared_local/images/Image_1976.jpg,1976,"[array([[[  0,  71, 254],
        [  0,  71, 254],
        [  0,  71, 254],
        ...,
        [  0,  87, 255],
        [  0,  87, 255],
        [  0,  87, 255]],

       [[  0,  71, 254],
        [  0,  71, 254],
        [  0,  71, 254],
        ...,
        [  0,  87, 255],
        [  0,  87, 255],
        [  0,  87, 255]],

       [[  0,  72, 255],
        [  0,  72, 255],
        [  0,  72, 255],
        ...,
        [  0,  87, 255],
        [  0,  87, 255],
        [  0,  87, 255]],

       ...,

       [[159, 137, 119],
        [223, 203, 212],
        [203, 188, 214],
        ...,
        [208, 223, 223],
        [211, 225, 221],
        [213, 224, 221]],

       [[154, 132,  96],
        [204, 186, 170],
        [168, 157, 156],
        ...,
        [207, 221, 223],
        [211, 224, 219],
        [213, 224, 218]],

       [[111,  88,  36],
        [158, 141,  98],
        [165, 155, 118],
        ...,
        [207, 221, 224],
        [213, 224, 218],
        [214, 224, 215]]], dtype=uint8)]"
Image_1977.jpg,519,85,138,198,1200,630,657,283,198,daskShared_local/images/Image_1977.jpg,1977,"[array([[[  1, 154, 221],
        [  1, 154, 221],
        [  1, 154, 221],
        ...,
        [  3, 155, 222],
        [  3, 155, 222],
        [  3, 155, 222]],

       [[  1, 154, 221],
        [  1, 154, 221],
        [  1, 154, 221],
        ...,
        [  3, 155, 222],
        [  3, 155, 222],
        [  3, 155, 222]],

       [[  1, 154, 221],
        [  1, 154, 221],
        [  1, 154, 221],
        ...,
        [  3, 155, 222],
        [  3, 155, 222],
        [  3, 155, 222]],

       ...,

       [[ 36,  25,  31],
        [ 28,  19,  24],
        [ 19,  10,  15],
        ...,
        [  9,  87, 125],
        [  3,  81, 119],
        [  0,  77, 115]],

       [[ 32,  23,  28],
        [ 27,  18,  23],
        [ 19,  10,  15],
        ...,
        [ 14,  92, 130],
        [  4,  82, 120],
        [  0,  78, 116]],

       [[ 28,  19,  24],
        [ 24,  15,  20],
        [ 17,  11,  15],
        ...,
        [  9,  84, 123],
        [  1,  76, 115],
        [  1,  76, 115]]], dtype=uint8)]"
Image_1978.jpg,519,89,290,371,1600,900,809,460,371,daskShared_local/images/Image_1978.jpg,1978,"[array([[[  1, 158, 210],
        [  1, 158, 209],
        [  0, 159, 209],
        ...,
        [152, 199, 241],
        [152, 199, 241],
        [152, 199, 241]],

       [[  0, 157, 209],
        [  0, 158, 208],
        [  0, 159, 209],
        ...,
        [152, 199, 241],
        [152, 199, 241],
        [152, 199, 241]],

       [[  0, 157, 209],
        [  0, 157, 208],
        [  0, 158, 208],
        ...,
        [152, 199, 241],
        [152, 199, 241],
        [151, 198, 240]],

       ...,

       [[  1, 144, 207],
        [  0, 144, 207],
        [  0, 144, 204],
        ...,
        [129, 142, 139],
        [156, 156, 147],
        [139, 122, 106]],

       [[  1, 144, 207],
        [  0, 145, 208],
        [  1, 145, 205],
        ...,
        [103, 105, 101],
        [135, 127, 116],
        [138, 118, 100]],

       [[  1, 144, 206],
        [  0, 144, 206],
        [  1, 146, 202],
        ...,
        [ 83,  76,  70],
        [127, 114, 100],
        [133, 112,  95]]], dtype=uint8)]"
Image_1979.jpg,366,27,148,123,550,380,514,150,148,daskShared_local/images/Image_1979.jpg,1979,"[array([[[ 76,  95, 151],
        [ 76,  95, 151],
        [ 76,  95, 150],
        ...,
        [ 69,  84, 143],
        [ 69,  84, 143],
        [ 69,  84, 143]],

       [[ 76,  95, 151],
        [ 76,  95, 151],
        [ 76,  95, 151],
        ...,
        [ 70,  85, 144],
        [ 70,  85, 144],
        [ 70,  85, 144]],

       [[ 76,  95, 151],
        [ 76,  95, 151],
        [ 76,  95, 152],
        ...,
        [ 71,  86, 145],
        [ 71,  86, 145],
        [ 71,  86, 145]],

       ...,

       [[158, 129, 104],
        [136, 106,  78],
        [115,  86,  58],
        ...,
        [ 66,  78, 139],
        [ 66,  77, 139],
        [ 66,  77, 139]],

       [[173, 146, 121],
        [164, 138, 108],
        [145, 118,  89],
        ...,
        [ 65,  77, 139],
        [ 66,  77, 139],
        [ 66,  77, 139]],

       [[199, 175, 148],
        [207, 182, 152],
        [188, 163, 132],
        ...,
        [ 65,  77, 139],
        [ 66,  77, 139],
        [ 66,  77, 139]]], dtype=uint8)]"
Image_198.jpg,355,98,153,195,728,486,508,293,195,daskShared_local/images/Image_198.jpg,198,"[array([[[  1,  64, 253],
        [  1,  66, 254],
        [  0,  69, 252],
        ...,
        [  1, 107, 255],
        [  0, 106, 254],
        [  0, 106, 254]],

       [[  1,  64, 253],
        [  1,  64, 253],
        [  1,  64, 255],
        ...,
        [  0, 106, 254],
        [  0, 107, 255],
        [  0, 106, 254]],

       [[  0,  63, 254],
        [  0,  63, 252],
        [  1,  64, 253],
        ...,
        [  2, 106, 255],
        [  0, 106, 250],
        [  0, 104, 255]],

       ...,

       [[170, 106,  81],
        [178, 115,  84],
        [180, 120,  86],
        ...,
        [163, 182, 169],
        [195, 205, 193],
        [190, 194, 178]],

       [[185, 137,  94],
        [197, 149, 111],
        [197, 153, 124],
        ...,
        [ 83,  90,  47],
        [112, 140, 110],
        [172, 188, 184]],

       [[196, 154, 112],
        [193, 151, 113],
        [134, 102,  83],
        ...,
        [ 81,  84,  56],
        [ 73,  80,  39],
        [ 90, 100,  66]]], dtype=uint8)]"
Image_1980.jpg,1263,1059,381,385,2592,1944,1644,1444,385,daskShared_local/images/Image_1980.jpg,1980,"[array([[[118,  87,  59],
        [102,  72,  47],
        [118,  90,  66],
        ...,
        [ 42, 114, 172],
        [ 46, 118, 176],
        [ 46, 118, 176]],

       [[144, 114,  85],
        [129, 100,  73],
        [129, 101,  78],
        ...,
        [ 41, 113, 171],
        [ 46, 118, 176],
        [ 46, 118, 176]],

       [[151, 122,  93],
        [140, 112,  86],
        [136, 110,  86],
        ...,
        [ 43, 115, 173],
        [ 43, 115, 173],
        [ 44, 116, 174]],

       ...,

       [[ 46, 122, 170],
        [ 41, 119, 165],
        [ 38, 116, 162],
        ...,
        [ 37, 120, 165],
        [ 37, 120, 164],
        [ 35, 118, 162]],

       [[ 40, 118, 167],
        [ 37, 115, 165],
        [ 36, 116, 167],
        ...,
        [ 37, 120, 167],
        [ 37, 121, 167],
        [ 36, 120, 166]],

       [[ 39, 117, 165],
        [ 38, 117, 166],
        [ 38, 118, 169],
        ...,
        [ 36, 118, 165],
        [ 38, 120, 167],
        [ 37, 119, 166]]], dtype=uint8)]"
Image_1981.jpg,1040,0,2515,2759,4608,3072,3555,2759,2759,daskShared_local/images/Image_1981.jpg,1981,"[array([[[ 51,  54,  58],
        [ 56,  59,  62],
        [ 60,  63,  66],
        ...,
        [173, 168, 123],
        [173, 169, 124],
        [173, 168, 125]],

       [[ 51,  54,  56],
        [ 53,  55,  57],
        [ 55,  56,  58],
        ...,
        [173, 168, 123],
        [173, 168, 124],
        [173, 168, 126]],

       [[ 51,  52,  53],
        [ 52,  53,  54],
        [ 54,  55,  54],
        ...,
        [173, 168, 124],
        [172, 167, 124],
        [173, 168, 125]],

       ...,

       [[ 97,  80,  49],
        [ 97,  81,  53],
        [ 98,  81,  53],
        ...,
        [154, 135,  94],
        [154, 135,  89],
        [157, 136,  87]],

       [[ 94,  76,  48],
        [ 94,  77,  50],
        [ 96,  78,  50],
        ...,
        [154, 132,  83],
        [153, 130,  81],
        [159, 136,  89]],

       [[ 90,  73,  46],
        [ 89,  73,  45],
        [ 91,  74,  46],
        ...,
        [157, 138,  88],
        [164, 139,  82],
        [172, 148,  98]]], dtype=uint8)]"
Image_1982.jpg,122,160,372,280,1152,768,494,440,372,daskShared_local/images/Image_1982.jpg,1982,"[array([[[182, 233, 226],
        [184, 235, 228],
        [187, 236, 230],
        ...,
        [145, 222, 216],
        [145, 222, 216],
        [146, 223, 217]],

       [[182, 233, 224],
        [183, 234, 225],
        [186, 236, 227],
        ...,
        [142, 219, 215],
        [143, 220, 215],
        [143, 220, 216]],

       [[182, 233, 224],
        [183, 234, 225],
        [186, 236, 227],
        ...,
        [139, 218, 214],
        [141, 220, 215],
        [142, 221, 216]],

       ...,

       [[101, 182, 191],
        [101, 181, 190],
        [101, 177, 188],
        ...,
        [ 92, 124, 126],
        [101, 132, 134],
        [ 96, 135, 128]],

       [[ 99, 183, 192],
        [ 98, 182, 191],
        [ 96, 179, 188],
        ...,
        [ 94, 126, 129],
        [101, 131, 134],
        [ 95, 132, 126]],

       [[ 97, 180, 191],
        [ 94, 179, 189],
        [ 89, 178, 186],
        ...,
        [ 90, 122, 127],
        [100, 130, 133],
        [104, 139, 135]]], dtype=uint8)]"
Image_1983.jpg,968,388,195,204,2000,1000,1163,592,204,daskShared_local/images/Image_1983.jpg,1983,"[array([[[208, 182, 145],
        [206, 180, 143],
        [206, 180, 143],
        ...,
        [205, 186, 153],
        [199, 180, 147],
        [198, 179, 146]],

       [[208, 184, 146],
        [206, 182, 144],
        [207, 181, 144],
        ...,
        [209, 190, 157],
        [206, 187, 154],
        [203, 184, 151]],

       [[203, 181, 144],
        [200, 178, 141],
        [201, 177, 139],
        ...,
        [205, 185, 152],
        [207, 187, 154],
        [207, 187, 154]],

       ...,

       [[ 32,  33,  28],
        [ 32,  32,  30],
        [ 34,  34,  32],
        ...,
        [168, 139, 105],
        [163, 136, 103],
        [161, 136, 105]],

       [[ 32,  33,  28],
        [ 32,  33,  28],
        [ 33,  33,  31],
        ...,
        [198, 170, 131],
        [190, 166, 130],
        [183, 160, 126]],

       [[ 32,  33,  28],
        [ 34,  35,  30],
        [ 38,  38,  36],
        ...,
        [190, 166, 122],
        [204, 181, 140],
        [202, 183, 143]]], dtype=uint8)]"
Image_1984.jpg,435,149,690,613,1152,763,1125,762,690,daskShared_local/images/Image_1984.jpg,1984,"[array([[[  0, 184, 238],
        [  1, 183, 238],
        [  2, 181, 237],
        ...,
        [  1, 182, 237],
        [  1, 183, 238],
        [  1, 183, 238]],

       [[  0, 184, 238],
        [  0, 184, 238],
        [  1, 182, 237],
        ...,
        [  2, 181, 237],
        [  2, 181, 237],
        [  2, 181, 237]],

       [[  0, 184, 238],
        [  0, 184, 238],
        [  0, 183, 237],
        ...,
        [  2, 181, 237],
        [  2, 181, 237],
        [  1, 180, 236]],

       ...,

       [[136, 160, 119],
        [126, 152, 112],
        [137, 163, 137],
        ...,
        [184, 199, 200],
        [188, 202, 188],
        [191, 204, 196]],

       [[139, 163, 125],
        [135, 160, 127],
        [147, 172, 150],
        ...,
        [196, 211, 204],
        [182, 201, 195],
        [180, 201, 185]],

       [[140, 164, 132],
        [144, 168, 143],
        [154, 178, 160],
        ...,
        [180, 200, 195],
        [171, 192, 178],
        [172, 194, 173]]], dtype=uint8)]"
Image_1985.jpg,542,234,153,193,990,681,695,427,193,daskShared_local/images/Image_1985.jpg,1985,"[array([[[ 41,  37,  25],
        [ 42,  38,  26],
        [ 40,  37,  22],
        ...,
        [ 27,  19,   8],
        [ 29,  17,   3],
        [ 31,  18,   1]],

       [[ 38,  34,  22],
        [ 40,  36,  24],
        [ 40,  37,  22],
        ...,
        [ 35,  28,  12],
        [ 37,  26,   8],
        [ 40,  25,   6]],

       [[ 33,  29,  17],
        [ 36,  32,  20],
        [ 37,  34,  19],
        ...,
        [ 37,  31,   9],
        [ 40,  29,   7],
        [ 44,  29,   6]],

       ...,

       [[151, 145, 113],
        [173, 167, 133],
        [171, 166, 128],
        ...,
        [ 41,  48,  32],
        [ 45,  52,  36],
        [ 55,  62,  44]],

       [[119, 114,  82],
        [157, 152, 118],
        [168, 163, 126],
        ...,
        [ 38,  45,  29],
        [ 42,  49,  31],
        [ 53,  60,  42]],

       [[ 93,  87,  55],
        [133, 127,  91],
        [146, 138, 101],
        ...,
        [ 35,  42,  26],
        [ 40,  47,  29],
        [ 52,  59,  41]]], dtype=uint8)]"
Image_1986.jpg,499,166,93,79,660,438,592,245,93,daskShared_local/images/Image_1986.jpg,1986,"[array([[[  2,  17,  63],
        [  1,  17,  63],
        [  4,  19,  65],
        ...,
        [ 39,  57,  93],
        [ 12,  27,  80],
        [ 15,  31,  82]],

       [[  2,  17,  63],
        [  1,  17,  63],
        [  4,  19,  65],
        ...,
        [ 40,  57,  94],
        [ 12,  27,  81],
        [ 16,  31,  83]],

       [[  2,  21,  63],
        [  2,  20,  62],
        [  5,  23,  64],
        ...,
        [ 31,  50,  85],
        [ 10,  27,  76],
        [ 12,  30,  77]],

       ...,

       [[223, 168, 118],
        [222, 167, 117],
        [227, 177, 129],
        ...,
        [ 62,  55,  65],
        [ 55,  48,  62],
        [ 56,  48,  62]],

       [[216, 149, 106],
        [213, 146, 103],
        [233, 169, 128],
        ...,
        [ 40,  32,  44],
        [ 41,  33,  48],
        [ 41,  33,  48]],

       [[216, 151, 108],
        [214, 149, 105],
        [233, 170, 128],
        ...,
        [ 43,  35,  47],
        [ 43,  35,  50],
        [ 43,  35,  49]]], dtype=uint8)]"
Image_1987.jpg,385,163,113,121,900,600,498,284,121,daskShared_local/images/Image_1987.jpg,1987,"[array([[[ 45, 122, 186],
        [ 42, 121, 185],
        [ 34, 118, 184],
        ...,
        [ 33,  93, 154],
        [ 27,  93, 154],
        [ 25,  93, 154]],

       [[ 38, 120, 185],
        [ 35, 119, 184],
        [ 29, 116, 184],
        ...,
        [ 30,  94, 157],
        [ 25,  94, 157],
        [ 24,  94, 157]],

       [[ 19, 114, 182],
        [ 19, 113, 182],
        [ 18, 112, 182],
        ...,
        [ 20,  97, 165],
        [ 20,  98, 165],
        [ 21,  98, 165]],

       ...,

       [[  0,  88, 177],
        [  0,  88, 176],
        [  1,  87, 174],
        ...,
        [121,  89, 113],
        [132, 100, 122],
        [136, 104, 126]],

       [[  1,  84, 172],
        [  1,  84, 172],
        [  2,  85, 172],
        ...,
        [130,  98, 118],
        [133, 101, 120],
        [133, 102, 121]],

       [[  1,  83, 170],
        [  1,  83, 170],
        [  2,  85, 171],
        ...,
        [133, 102, 119],
        [132, 101, 119],
        [132, 101, 119]]], dtype=uint8)]"
Image_1988.jpg,410,135,119,84,759,422,529,219,119,daskShared_local/images/Image_1988.jpg,1988,"[array([[[136, 206, 208],
        [134, 204, 205],
        [126, 196, 196],
        ...,
        [ 28, 142, 156],
        [ 13, 137, 154],
        [  8, 136, 153]],

       [[129, 199, 200],
        [127, 197, 199],
        [124, 194, 194],
        ...,
        [ 25, 140, 153],
        [ 11, 136, 152],
        [  7, 135, 152]],

       [[106, 176, 177],
        [109, 179, 180],
        [117, 187, 187],
        ...,
        [ 14, 132, 144],
        [  6, 131, 147],
        [  3, 131, 148]],

       ...,

       [[  0, 154, 185],
        [  0, 154, 185],
        [  0, 154, 185],
        ...,
        [  0, 137, 163],
        [  2, 138, 162],
        [  3, 139, 161]],

       [[  0, 153, 186],
        [  0, 153, 186],
        [  0, 153, 186],
        ...,
        [  0, 138, 162],
        [  2, 138, 160],
        [  3, 138, 160]],

       [[  0, 153, 187],
        [  0, 153, 187],
        [  0, 153, 187],
        ...,
        [  0, 138, 161],
        [  2, 138, 160],
        [  3, 138, 159]]], dtype=uint8)]"
Image_1989.jpg,477,160,226,272,981,650,703,432,272,daskShared_local/images/Image_1989.jpg,1989,"[array([[[244, 244, 244],
        [244, 244, 244],
        [244, 244, 244],
        ...,
        [242, 242, 242],
        [242, 242, 242],
        [242, 242, 242]],

       [[244, 244, 244],
        [244, 244, 244],
        [244, 244, 244],
        ...,
        [242, 242, 242],
        [242, 242, 242],
        [242, 242, 242]],

       [[244, 244, 244],
        [244, 244, 244],
        [244, 244, 244],
        ...,
        [242, 242, 242],
        [242, 242, 242],
        [242, 242, 242]],

       ...,

       [[ 26,  93, 174],
        [ 27,  94, 173],
        [ 25,  92, 170],
        ...,
        [ 21,  89, 172],
        [ 21,  89, 171],
        [ 22,  90, 171]],

       [[ 25,  92, 173],
        [ 27,  94, 174],
        [ 26,  93, 171],
        ...,
        [ 19,  87, 170],
        [ 21,  88, 171],
        [ 22,  90, 172]],

       [[ 25,  92, 173],
        [ 28,  95, 175],
        [ 29,  96, 174],
        ...,
        [ 17,  85, 171],
        [ 20,  88, 172],
        [ 22,  90, 174]]], dtype=uint8)]"
Image_199.jpg,427,152,262,271,1200,822,689,423,271,daskShared_local/images/Image_199.jpg,199,"[array([[[  1, 149, 175],
        [  0, 148, 174],
        [  1, 149, 175],
        ...,
        [  3, 164, 192],
        [  3, 164, 192],
        [  3, 164, 192]],

       [[  0, 150, 175],
        [  0, 149, 174],
        [  0, 150, 175],
        ...,
        [  1, 161, 189],
        [  1, 161, 190],
        [  2, 161, 190]],

       [[  2, 152, 177],
        [  0, 150, 175],
        [  0, 150, 175],
        ...,
        [  2, 161, 190],
        [  3, 162, 191],
        [  4, 163, 192]],

       ...,

       [[ 91,  96,  54],
        [ 90,  99,  49],
        [ 89,  97,  43],
        ...,
        [107,  91,  55],
        [ 90,  76,  38],
        [ 99,  82,  40]],

       [[ 76,  75,  37],
        [ 96, 103,  56],
        [108, 119,  63],
        ...,
        [100,  79,  50],
        [106,  89,  58],
        [105,  85,  48]],

       [[ 58,  51,  17],
        [ 73,  77,  35],
        [ 99, 111,  59],
        ...,
        [100,  75,  53],
        [117,  96,  73],
        [115,  91,  60]]], dtype=uint8)]"
Image_1990.jpg,409,314,237,199,1500,1000,646,513,237,daskShared_local/images/Image_1990.jpg,1990,"[array([[[  3, 126, 152],
        [  6, 127, 154],
        [  5, 127, 153],
        ...,
        [  0, 101, 123],
        [  0, 101, 123],
        [  0, 100, 122]],

       [[  4, 130, 155],
        [  5, 129, 155],
        [  3, 128, 153],
        ...,
        [  2, 108, 129],
        [  4, 110, 131],
        [  0, 105, 127]],

       [[  2, 131, 156],
        [  4, 131, 156],
        [  4, 131, 156],
        ...,
        [  7, 116, 135],
        [  8, 117, 136],
        [  2, 111, 130]],

       ...,

       [[169, 191, 162],
        [190, 207, 175],
        [214, 226, 192],
        ...,
        [167, 156,  95],
        [164, 154,  96],
        [148, 141,  84]],

       [[149, 173, 144],
        [183, 202, 172],
        [215, 230, 196],
        ...,
        [142, 132,  73],
        [156, 148,  90],
        [148, 142,  86]],

       [[122, 149, 124],
        [157, 180, 151],
        [197, 215, 185],
        ...,
        [129, 121,  63],
        [116, 110,  54],
        [102,  97,  41]]], dtype=uint8)]"
Image_1991.jpg,1285,642,184,156,2304,1536,1469,798,184,daskShared_local/images/Image_1991.jpg,1991,"[array([[[ 33, 157, 209],
        [ 34, 158, 210],
        [ 38, 160, 212],
        ...,
        [  0, 110, 145],
        [  0, 110, 145],
        [  0, 110, 145]],

       [[ 38, 160, 207],
        [ 41, 162, 210],
        [ 45, 164, 212],
        ...,
        [  0, 110, 145],
        [  0, 112, 146],
        [  0, 112, 146]],

       [[ 22, 148, 187],
        [ 25, 149, 188],
        [ 30, 151, 192],
        ...,
        [  0, 110, 144],
        [  0, 111, 145],
        [  0, 113, 147]],

       ...,

       [[ 76, 135, 145],
        [ 78, 136, 131],
        [109, 161, 145],
        ...,
        [ 53,  74,  78],
        [ 18,  34,  62],
        [ 26,  25,  57]],

       [[ 70, 126, 134],
        [ 83, 135, 132],
        [111, 158, 144],
        ...,
        [ 48,  73,  83],
        [ 15,  32,  67],
        [ 26,  23,  59]],

       [[ 70, 114, 119],
        [ 97, 139, 136],
        [137, 176, 166],
        ...,
        [ 27,  45,  62],
        [ 13,  24,  59],
        [ 25,  25,  56]]], dtype=uint8)]"
Image_1992.jpg,190,107,349,257,1024,670,539,364,349,daskShared_local/images/Image_1992.jpg,1992,"[array([[[ 36,  54,  69],
        [ 39,  63,  72],
        [ 42,  66,  75],
        ...,
        [ 12, 106, 115],
        [ 10, 107, 121],
        [ 50, 170, 182]],

       [[ 28,  47,  62],
        [ 39,  63,  72],
        [ 40,  61,  72],
        ...,
        [ 32,  96, 108],
        [ 33, 111, 125],
        [ 29, 130, 144]],

       [[ 23,  40,  56],
        [ 42,  52,  55],
        [ 37,  48,  54],
        ...,
        [  6,  73,  92],
        [ 18,  83, 102],
        [ 12,  75,  91]],

       ...,

       [[  5,   9,  25],
        [  5,   7,  19],
        [ 22,  54,  95],
        ...,
        [ 39, 138, 155],
        [ 35, 139, 154],
        [ 32, 138, 149]],

       [[ 11,   6,  11],
        [  8,   6,  22],
        [ 29,  51, 101],
        ...,
        [ 39, 162, 182],
        [ 29, 162, 183],
        [ 39, 179, 201]],

       [[  4,  15,   8],
        [ 15,  14,  35],
        [ 13,  29,  85],
        ...,
        [ 53, 163, 187],
        [ 68, 189, 212],
        [ 90, 214, 237]]], dtype=uint8)]"
Image_1993.jpg,253,217,127,138,775,518,380,355,138,daskShared_local/images/Image_1993.jpg,1993,"[array([[[166, 142, 134],
        [164, 140, 132],
        [170, 144, 136],
        ...,
        [125,  92,  62],
        [138, 105,  72],
        [143, 110,  76]],

       [[169, 145, 136],
        [167, 142, 133],
        [169, 143, 134],
        ...,
        [112,  80,  49],
        [135, 102,  67],
        [147, 114,  80]],

       [[172, 147, 136],
        [173, 147, 137],
        [174, 147, 137],
        ...,
        [102,  70,  38],
        [126,  93,  57],
        [142, 109,  74]],

       ...,

       [[162, 135,  88],
        [167, 140,  93],
        [176, 149, 102],
        ...,
        [189, 153, 110],
        [188, 154, 109],
        [191, 157, 112]],

       [[155, 128,  81],
        [159, 132,  85],
        [167, 140,  93],
        ...,
        [196, 160, 117],
        [195, 161, 116],
        [197, 163, 118]],

       [[152, 125,  78],
        [154, 127,  80],
        [162, 135,  88],
        ...,
        [201, 165, 122],
        [200, 166, 121],
        [201, 167, 122]]], dtype=uint8)]"
Image_1994.jpg,311,307,160,127,966,642,471,434,160,daskShared_local/images/Image_1994.jpg,1994,"[array([[[ 11,  86,  66],
        [ 11,  88,  71],
        [ 11,  88,  72],
        ...,
        [ 26,  36,  28],
        [ 39,  43,  33],
        [ 47,  44,  40]],

       [[  7,  83,  56],
        [ 12,  86,  64],
        [ 12,  84,  63],
        ...,
        [ 16,  25,  21],
        [ 19,  26,  21],
        [ 21,  23,  24]],

       [[  7,  82,  50],
        [ 13,  85,  54],
        [ 13,  83,  52],
        ...,
        [ 14,  21,  22],
        [ 13,  19,  16],
        [ 13,  16,  16]],

       ...,

       [[ 27, 197, 213],
        [ 13, 196, 205],
        [ 10, 197, 204],
        ...,
        [ 44, 223, 233],
        [ 54, 226, 237],
        [ 63, 229, 240]],

       [[ 23, 195, 209],
        [ 11, 193, 202],
        [ 10, 195, 202],
        ...,
        [ 45, 223, 233],
        [ 58, 228, 239],
        [ 67, 232, 244]],

       [[ 20, 193, 207],
        [ 14, 194, 204],
        [ 14, 197, 205],
        ...,
        [ 49, 225, 235],
        [ 61, 231, 242],
        [ 69, 234, 246]]], dtype=uint8)]"
Image_1995.jpg,732,344,177,144,1600,1000,909,488,177,daskShared_local/images/Image_1995.jpg,1995,"[array([[[  0,  81, 163],
        [  0,  81, 163],
        [  0,  81, 163],
        ...,
        [  0,  81, 163],
        [  0,  81, 163],
        [  0,  81, 163]],

       [[  0,  81, 163],
        [  0,  81, 163],
        [  0,  81, 163],
        ...,
        [  0,  81, 163],
        [  0,  81, 163],
        [  0,  81, 163]],

       [[  0,  81, 163],
        [  0,  81, 163],
        [  0,  81, 163],
        ...,
        [  0,  81, 163],
        [  0,  81, 163],
        [  0,  81, 163]],

       ...,

       [[ 86, 181, 174],
        [ 92, 189, 176],
        [ 83, 182, 164],
        ...,
        [200, 171, 159],
        [190, 168, 156],
        [194, 177, 165]],

       [[ 73, 166, 150],
        [ 71, 163, 143],
        [ 53, 145, 120],
        ...,
        [226, 195, 179],
        [207, 181, 166],
        [195, 176, 161]],

       [[ 38, 129, 111],
        [ 23, 111,  88],
        [ 18, 103,  78],
        ...,
        [209, 174, 155],
        [214, 186, 168],
        [215, 194, 176]]], dtype=uint8)]"
Image_1996.jpg,409,327,128,124,800,600,537,451,128,daskShared_local/images/Image_1996.jpg,1996,"[array([[[220, 208, 179],
        [216, 205, 176],
        [209, 198, 172],
        ...,
        [  0,  87,  99],
        [  2,  88, 101],
        [  3,  89, 102]],

       [[216, 209, 180],
        [212, 205, 178],
        [204, 198, 173],
        ...,
        [  1,  87, 100],
        [  2,  89, 101],
        [  3,  90, 102]],

       [[207, 209, 182],
        [203, 205, 180],
        [194, 196, 175],
        ...,
        [  2,  88, 101],
        [  3,  89, 102],
        [  3,  90, 102]],

       ...,

       [[ 34,  52,  52],
        [ 34,  52,  52],
        [ 33,  51,  51],
        ...,
        [ 64, 153, 113],
        [ 51, 140,  98],
        [ 42, 131,  88]],

       [[ 34,  53,  52],
        [ 34,  53,  52],
        [ 33,  52,  52],
        ...,
        [ 50, 141,  98],
        [ 44, 132,  91],
        [ 40, 127,  85]],

       [[ 34,  53,  53],
        [ 34,  53,  52],
        [ 33,  53,  52],
        ...,
        [ 41, 131,  88],
        [ 40, 128,  86],
        [ 39, 125,  84]]], dtype=uint8)]"
Image_1997.jpg,691,299,507,501,1920,1080,1198,800,507,daskShared_local/images/Image_1997.jpg,1997,"[array([[[ 18,  39,  51],
        [ 38,  57,  58],
        [ 46,  61,  54],
        ...,
        [ 46,  72,  73],
        [ 31,  66,  64],
        [ 42,  85,  80]],

       [[ 11,  35,  45],
        [ 40,  60,  60],
        [ 46,  62,  55],
        ...,
        [ 41,  75,  73],
        [ 29,  75,  70],
        [ 26,  79,  72]],

       [[ 16,  45,  49],
        [ 35,  58,  55],
        [ 46,  64,  56],
        ...,
        [ 47,  98,  91],
        [ 65, 124, 116],
        [131, 202, 192]],

       ...,

       [[ 27,  94, 146],
        [ 27,  94, 146],
        [ 27,  94, 145],
        ...,
        [ 23,  39,  37],
        [ 24,  39,  36],
        [ 23,  39,  36]],

       [[ 27,  93, 145],
        [ 28,  94, 145],
        [ 27,  94, 145],
        ...,
        [ 24,  39,  38],
        [ 26,  41,  39],
        [ 26,  42,  39]],

       [[ 27,  93, 143],
        [ 28,  94, 144],
        [ 29,  95, 145],
        ...,
        [ 22,  36,  37],
        [ 22,  41,  39],
        [ 27,  46,  42]]], dtype=uint8)]"
Image_1998.jpg,165,181,177,128,728,500,342,309,177,daskShared_local/images/Image_1998.jpg,1998,"[array([[[  1,  71, 218],
        [  0,  69, 216],
        [  1,  71, 219],
        ...,
        [  1,  80, 225],
        [  0,  79, 224],
        [  0,  81, 225]],

       [[  2,  72, 219],
        [  1,  71, 219],
        [  1,  71, 219],
        ...,
        [  0,  79, 224],
        [  1,  80, 225],
        [  1,  80, 225]],

       [[  1,  71, 218],
        [  2,  70, 219],
        [  1,  69, 217],
        ...,
        [  0,  79, 224],
        [  1,  80, 225],
        [  2,  81, 225]],

       ...,

       [[ 20, 136, 144],
        [ 20, 138, 148],
        [ 21, 137, 153],
        ...,
        [204, 160, 116],
        [225, 189, 154],
        [230, 196, 158]],

       [[ 24, 139, 144],
        [ 20, 139, 146],
        [ 17, 135, 145],
        ...,
        [216, 175, 111],
        [235, 201, 141],
        [250, 237, 187]],

       [[ 24, 139, 146],
        [ 19, 141, 148],
        [ 24, 143, 146],
        ...,
        [243, 215, 153],
        [241, 216, 177],
        [250, 244, 222]]], dtype=uint8)]"
Image_1999.jpg,802,335,154,113,1536,1024,956,448,154,daskShared_local/images/Image_1999.jpg,1999,"[array([[[  8,  90, 164],
        [ 18, 109, 190],
        [ 33, 122, 210],
        ...,
        [ 47, 124, 214],
        [ 46, 123, 213],
        [ 46, 123, 213]],

       [[ 15, 101, 180],
        [ 26, 115, 200],
        [ 36, 124, 211],
        ...,
        [ 47, 124, 214],
        [ 47, 124, 214],
        [ 47, 124, 214]],

       [[ 25, 114, 197],
        [ 35, 120, 208],
        [ 41, 125, 211],
        ...,
        [ 47, 124, 214],
        [ 47, 124, 214],
        [ 47, 124, 214]],

       ...,

       [[ 18, 117, 203],
        [ 17, 117, 203],
        [ 16, 116, 202],
        ...,
        [ 17, 114, 204],
        [ 18, 114, 203],
        [ 18, 113, 202]],

       [[ 19, 117, 204],
        [ 18, 117, 204],
        [ 18, 117, 204],
        ...,
        [ 14, 113, 202],
        [ 15, 113, 202],
        [ 16, 112, 202]],

       [[ 20, 116, 203],
        [ 19, 116, 203],
        [ 18, 117, 203],
        ...,
        [ 12, 112, 201],
        [ 14, 113, 201],
        [ 15, 113, 202]]], dtype=uint8)]"
Image_2.jpg,632,183,481,441,2000,1000,1113,624,481,daskShared_local/images/Image_2.jpg,2,"[array([[[  1, 159, 207],
        [  2, 160, 208],
        [  2, 160, 208],
        ...,
        [  1, 152, 207],
        [  1, 152, 207],
        [  2, 153, 208]],

       [[  0, 160, 209],
        [  0, 160, 210],
        [  1, 161, 211],
        ...,
        [  0, 151, 206],
        [  1, 152, 207],
        [  1, 152, 207]],

       [[  0, 161, 210],
        [  0, 162, 211],
        [  0, 162, 211],
        ...,
        [  0, 154, 208],
        [  0, 153, 207],
        [  0, 152, 206]],

       ...,

       [[  2, 111, 149],
        [  1, 110, 148],
        [  0, 107, 145],
        ...,
        [  5,  92,  77],
        [  3,  88,  74],
        [ 11,  80,  70]],

       [[  1, 113, 150],
        [  1, 111, 148],
        [  0, 107, 145],
        ...,
        [  2,  89,  75],
        [  5,  80,  68],
        [ 11,  92,  77]],

       [[  1, 110, 147],
        [  1, 107, 145],
        [  0, 103, 142],
        ...,
        [  0,  83,  69],
        [  5,  91,  74],
        [  2,  87,  69]]], dtype=uint8)]"
Image_20.jpg,338,138,260,231,845,563,598,369,260,daskShared_local/images/Image_20.jpg,20,"[array([[[ 77, 202, 202],
        [ 73, 198, 198],
        [ 76, 197, 198],
        ...,
        [ 77, 195, 193],
        [ 80, 194, 194],
        [ 86, 197, 197]],

       [[ 80, 201, 201],
        [ 77, 200, 199],
        [ 78, 198, 198],
        ...,
        [ 73, 193, 191],
        [ 76, 193, 192],
        [ 80, 195, 194]],

       [[ 88, 202, 203],
        [ 85, 203, 202],
        [ 83, 203, 201],
        ...,
        [ 63, 192, 187],
        [ 64, 192, 187],
        [ 66, 193, 189]],

       ...,

       [[ 62, 103,  37],
        [ 59, 101,  35],
        [ 62, 102,  37],
        ...,
        [ 62, 197, 191],
        [ 59, 197, 191],
        [ 55, 195, 189]],

       [[ 66, 108,  42],
        [ 61, 102,  36],
        [ 63, 103,  38],
        ...,
        [ 63, 199, 192],
        [ 65, 201, 194],
        [ 65, 201, 194]],

       [[ 63, 107,  40],
        [ 56,  97,  31],
        [ 54,  95,  29],
        ...,
        [ 62, 200, 192],
        [ 68, 204, 195],
        [ 71, 206, 197]]], dtype=uint8)]"
Image_200.jpg,38,84,221,154,800,600,259,238,221,daskShared_local/images/Image_200.jpg,200,"[array([[[  7, 155, 203],
        [  5, 153, 201],
        [  9, 159, 204],
        ...,
        [ 14, 174, 223],
        [ 18, 176, 224],
        [ 22, 179, 226]],

       [[ 15, 164, 214],
        [  7, 155, 203],
        [  6, 155, 201],
        ...,
        [ 13, 173, 221],
        [ 13, 174, 220],
        [ 17, 175, 220]],

       [[ 22, 169, 221],
        [ 13, 160, 211],
        [  8, 157, 205],
        ...,
        [ 12, 173, 219],
        [ 14, 175, 220],
        [ 21, 178, 225]],

       ...,

       [[ 76, 141, 120],
        [ 70, 133, 116],
        [ 67, 131, 115],
        ...,
        [126, 114,  92],
        [120, 107,  85],
        [116, 103,  80]],

       [[ 71, 137, 119],
        [ 67, 132, 115],
        [ 65, 132, 115],
        ...,
        [103,  86,  64],
        [105,  87,  65],
        [109,  91,  69]],

       [[ 67, 134, 117],
        [ 65, 132, 115],
        [ 62, 130, 113],
        ...,
        [ 91,  71,  48],
        [ 98,  78,  54],
        [110,  89,  68]]], dtype=uint8)]"
Image_2000.jpg,1794,2578,495,391,2720,4080,2289,2969,495,daskShared_local/images/Image_2000.jpg,2000,"[array([[[144, 128, 105],
        [156, 138, 115],
        [132, 109,  84],
        ...,
        [  5, 119, 192],
        [  5, 119, 193],
        [  3, 119, 192]],

       [[103, 101,  91],
        [ 99,  96,  88],
        [ 93,  77,  60],
        ...,
        [  3, 118, 193],
        [  2, 122, 195],
        [  1, 121, 194]],

       [[ 57,  56,  58],
        [ 49,  46,  46],
        [ 76,  63,  52],
        ...,
        [  2, 119, 193],
        [  2, 121, 195],
        [  1, 120, 193]],

       ...,

       [[  7, 118, 192],
        [  3, 114, 188],
        [  7, 117, 191],
        ...,
        [  6, 116, 192],
        [  4, 112, 188],
        [  9, 120, 196]],

       [[  6, 117, 191],
        [  6, 118, 192],
        [  4, 114, 188],
        ...,
        [  2, 109, 185],
        [  6, 117, 193],
        [  3, 113, 189]],

       [[  4, 116, 190],
        [  5, 116, 190],
        [  6, 118, 192],
        ...,
        [  3, 113, 189],
        [  3, 114, 190],
        [  5, 115, 191]]], dtype=uint8)]"
Image_201.jpg,464,131,289,298,1600,1019,753,429,298,daskShared_local/images/Image_201.jpg,201,"[array([[[ 26, 109, 213],
        [ 26, 109, 213],
        [ 26, 109, 213],
        ...,
        [ 28, 116, 213],
        [ 28, 116, 213],
        [ 28, 116, 213]],

       [[ 26, 109, 213],
        [ 26, 109, 213],
        [ 26, 109, 213],
        ...,
        [ 28, 116, 213],
        [ 28, 116, 213],
        [ 28, 116, 213]],

       [[ 26, 109, 213],
        [ 26, 109, 213],
        [ 26, 109, 213],
        ...,
        [ 28, 116, 213],
        [ 28, 116, 213],
        [ 28, 116, 213]],

       ...,

       [[127, 105,  92],
        [174, 151, 137],
        [187, 170, 158],
        ...,
        [ 56,  44,  43],
        [ 54,  28,  31],
        [ 48,  31,  29]],

       [[168, 154, 141],
        [209, 197, 184],
        [223, 217, 205],
        ...,
        [ 33,  10,  10],
        [ 51,  21,  22],
        [ 50,  35,  30]],

       [[208, 207, 198],
        [210, 213, 202],
        [206, 211, 201],
        ...,
        [ 42,   7,   7],
        [ 64,  27,  28],
        [ 55,  40,  33]]], dtype=uint8)]"
Image_202.jpg,248,384,808,578,1512,1231,1056,962,808,daskShared_local/images/Image_202.jpg,202,"[array([[[ 77,  93,  91],
        [ 79,  95,  94],
        [ 80,  94,  92],
        ...,
        [102, 116, 107],
        [ 97, 110, 101],
        [ 93, 106,  96]],

       [[ 77,  94,  88],
        [ 78,  94,  90],
        [ 76,  92,  86],
        ...,
        [ 93, 107,  98],
        [ 88, 101,  90],
        [ 85,  97,  84]],

       [[ 78,  94,  84],
        [ 78,  91,  83],
        [ 74,  88,  81],
        ...,
        [ 82,  94,  82],
        [ 80,  91,  77],
        [ 79,  91,  75]],

       ...,

       [[255, 241, 218],
        [254, 240, 217],
        [255, 240, 217],
        ...,
        [244, 230, 216],
        [241, 228, 213],
        [235, 224, 206]],

       [[255, 241, 218],
        [255, 240, 217],
        [255, 240, 217],
        ...,
        [236, 227, 213],
        [233, 223, 205],
        [221, 211, 188]],

       [[255, 240, 217],
        [255, 240, 217],
        [255, 240, 217],
        ...,
        [228, 213, 192],
        [225, 208, 182],
        [213, 196, 166]]], dtype=uint8)]"
Image_203.jpg,653,292,311,323,1600,1000,964,615,323,daskShared_local/images/Image_203.jpg,203,"[array([[[  0,  69, 162],
        [  0,  69, 162],
        [  0,  69, 162],
        ...,
        [  1,  68, 159],
        [  1,  68, 159],
        [  1,  68, 159]],

       [[  0,  69, 162],
        [  0,  69, 162],
        [  0,  69, 162],
        ...,
        [  0,  67, 158],
        [  0,  67, 158],
        [  1,  68, 159]],

       [[  0,  69, 162],
        [  0,  69, 162],
        [  0,  69, 162],
        ...,
        [  1,  68, 159],
        [  1,  68, 159],
        [  1,  68, 159]],

       ...,

       [[ 67,  76,  45],
        [138, 141,  99],
        [157, 163, 124],
        ...,
        [103,  92,  50],
        [107,  93,  51],
        [111,  95,  55]],

       [[ 43,  50,  29],
        [106, 107,  76],
        [ 99, 103,  74],
        ...,
        [113,  97,  61],
        [123, 107,  71],
        [120, 105,  71]],

       [[ 61,  67,  52],
        [ 69,  68,  46],
        [ 45,  48,  24],
        ...,
        [125, 105,  71],
        [136, 120,  84],
        [158, 146, 108]]], dtype=uint8)]"
Image_204.jpg,356,125,211,189,1280,720,567,314,211,daskShared_local/images/Image_204.jpg,204,"[array([[[ 25, 119, 207],
        [ 24, 120, 207],
        [ 24, 120, 207],
        ...,
        [ 17, 130, 210],
        [ 18, 131, 211],
        [ 17, 130, 210]],

       [[ 19, 113, 201],
        [ 18, 114, 201],
        [ 17, 113, 200],
        ...,
        [ 20, 133, 213],
        [ 19, 132, 212],
        [ 19, 132, 212]],

       [[ 12, 106, 194],
        [ 11, 105, 193],
        [  9, 105, 192],
        ...,
        [ 22, 135, 215],
        [ 21, 134, 214],
        [ 21, 134, 214]],

       ...,

       [[ 16,  81, 173],
        [ 15,  80, 172],
        [ 13,  78, 170],
        ...,
        [ 79,  74,  41],
        [140, 134, 100],
        [196, 188, 152]],

       [[ 13,  78, 170],
        [ 14,  79, 171],
        [ 14,  79, 171],
        ...,
        [ 15,  11,   2],
        [ 62,  57,  29],
        [149, 143, 111]],

       [[ 15,  80, 172],
        [ 15,  80, 172],
        [ 15,  80, 172],
        ...,
        [ 22,  20,   7],
        [  8,   4,   1],
        [ 42,  37,   9]]], dtype=uint8)]"
Image_205.jpg,3374,1259,127,122,3840,2160,3501,1381,127,daskShared_local/images/Image_205.jpg,205,"[array([[[ 32,  95, 110],
        [ 32,  95, 110],
        [ 33,  96, 110],
        ...,
        [  1,  50,  54],
        [  1,  50,  54],
        [  1,  50,  54]],

       [[ 29,  92, 107],
        [ 29,  92, 107],
        [ 30,  93, 107],
        ...,
        [  1,  50,  54],
        [  1,  49,  53],
        [  1,  49,  53]],

       [[ 24,  87, 101],
        [ 24,  87, 102],
        [ 25,  87, 102],
        ...,
        [  0,  49,  53],
        [  0,  48,  52],
        [  0,  48,  52]],

       ...,

       [[  0, 112, 162],
        [  0, 112, 162],
        [  0, 112, 162],
        ...,
        [  2, 109, 155],
        [  2, 109, 155],
        [  2, 109, 155]],

       [[  0, 112, 162],
        [  0, 112, 162],
        [  0, 112, 162],
        ...,
        [  2, 109, 155],
        [  2, 109, 155],
        [  2, 109, 155]],

       [[  0, 113, 163],
        [  0, 112, 162],
        [  0, 112, 162],
        ...,
        [  2, 109, 155],
        [  2, 109, 155],
        [  2, 109, 155]]], dtype=uint8)]"
Image_206.jpg,449,287,168,159,850,567,617,446,168,daskShared_local/images/Image_206.jpg,206,"[array([[[220, 173, 155],
        [156, 111,  92],
        [105,  69,  54],
        ...,
        [ 45,  56,  78],
        [ 49,  52,  80],
        [ 31,  50,  70]],

       [[173, 119,  97],
        [133,  81,  66],
        [111,  67,  58],
        ...,
        [ 42,  55,  81],
        [ 48,  53,  84],
        [ 34,  50,  73]],

       [[156,  99,  73],
        [130,  74,  63],
        [135,  83,  82],
        ...,
        [ 50,  61,  90],
        [ 48,  57,  88],
        [ 46,  53,  75]],

       ...,

       [[  8, 124, 233],
        [  9, 125, 236],
        [  9, 125, 236],
        ...,
        [  9, 127, 233],
        [  8, 126, 232],
        [ 10, 128, 234]],

       [[  8, 124, 234],
        [  9, 125, 236],
        [ 10, 126, 237],
        ...,
        [  9, 127, 233],
        [  9, 127, 233],
        [ 11, 129, 235]],

       [[  8, 124, 235],
        [  9, 125, 236],
        [  9, 125, 236],
        ...,
        [ 10, 128, 234],
        [ 10, 128, 235],
        [ 11, 129, 237]]], dtype=uint8)]"
Image_207.jpg,417,3,406,501,1280,720,823,504,501,daskShared_local/images/Image_207.jpg,207,"[array([[[157, 227, 237],
        [155, 227, 236],
        [154, 226, 237],
        ...,
        [ 30, 177, 205],
        [ 28, 175, 201],
        [ 49, 179, 205]],

       [[159, 228, 238],
        [156, 228, 238],
        [155, 228, 239],
        ...,
        [ 39, 178, 204],
        [ 52, 179, 205],
        [ 47, 180, 206]],

       [[161, 227, 241],
        [159, 227, 240],
        [157, 227, 239],
        ...,
        [ 48, 179, 205],
        [ 56, 181, 211],
        [ 44, 178, 206]],

       ...,

       [[ 38,  35,  30],
        [ 49,  44,  38],
        [ 76,  65,  55],
        ...,
        [  3,  76,  99],
        [  4,  76, 100],
        [  4,  76, 100]],

       [[ 44,  40,  35],
        [ 65,  58,  47],
        [ 87,  79,  59],
        ...,
        [  3,  75,  99],
        [  3,  75,  99],
        [  3,  75,  99]],

       [[ 53,  49,  42],
        [ 77,  66,  56],
        [102,  92,  75],
        ...,
        [  2,  74,  98],
        [  2,  74,  98],
        [  2,  74,  98]]], dtype=uint8)]"
Image_208.jpg,404,1016,813,581,4601,3200,1217,1597,813,daskShared_local/images/Image_208.jpg,208,"[array([[[ 25, 159, 236],
        [ 31, 165, 238],
        [ 28, 158, 235],
        ...,
        [ 49, 158, 231],
        [ 51, 165, 234],
        [ 52, 163, 241]],

       [[ 22, 155, 228],
        [ 32, 163, 238],
        [ 31, 157, 232],
        ...,
        [ 52, 159, 221],
        [ 50, 156, 218],
        [ 52, 160, 226]],

       [[ 29, 157, 232],
        [ 31, 162, 236],
        [ 32, 159, 225],
        ...,
        [ 51, 163, 229],
        [ 50, 157, 221],
        [ 52, 153, 218]],

       ...,

       [[ 28, 157, 227],
        [ 29, 157, 224],
        [ 29, 157, 223],
        ...,
        [ 37, 150, 203],
        [ 44, 161, 218],
        [ 45, 160, 217]],

       [[ 17, 148, 215],
        [ 26, 158, 226],
        [ 23, 156, 220],
        ...,
        [ 37, 152, 198],
        [ 47, 164, 212],
        [ 45, 160, 210]],

       [[ 20, 154, 216],
        [ 24, 154, 221],
        [ 18, 149, 216],
        ...,
        [ 45, 154, 198],
        [ 45, 156, 207],
        [ 43, 158, 207]]], dtype=uint8)]"
Image_209.jpg,908,459,667,518,3008,2000,1575,977,667,daskShared_local/images/Image_209.jpg,209,"[array([[[148, 187, 194],
        [148, 187, 194],
        [148, 187, 194],
        ...,
        [137, 179, 191],
        [137, 179, 191],
        [137, 179, 191]],

       [[148, 187, 194],
        [148, 187, 194],
        [148, 187, 194],
        ...,
        [137, 179, 191],
        [137, 179, 191],
        [137, 179, 191]],

       [[148, 187, 194],
        [148, 187, 194],
        [148, 187, 194],
        ...,
        [137, 179, 191],
        [137, 179, 191],
        [137, 179, 191]],

       ...,

       [[115, 173, 179],
        [117, 171, 179],
        [118, 171, 179],
        ...,
        [ 59,  79,  83],
        [ 60,  79,  83],
        [ 56,  75,  79]],

       [[111, 170, 176],
        [114, 168, 176],
        [115, 168, 176],
        ...,
        [ 78,  99, 102],
        [ 74,  93,  97],
        [ 75,  94,  98]],

       [[111, 170, 176],
        [114, 168, 176],
        [115, 168, 176],
        ...,
        [ 84, 105, 108],
        [ 79,  98, 102],
        [ 85, 104, 108]]], dtype=uint8)]"
Image_21.jpg,279,168,171,162,800,533,450,330,171,daskShared_local/images/Image_21.jpg,21,"[array([[[233, 206, 185],
        [236, 213, 185],
        [237, 216, 186],
        ...,
        [ 47,  45,  65],
        [ 53,  50,  76],
        [ 49,  46,  73]],

       [[237, 214, 201],
        [240, 219, 199],
        [238, 217, 195],
        ...,
        [ 73,  71,  90],
        [ 67,  65,  89],
        [ 61,  58,  83]],

       [[242, 225, 221],
        [246, 224, 215],
        [242, 220, 209],
        ...,
        [ 87,  86, 104],
        [ 86,  84, 107],
        [ 90,  88, 110]],

       ...,

       [[164, 137, 118],
        [157, 129, 116],
        [158, 130, 118],
        ...,
        [ 83,  67,  58],
        [ 77,  59,  46],
        [ 76,  58,  45]],

       [[159, 132, 113],
        [164, 136, 123],
        [164, 136, 124],
        ...,
        [ 89,  73,  62],
        [ 94,  76,  62],
        [ 94,  76,  62]],

       [[144, 117,  99],
        [143, 115, 101],
        [143, 115, 103],
        ...,
        [104,  88,  76],
        [118, 100,  86],
        [117,  99,  85]]], dtype=uint8)]"
Image_210.jpg,614,315,192,158,1400,933,806,473,192,daskShared_local/images/Image_210.jpg,210,"[array([[[  0, 172, 230],
        [  0, 172, 230],
        [  0, 173, 229],
        ...,
        [  0, 206, 248],
        [  0, 205, 247],
        [  0, 206, 248]],

       [[  0, 172, 230],
        [  0, 172, 230],
        [  0, 175, 230],
        ...,
        [  0, 205, 245],
        [  0, 205, 245],
        [  0, 206, 246]],

       [[  0, 172, 230],
        [  0, 172, 230],
        [  1, 176, 231],
        ...,
        [  0, 205, 245],
        [  0, 206, 246],
        [  1, 207, 247]],

       ...,

       [[208, 186, 150],
        [218, 195, 157],
        [240, 201, 187],
        ...,
        [  0, 184, 236],
        [  0, 184, 236],
        [  0, 184, 236]],

       [[179, 165, 137],
        [247, 243, 226],
        [251, 245, 244],
        ...,
        [  0, 185, 236],
        [  0, 184, 236],
        [  0, 183, 235]],

       [[155, 144, 116],
        [155, 139, 122],
        [163, 147, 131],
        ...,
        [  0, 185, 236],
        [  0, 183, 235],
        [  0, 183, 235]]], dtype=uint8)]"
Image_211.jpg,214,453,162,181,2015,1510,376,634,181,daskShared_local/images/Image_211.jpg,211,"[array([[[ 52,  49,  44],
        [ 54,  51,  46],
        [ 55,  52,  47],
        ...,
        [ 14,  13,   6],
        [  9,   4,   1],
        [ 12,   7,   4]],

       [[ 50,  47,  42],
        [ 51,  48,  43],
        [ 47,  44,  39],
        ...,
        [ 13,  12,   5],
        [ 14,   6,   4],
        [ 16,   9,   6]],

       [[ 49,  48,  43],
        [ 44,  43,  39],
        [ 35,  33,  29],
        ...,
        [ 12,  10,   3],
        [ 21,  12,  10],
        [ 22,  12,  11]],

       ...,

       [[176, 172, 160],
        [163, 159, 148],
        [135, 132, 121],
        ...,
        [206, 206, 209],
        [210, 220, 221],
        [176, 186, 187]],

       [[156, 152, 140],
        [143, 140, 128],
        [108, 106,  94],
        ...,
        [209, 208, 211],
        [200, 210, 211],
        [183, 193, 194]],

       [[141, 139, 127],
        [133, 131, 119],
        [114, 114, 103],
        ...,
        [230, 228, 231],
        [212, 222, 223],
        [192, 202, 203]]], dtype=uint8)]"
Image_212.jpg,212,37,212,166,900,521,424,203,212,daskShared_local/images/Image_212.jpg,212,"[array([[[ 16,  58, 170],
        [ 16,  58, 170],
        [ 16,  58, 170],
        ...,
        [ 34,  69, 185],
        [ 34,  69, 185],
        [ 34,  69, 185]],

       [[ 16,  58, 170],
        [ 16,  58, 170],
        [ 16,  58, 170],
        ...,
        [ 34,  69, 185],
        [ 34,  69, 185],
        [ 34,  69, 185]],

       [[ 16,  58, 170],
        [ 17,  59, 171],
        [ 17,  59, 171],
        ...,
        [ 32,  69, 184],
        [ 32,  69, 184],
        [ 32,  69, 184]],

       ...,

       [[  1,  51, 136],
        [  1,  51, 136],
        [  2,  52, 137],
        ...,
        [205, 222, 216],
        [204, 221, 215],
        [217, 234, 228]],

       [[  2,  52, 139],
        [  2,  52, 139],
        [  2,  52, 139],
        ...,
        [207, 223, 221],
        [199, 215, 214],
        [214, 230, 228]],

       [[  2,  52, 139],
        [  2,  52, 139],
        [  2,  52, 139],
        ...,
        [201, 217, 216],
        [187, 203, 202],
        [203, 219, 218]]], dtype=uint8)]"
Image_213.jpg,101,259,162,117,900,600,263,376,162,daskShared_local/images/Image_213.jpg,213,"[array([[[  4,  84,  91],
        [  3,  81,  91],
        [  1,  79,  89],
        ...,
        [  7,  86,  98],
        [ 16,  95, 105],
        [ 24, 103, 111]],

       [[  6,  83,  91],
        [  3,  79,  89],
        [  1,  76,  87],
        ...,
        [  2,  86,  98],
        [  6,  90, 101],
        [  9,  94, 103]],

       [[  8,  81,  91],
        [  3,  74,  85],
        [  2,  72,  84],
        ...,
        [  1,  87, 100],
        [  2,  90, 103],
        [  1,  89, 102]],

       ...,

       [[  0,  66,  75],
        [  1,  66,  75],
        [  1,  66,  75],
        ...,
        [ 15,  44,  40],
        [ 15,  42,  39],
        [ 14,  41,  38]],

       [[  0,  67,  76],
        [  2,  66,  76],
        [  2,  66,  76],
        ...,
        [ 18,  45,  41],
        [ 18,  45,  41],
        [ 17,  43,  40]],

       [[  0,  67,  76],
        [  2,  67,  77],
        [  3,  67,  77],
        ...,
        [ 19,  47,  42],
        [ 20,  47,  42],
        [ 19,  46,  41]]], dtype=uint8)]"
Image_214.jpg,693,187,193,144,1000,600,886,331,193,daskShared_local/images/Image_214.jpg,214,"[array([[[  1, 158, 203],
        [  0, 158, 203],
        [  0, 157, 202],
        ...,
        [  2, 145, 205],
        [  2, 145, 205],
        [  2, 145, 205]],

       [[  1, 157, 205],
        [  0, 158, 205],
        [  0, 158, 205],
        ...,
        [  2, 146, 206],
        [  3, 147, 207],
        [  3, 147, 207]],

       [[  1, 159, 206],
        [  0, 158, 205],
        [  0, 160, 206],
        ...,
        [  4, 148, 208],
        [  5, 149, 209],
        [  6, 150, 210]],

       ...,

       [[ 97,  85,  43],
        [167, 159, 112],
        [250, 249, 205],
        ...,
        [192, 191, 162],
        [188, 186, 166],
        [176, 173, 157]],

       [[168, 159, 118],
        [232, 225, 180],
        [252, 251, 207],
        ...,
        [173, 170, 153],
        [184, 180, 169],
        [193, 189, 180]],

       [[219, 212, 174],
        [233, 227, 186],
        [208, 206, 158],
        ...,
        [125, 122, 116],
        [167, 163, 162],
        [208, 204, 203]]], dtype=uint8)]"
Image_215.jpg,379,340,344,218,1904,803,723,558,344,daskShared_local/images/Image_215.jpg,215,"[array([[[  2,  56,  99],
        [  2,  56,  99],
        [  2,  56,  99],
        ...,
        [ 83, 148, 152],
        [117, 182, 190],
        [180, 241, 246]],

       [[  4,  58, 103],
        [  4,  58, 102],
        [  4,  58, 103],
        ...,
        [148, 199, 202],
        [201, 251, 252],
        [195, 248, 252]],

       [[  4,  58, 104],
        [  4,  58, 104],
        [  4,  58, 104],
        ...,
        [202, 250, 252],
        [173, 233, 242],
        [134, 194, 204]],

       ...,

       [[  5,  86, 113],
        [  7,  86, 131],
        [ 11,  89, 144],
        ...,
        [186, 238, 230],
        [102, 196, 207],
        [ 53, 155, 168]],

       [[ 16,  64,  95],
        [ 17,  64, 107],
        [ 19,  65, 116],
        ...,
        [155, 216, 208],
        [ 86, 177, 199],
        [ 32, 129, 156]],

       [[  7,  41,  73],
        [  6,  39,  73],
        [  5,  39,  74],
        ...,
        [118, 188, 185],
        [ 68, 162, 192],
        [ 35, 136, 169]]], dtype=uint8)]"
Image_216.jpg,1186,1032,466,415,2592,1944,1652,1447,466,daskShared_local/images/Image_216.jpg,216,"[array([[[127, 104,  90],
        [117,  92,  79],
        [124,  96,  82],
        ...,
        [ 43, 117, 174],
        [ 40, 116, 168],
        [ 42, 116, 168]],

       [[127, 101,  86],
        [112,  85,  70],
        [111,  83,  65],
        ...,
        [ 42, 116, 173],
        [ 41, 117, 170],
        [ 43, 118, 170]],

       [[124,  99,  78],
        [108,  81,  59],
        [132, 103,  78],
        ...,
        [ 44, 115, 173],
        [ 44, 117, 172],
        [ 44, 117, 172]],

       ...,

       [[ 38, 120, 168],
        [ 38, 120, 168],
        [ 39, 120, 169],
        ...,
        [ 39, 123, 167],
        [ 42, 125, 168],
        [ 40, 123, 166]],

       [[ 38, 122, 169],
        [ 38, 122, 169],
        [ 39, 122, 170],
        ...,
        [ 39, 124, 165],
        [ 39, 120, 166],
        [ 40, 121, 168]],

       [[ 38, 122, 170],
        [ 39, 122, 169],
        [ 40, 122, 169],
        ...,
        [ 40, 123, 164],
        [ 40, 119, 166],
        [ 44, 121, 170]]], dtype=uint8)]"
Image_217.jpg,519,87,289,400,1600,900,808,487,400,daskShared_local/images/Image_217.jpg,217,"[array([[[  0, 155, 209],
        [  0, 155, 209],
        [  0, 155, 209],
        ...,
        [152, 199, 241],
        [151, 198, 240],
        [151, 198, 240]],

       [[  1, 155, 209],
        [  1, 155, 209],
        [  0, 155, 209],
        ...,
        [152, 199, 241],
        [151, 198, 240],
        [151, 198, 240]],

       [[  1, 155, 209],
        [  1, 155, 209],
        [  1, 155, 209],
        ...,
        [152, 199, 241],
        [151, 198, 240],
        [151, 198, 240]],

       ...,

       [[  0, 142, 202],
        [  0, 143, 203],
        [  0, 143, 203],
        ...,
        [ 64,  41,  42],
        [ 80,  58,  52],
        [ 88,  66,  55]],

       [[  0, 142, 202],
        [  0, 143, 203],
        [  0, 143, 203],
        ...,
        [ 57,  38,  38],
        [ 87,  69,  63],
        [ 93,  76,  66]],

       [[  0, 142, 202],
        [  0, 143, 203],
        [  0, 143, 203],
        ...,
        [ 48,  34,  34],
        [ 73,  59,  56],
        [ 93,  81,  74]]], dtype=uint8)]"
Image_218.jpg,987,144,251,350,1686,1216,1238,494,350,daskShared_local/images/Image_218.jpg,218,"[array([[[121, 182, 213],
        [122, 183, 214],
        [123, 184, 215],
        ...,
        [161, 201, 226],
        [161, 201, 226],
        [161, 201, 226]],

       [[120, 181, 212],
        [122, 183, 214],
        [122, 183, 214],
        ...,
        [161, 201, 226],
        [161, 201, 226],
        [161, 201, 226]],

       [[120, 181, 212],
        [121, 182, 213],
        [121, 182, 213],
        ...,
        [160, 200, 225],
        [160, 200, 225],
        [160, 200, 225]],

       ...,

       [[183, 188, 171],
        [188, 188, 170],
        [169, 167, 148],
        ...,
        [ 81, 163, 200],
        [ 79, 161, 198],
        [ 81, 163, 200]],

       [[183, 191, 175],
        [182, 184, 167],
        [158, 156, 137],
        ...,
        [ 82, 164, 201],
        [ 79, 161, 198],
        [ 80, 162, 199]],

       [[197, 207, 193],
        [189, 195, 178],
        [153, 154, 135],
        ...,
        [ 81, 163, 200],
        [ 78, 160, 197],
        [ 77, 159, 196]]], dtype=uint8)]"
Image_219.jpg,512,84,149,190,1200,630,661,274,190,daskShared_local/images/Image_219.jpg,219,"[array([[[  2, 155, 222],
        [  2, 155, 222],
        [  2, 155, 222],
        ...,
        [  3, 155, 222],
        [  3, 155, 222],
        [  3, 155, 222]],

       [[  1, 154, 221],
        [  1, 154, 221],
        [  1, 154, 221],
        ...,
        [  2, 154, 221],
        [  3, 155, 222],
        [  3, 155, 222]],

       [[  1, 154, 221],
        [  1, 154, 221],
        [  1, 154, 221],
        ...,
        [  2, 154, 221],
        [  3, 155, 222],
        [  3, 155, 222]],

       ...,

       [[ 26,  15,  23],
        [ 23,  13,  19],
        [ 22,  12,  16],
        ...,
        [  6,  85, 124],
        [  4,  83, 121],
        [  2,  81, 120]],

       [[ 24,  11,  20],
        [ 28,  15,  24],
        [ 21,   8,  17],
        ...,
        [  2,  80, 118],
        [  1,  81, 118],
        [  0,  82, 119]],

       [[ 31,  18,  27],
        [ 28,  15,  24],
        [ 19,   6,  15],
        ...,
        [  2,  80, 118],
        [  0,  79, 116],
        [  0,  80, 117]]], dtype=uint8)]"
Image_22.jpg,649,120,203,192,1156,650,852,312,203,daskShared_local/images/Image_22.jpg,22,"[array([[[ 64, 151, 179],
        [ 56, 146, 173],
        [ 47, 139, 168],
        ...,
        [ 20, 135, 148],
        [  1, 127, 137],
        [  3, 141, 151]],

       [[ 49, 139, 166],
        [ 50, 141, 168],
        [ 45, 140, 168],
        ...,
        [ 28, 135, 148],
        [ 17, 138, 149],
        [ 21, 148, 159]],

       [[ 30, 124, 150],
        [ 55, 152, 177],
        [ 74, 173, 200],
        ...,
        [ 63, 158, 174],
        [ 44, 149, 165],
        [ 44, 155, 170]],

       ...,

       [[ 43,  39,  28],
        [ 63,  60,  45],
        [ 83,  81,  61],
        ...,
        [  4, 128, 180],
        [  4, 128, 179],
        [  4, 128, 179]],

       [[ 10,   3,   1],
        [ 31,  25,  11],
        [ 76,  71,  52],
        ...,
        [  4, 128, 180],
        [  4, 128, 179],
        [  4, 128, 179]],

       [[ 12,   6,   0],
        [ 13,   7,   1],
        [ 54,  49,  29],
        ...,
        [  3, 129, 180],
        [  3, 129, 179],
        [  3, 129, 179]]], dtype=uint8)]"
Image_220.jpg,417,172,823,642,1500,1000,1240,814,823,daskShared_local/images/Image_220.jpg,220,"[array([[[  3,  58,  65],
        [  2,  56,  65],
        [  3,  55,  66],
        ...,
        [142, 139, 162],
        [104, 107, 142],
        [ 87,  92, 135]],

       [[  2,  58,  66],
        [  2,  57,  66],
        [  3,  55,  66],
        ...,
        [123, 123, 150],
        [ 95, 100, 138],
        [ 82,  87, 132]],

       [[  1,  58,  67],
        [  1,  57,  66],
        [  3,  55,  66],
        ...,
        [ 99, 100, 138],
        [ 82,  86, 131],
        [ 77,  81, 129]],

       ...,

       [[147, 164, 193],
        [191, 195, 207],
        [204, 203, 209],
        ...,
        [ 60,  86,  57],
        [ 60,  88,  58],
        [ 58,  88,  58]],

       [[121, 143, 184],
        [172, 182, 200],
        [195, 197, 207],
        ...,
        [ 61,  88,  57],
        [ 62,  88,  58],
        [ 60,  89,  59]],

       [[109, 136, 179],
        [155, 169, 196],
        [183, 190, 205],
        ...,
        [ 62,  89,  58],
        [ 62,  88,  59],
        [ 59,  88,  58]]], dtype=uint8)]"
Image_221.jpg,979,393,198,200,2000,1000,1177,593,200,daskShared_local/images/Image_221.jpg,221,"[array([[[193, 170, 136],
        [195, 173, 136],
        [193, 171, 134],
        ...,
        [207, 187, 150],
        [205, 179, 142],
        [203, 179, 141]],

       [[193, 171, 134],
        [199, 177, 138],
        [197, 175, 136],
        ...,
        [210, 188, 149],
        [210, 186, 148],
        [208, 184, 148]],

       [[215, 195, 160],
        [197, 175, 136],
        [199, 177, 138],
        ...,
        [206, 182, 144],
        [203, 179, 143],
        [201, 179, 142]],

       ...,

       [[131, 127, 115],
        [189, 186, 171],
        [197, 194, 175],
        ...,
        [192, 166, 131],
        [197, 175, 138],
        [199, 173, 138]],

       [[138, 132, 118],
        [168, 165, 148],
        [204, 201, 182],
        ...,
        [204, 170, 142],
        [198, 174, 136],
        [198, 169, 135]],

       [[159, 156, 137],
        [166, 164, 143],
        [185, 183, 160],
        ...,
        [185, 151, 118],
        [186, 158, 118],
        [195, 167, 127]]], dtype=uint8)]"
Image_222.jpg,363,24,151,119,550,380,514,143,151,daskShared_local/images/Image_222.jpg,222,"[array([[[ 75,  94, 150],
        [ 75,  94, 150],
        [ 75,  94, 150],
        ...,
        [ 72,  87, 146],
        [ 73,  88, 147],
        [ 72,  87, 146]],

       [[ 75,  94, 150],
        [ 75,  94, 150],
        [ 75,  94, 150],
        ...,
        [ 71,  87, 146],
        [ 72,  87, 146],
        [ 72,  87, 146]],

       [[ 75,  94, 150],
        [ 75,  94, 150],
        [ 75,  94, 150],
        ...,
        [ 70,  86, 145],
        [ 72,  87, 146],
        [ 72,  87, 146]],

       ...,

       [[207, 182, 159],
        [169, 146, 122],
        [126, 105,  79],
        ...,
        [ 64,  78, 139],
        [ 63,  77, 138],
        [ 64,  78, 139]],

       [[233, 207, 184],
        [201, 178, 154],
        [157, 136, 111],
        ...,
        [ 64,  78, 139],
        [ 64,  78, 139],
        [ 64,  78, 139]],

       [[232, 206, 182],
        [214, 190, 166],
        [180, 159, 135],
        ...,
        [ 65,  79, 140],
        [ 64,  78, 139],
        [ 64,  78, 139]]], dtype=uint8)]"
Image_223.jpg,125,158,355,280,1152,768,480,438,355,daskShared_local/images/Image_223.jpg,223,"[array([[[187, 237, 225],
        [187, 237, 225],
        [187, 237, 226],
        ...,
        [143, 222, 217],
        [143, 222, 217],
        [143, 222, 217]],

       [[189, 238, 226],
        [190, 238, 226],
        [190, 238, 226],
        ...,
        [150, 226, 221],
        [150, 226, 221],
        [150, 226, 221]],

       [[190, 238, 226],
        [192, 239, 227],
        [194, 238, 225],
        ...,
        [160, 231, 227],
        [160, 231, 227],
        [160, 231, 227]],

       ...,

       [[102, 184, 193],
        [102, 183, 191],
        [102, 182, 189],
        ...,
        [ 90, 114, 120],
        [ 67,  97, 106],
        [ 98, 134, 145]],

       [[101, 184, 192],
        [100, 182, 191],
        [ 99, 179, 188],
        ...,
        [ 87, 115, 119],
        [ 75, 105, 112],
        [ 89, 121, 131]],

       [[101, 182, 190],
        [ 99, 180, 189],
        [ 98, 178, 187],
        ...,
        [ 86, 115, 119],
        [ 80, 109, 117],
        [ 90, 117, 129]]], dtype=uint8)]"
Image_224.jpg,1065,164,2478,2565,4608,3072,3543,2729,2565,daskShared_local/images/Image_224.jpg,224,"[array([[[ 31,  32,  31],
        [ 32,  33,  30],
        [ 30,  30,  27],
        ...,
        [117, 122, 115],
        [121, 126, 119],
        [132, 136, 126]],

       [[ 30,  31,  31],
        [ 33,  35,  32],
        [ 41,  42,  42],
        ...,
        [119, 122, 115],
        [113, 118, 112],
        [118, 124, 117]],

       [[ 32,  33,  33],
        [ 47,  50,  51],
        [ 77,  79,  82],
        ...,
        [124, 127, 119],
        [113, 117, 110],
        [110, 116, 110]],

       ...,

       [[104,  87,  63],
        [103,  87,  63],
        [105,  88,  62],
        ...,
        [164, 145,  99],
        [144, 122,  81],
        [129, 113,  80]],

       [[101,  84,  58],
        [101,  84,  58],
        [100,  85,  60],
        ...,
        [172, 153,  98],
        [169, 135,  66],
        [154, 116,  58]],

       [[ 99,  82,  50],
        [ 99,  82,  54],
        [ 99,  82,  56],
        ...,
        [167, 156, 116],
        [170, 155,  93],
        [171, 150,  74]]], dtype=uint8)]"
Image_225.jpg,618,226,137,99,1000,667,755,325,137,daskShared_local/images/Image_225.jpg,225,"[array([[[ 69, 140, 140],
        [ 73, 143, 143],
        [ 78, 147, 146],
        ...,
        [ 44, 118, 133],
        [ 53, 125, 140],
        [ 58, 128, 144]],

       [[ 70, 141, 143],
        [ 74, 143, 145],
        [ 78, 147, 147],
        ...,
        [ 33, 113, 126],
        [ 43, 121, 134],
        [ 48, 125, 139]],

       [[ 73, 141, 146],
        [ 75, 143, 147],
        [ 79, 146, 149],
        ...,
        [ 16, 103, 113],
        [ 26, 112, 122],
        [ 32, 116, 127]],

       ...,

       [[185, 190, 167],
        [187, 192, 168],
        [182, 187, 161],
        ...,
        [ 86, 167, 171],
        [ 88, 168, 172],
        [ 89, 169, 174]],

       [[174, 179, 155],
        [183, 188, 163],
        [191, 196, 170],
        ...,
        [ 86, 166, 170],
        [ 88, 167, 171],
        [ 89, 168, 173]],

       [[165, 170, 145],
        [176, 181, 156],
        [190, 194, 169],
        ...,
        [ 85, 164, 168],
        [ 87, 166, 170],
        [ 89, 168, 172]]], dtype=uint8)]"
Image_226.jpg,222,211,131,162,800,600,353,373,162,daskShared_local/images/Image_226.jpg,226,"[array([[[ 69, 188, 210],
        [ 70, 188, 209],
        [ 71, 188, 209],
        ...,
        [ 13, 164, 191],
        [ 14, 164, 192],
        [ 16, 165, 195]],

       [[ 68, 187, 209],
        [ 68, 187, 208],
        [ 69, 187, 209],
        ...,
        [ 15, 164, 191],
        [ 14, 164, 192],
        [ 15, 164, 195]],

       [[ 67, 187, 210],
        [ 67, 187, 209],
        [ 67, 187, 209],
        ...,
        [ 17, 164, 193],
        [ 16, 164, 194],
        [ 15, 164, 196]],

       ...,

       [[ 29, 114, 101],
        [ 28, 114,  99],
        [ 31, 114, 100],
        ...,
        [226, 192, 126],
        [230, 197, 126],
        [229, 195, 136]],

       [[ 37, 121, 108],
        [ 36, 122, 107],
        [ 36, 120, 105],
        ...,
        [229, 194, 129],
        [228, 193, 125],
        [226, 194, 133]],

       [[ 39, 124, 110],
        [ 38, 124, 109],
        [ 37, 120, 106],
        ...,
        [228, 193, 130],
        [226, 191, 126],
        [224, 194, 135]]], dtype=uint8)]"
Image_227.png,369,59,185,144,600,600,554,203,185,daskShared_local/images/Image_227.png,227,"[array([[[  1, 101, 249],
        [  1, 101, 249],
        [  2, 102, 250],
        ...,
        [  2, 120, 255],
        [  1, 119, 255],
        [  1, 119, 255]],

       [[  0, 106, 248],
        [  0, 106, 249],
        [  1, 107, 250],
        ...,
        [  0, 121, 254],
        [  1, 122, 255],
        [  1, 122, 255]],

       [[  0, 105, 247],
        [  0, 106, 248],
        [  1, 106, 249],
        ...,
        [  0, 121, 254],
        [  1, 122, 255],
        [  1, 122, 255]],

       ...,

       [[222, 198,  97],
        [230, 211, 180],
        [217, 192, 158],
        ...,
        [242, 250, 220],
        [243, 249, 221],
        [244, 251, 209]],

       [[231, 201,  62],
        [249, 223, 145],
        [247, 225, 218],
        ...,
        [242, 249, 209],
        [241, 247, 213],
        [243, 249, 201]],

       [[186, 137,  11],
        [211, 170,  32],
        [217, 215, 144],
        ...,
        [241, 251, 202],
        [243, 249, 204],
        [246, 251, 194]]], dtype=uint8)]"
Image_228.jpg,593,86,219,170,1068,601,812,256,219,daskShared_local/images/Image_228.jpg,228,"[array([[[  0,  75, 255],
        [  0,  75, 255],
        [  0,  75, 255],
        ...,
        [  0,  88, 255],
        [  0,  88, 255],
        [  0,  88, 255]],

       [[  0,  74, 255],
        [  0,  74, 255],
        [  0,  75, 255],
        ...,
        [  0,  88, 255],
        [  0,  88, 255],
        [  0,  88, 255]],

       [[  2,  72, 255],
        [  2,  72, 255],
        [  1,  71, 254],
        ...,
        [  2,  87, 255],
        [  2,  87, 255],
        [  2,  87, 255]],

       ...,

       [[139, 123, 101],
        [143, 129, 110],
        [133, 122, 108],
        ...,
        [213, 224, 219],
        [216, 223, 220],
        [218, 224, 218]],

       [[ 88,  72,  47],
        [100,  86,  65],
        [162, 151, 135],
        ...,
        [214, 224, 216],
        [216, 224, 214],
        [220, 224, 211]],

       [[199, 185, 160],
        [163, 152, 131],
        [181, 172, 156],
        ...,
        [211, 222, 210],
        [213, 221, 207],
        [218, 222, 205]]], dtype=uint8)]"
Image_229.jpg,426,154,230,172,1000,667,656,326,230,daskShared_local/images/Image_229.jpg,229,"[array([[[ 34, 176, 252],
        [ 31, 175, 251],
        [ 27, 173, 251],
        ...,
        [  0, 144, 225],
        [  0, 143, 224],
        [  0, 142, 224]],

       [[ 32, 175, 252],
        [ 32, 176, 252],
        [ 30, 174, 251],
        ...,
        [  0, 143, 224],
        [  1, 144, 223],
        [  1, 142, 221]],

       [[ 26, 173, 251],
        [ 29, 174, 252],
        [ 28, 174, 251],
        ...,
        [  0, 142, 223],
        [  0, 142, 222],
        [  1, 142, 222]],

       ...,

       [[186, 171, 121],
        [173, 152, 102],
        [169, 148,  98],
        ...,
        [  0,  62, 105],
        [  0,  62, 105],
        [  0,  63, 106]],

       [[169, 150,  99],
        [150, 126,  79],
        [136, 110,  68],
        ...,
        [  0,  62, 105],
        [  0,  62, 106],
        [  0,  63, 106]],

       [[154, 130,  82],
        [137, 109,  69],
        [129, 100,  62],
        ...,
        [  0,  62, 105],
        [  0,  61, 105],
        [  0,  63, 106]]], dtype=uint8)]"
Image_23.jpg,730,441,450,345,2119,1414,1180,786,450,daskShared_local/images/Image_23.jpg,23,"[array([[[ 91, 146, 177],
        [ 94, 149, 180],
        [ 92, 148, 179],
        ...,
        [ 75, 142, 171],
        [ 76, 143, 172],
        [ 81, 148, 177]],

       [[ 90, 144, 175],
        [ 90, 145, 176],
        [ 92, 147, 178],
        ...,
        [ 75, 142, 171],
        [ 75, 142, 171],
        [ 76, 143, 172]],

       [[ 89, 143, 175],
        [ 90, 145, 176],
        [ 93, 148, 179],
        ...,
        [ 76, 143, 172],
        [ 75, 142, 171],
        [ 74, 141, 170]],

       ...,

       [[ 82, 176, 201],
        [ 82, 176, 201],
        [ 82, 176, 201],
        ...,
        [151, 125, 107],
        [167, 142, 116],
        [168, 144, 109]],

       [[ 81, 175, 200],
        [ 83, 177, 202],
        [ 84, 178, 203],
        ...,
        [151, 130,  95],
        [160, 140,  97],
        [156, 139,  92]],

       [[ 81, 175, 200],
        [ 82, 176, 201],
        [ 83, 177, 202],
        ...,
        [145, 134,  92],
        [158, 147,  99],
        [157, 149, 104]]], dtype=uint8)]"
Image_230.jpg,432,149,666,614,1152,763,1098,763,666,daskShared_local/images/Image_230.jpg,230,"[array([[[  0, 184, 238],
        [  0, 184, 238],
        [  0, 183, 237],
        ...,
        [  1, 179, 235],
        [  1, 180, 236],
        [  0, 179, 235]],

       [[  0, 184, 238],
        [  0, 184, 238],
        [  0, 183, 237],
        ...,
        [  1, 180, 236],
        [  1, 180, 236],
        [  0, 179, 235]],

       [[  0, 184, 238],
        [  0, 184, 238],
        [  0, 183, 237],
        ...,
        [  2, 181, 237],
        [  1, 180, 236],
        [  0, 179, 235]],

       ...,

       [[157, 182, 159],
        [156, 181, 159],
        [155, 181, 158],
        ...,
        [176, 195, 188],
        [192, 203, 181],
        [188, 205, 192]],

       [[157, 182, 159],
        [154, 180, 155],
        [153, 179, 153],
        ...,
        [192, 201, 181],
        [198, 211, 201],
        [174, 197, 188]],

       [[158, 182, 159],
        [155, 180, 154],
        [152, 178, 151],
        ...,
        [200, 212, 201],
        [178, 200, 194],
        [164, 188, 169]]], dtype=uint8)]"
Image_231.jpg,542,237,155,195,990,681,697,432,195,daskShared_local/images/Image_231.jpg,231,"[array([[[ 32,  26,  14],
        [ 34,  28,  16],
        [ 35,  29,  15],
        ...,
        [ 51,  37,  10],
        [ 56,  41,  12],
        [ 62,  42,  15]],

       [[ 32,  26,  14],
        [ 34,  28,  16],
        [ 35,  29,  15],
        ...,
        [ 60,  46,  17],
        [ 64,  49,  20],
        [ 67,  48,  18]],

       [[ 33,  27,  15],
        [ 35,  29,  17],
        [ 36,  30,  16],
        ...,
        [ 65,  51,  22],
        [ 68,  53,  22],
        [ 69,  50,  20]],

       ...,

       [[167, 151, 115],
        [174, 156, 116],
        [172, 154, 108],
        ...,
        [ 53,  61,  40],
        [ 53,  61,  40],
        [ 54,  62,  39]],

       [[168, 149, 109],
        [180, 159, 116],
        [186, 164, 118],
        ...,
        [ 56,  64,  43],
        [ 56,  64,  43],
        [ 57,  65,  42]],

       [[180, 158, 119],
        [181, 158, 114],
        [176, 152, 104],
        ...,
        [ 55,  63,  42],
        [ 54,  62,  41],
        [ 55,  63,  40]]], dtype=uint8)]"
Image_232.jpg,498,165,97,74,660,438,595,239,97,daskShared_local/images/Image_232.jpg,232,"[array([[[ 19,  40,  80],
        [ 19,  40,  79],
        [ 26,  45,  85],
        ...,
        [  1,   9,  53],
        [  2,  13,  55],
        [  2,  13,  55]],

       [[ 20,  40,  80],
        [ 19,  40,  80],
        [ 26,  46,  86],
        ...,
        [  1,   9,  53],
        [  1,  13,  55],
        [  1,  13,  55]],

       [[ 10,  29,  70],
        [  9,  29,  70],
        [ 17,  36,  77],
        ...,
        [  2,  12,  56],
        [  4,  18,  61],
        [  4,  18,  61]],

       ...,

       [[205, 138,  89],
        [203, 135,  87],
        [232, 187, 130],
        ...,
        [ 39,  32,  54],
        [ 41,  33,  55],
        [ 41,  33,  55]],

       [[205, 127,  88],
        [204, 126,  86],
        [225, 169, 118],
        ...,
        [ 39,  31,  49],
        [ 43,  33,  53],
        [ 43,  33,  53]],

       [[205, 128,  88],
        [204, 126,  86],
        [225, 170, 118],
        ...,
        [ 39,  31,  49],
        [ 43,  33,  53],
        [ 43,  33,  53]]], dtype=uint8)]"
Image_233.jpg,382,164,110,102,900,600,492,266,110,daskShared_local/images/Image_233.jpg,233,"[array([[[ 65, 123, 184],
        [ 64, 123, 185],
        [ 60, 124, 187],
        ...,
        [153, 154, 149],
        [156, 157, 152],
        [157, 157, 152]],

       [[ 62, 122, 185],
        [ 62, 123, 185],
        [ 58, 124, 187],
        ...,
        [155, 155, 150],
        [158, 157, 152],
        [158, 158, 153]],

       [[ 50, 121, 186],
        [ 50, 122, 186],
        [ 47, 124, 187],
        ...,
        [162, 159, 154],
        [164, 161, 156],
        [164, 162, 157]],

       ...,

       [[102,  40,  28],
        [102,  41,  29],
        [103,  45,  34],
        ...,
        [126,  84, 111],
        [122,  83, 109],
        [121,  83, 108]],

       [[ 98,  36,  23],
        [ 98,  37,  24],
        [ 98,  39,  30],
        ...,
        [120,  81, 107],
        [116,  79, 105],
        [115,  79, 104]],

       [[ 97,  35,  22],
        [ 97,  36,  23],
        [ 97,  38,  29],
        ...,
        [119,  81, 106],
        [115,  79, 104],
        [114,  78, 103]]], dtype=uint8)]"
Image_234.jpg,424,131,106,90,759,422,530,221,106,daskShared_local/images/Image_234.jpg,234,"[array([[[ 29, 119, 121],
        [ 31, 120, 122],
        [ 38, 127, 129],
        ...,
        [  0, 136, 149],
        [  0, 135, 148],
        [  0, 134, 148]],

       [[ 30, 120, 122],
        [ 31, 121, 123],
        [ 40, 129, 131],
        ...,
        [  0, 136, 149],
        [  0, 134, 148],
        [  0, 134, 147]],

       [[ 36, 126, 129],
        [ 38, 128, 131],
        [ 53, 142, 146],
        ...,
        [  0, 134, 146],
        [  0, 133, 145],
        [  0, 133, 145]],

       ...,

       [[  1, 162, 190],
        [  1, 162, 190],
        [  1, 161, 190],
        ...,
        [  0, 144, 173],
        [  0, 144, 173],
        [  0, 144, 173]],

       [[  1, 159, 188],
        [  1, 159, 188],
        [  0, 159, 188],
        ...,
        [  0, 143, 172],
        [  0, 143, 172],
        [  0, 143, 172]],

       [[  0, 159, 187],
        [  0, 159, 187],
        [  0, 159, 188],
        ...,
        [  0, 142, 172],
        [  0, 142, 172],
        [  0, 142, 172]]], dtype=uint8)]"
Image_235.jpg,479,160,229,270,981,650,708,430,270,daskShared_local/images/Image_235.jpg,235,"[array([[[244, 244, 244],
        [244, 244, 244],
        [244, 244, 244],
        ...,
        [242, 242, 242],
        [242, 242, 242],
        [242, 242, 242]],

       [[244, 244, 244],
        [244, 244, 244],
        [244, 244, 244],
        ...,
        [242, 242, 242],
        [242, 242, 242],
        [242, 242, 242]],

       [[244, 244, 244],
        [244, 244, 244],
        [244, 244, 244],
        ...,
        [242, 242, 242],
        [242, 242, 242],
        [242, 242, 242]],

       ...,

       [[ 27,  94, 173],
        [ 28,  95, 176],
        [ 27,  94, 173],
        ...,
        [ 23,  92, 170],
        [ 21,  90, 167],
        [ 22,  89, 168]],

       [[ 26,  93, 172],
        [ 28,  95, 174],
        [ 28,  95, 174],
        ...,
        [ 22,  90, 170],
        [ 21,  90, 169],
        [ 22,  89, 168]],

       [[ 25,  92, 171],
        [ 27,  94, 173],
        [ 29,  96, 175],
        ...,
        [ 22,  90, 171],
        [ 23,  91, 172],
        [ 22,  89, 169]]], dtype=uint8)]"
Image_236.jpg,402,308,242,219,1500,1000,644,527,242,daskShared_local/images/Image_236.jpg,236,"[array([[[  0, 131, 154],
        [  0, 128, 151],
        [  0, 128, 152],
        ...,
        [  5, 112, 132],
        [  2, 110, 130],
        [  7, 114, 134]],

       [[  0, 133, 155],
        [  0, 131, 153],
        [  0, 131, 153],
        ...,
        [  3, 116, 134],
        [  7, 120, 138],
        [ 11, 124, 142]],

       [[  0, 139, 159],
        [  0, 138, 158],
        [  0, 136, 157],
        ...,
        [  5, 124, 139],
        [  8, 127, 142],
        [  8, 128, 143]],

       ...,

       [[ 82, 121, 102],
        [ 89, 130, 113],
        [ 90, 131, 116],
        ...,
        [143, 140,  85],
        [126, 125,  70],
        [179, 179, 124]],

       [[ 89, 127, 108],
        [ 89, 129, 111],
        [ 90, 131, 116],
        ...,
        [107, 105,  49],
        [104, 102,  46],
        [128, 128,  71]],

       [[ 95, 129, 112],
        [ 96, 133, 117],
        [ 96, 136, 120],
        ...,
        [ 98,  96,  37],
        [ 83,  82,  23],
        [ 69,  69,  10]]], dtype=uint8)]"
Image_237.jpg,1293,636,179,163,2304,1536,1472,799,179,daskShared_local/images/Image_237.jpg,237,"[array([[[ 37, 157, 208],
        [ 24, 144, 196],
        [ 12, 132, 183],
        ...,
        [  0, 111, 145],
        [  0, 111, 145],
        [  0, 111, 145]],

       [[ 15, 131, 179],
        [  8, 124, 171],
        [  4, 120, 167],
        ...,
        [  0, 113, 147],
        [  0, 114, 148],
        [  0, 114, 148]],

       [[  3, 117, 159],
        [  1, 115, 157],
        [  1, 117, 158],
        ...,
        [  1, 115, 149],
        [  2, 116, 150],
        [  3, 117, 151]],

       ...,

       [[ 52,  99, 120],
        [ 55, 104, 123],
        [ 75, 127, 142],
        ...,
        [ 30,  30,  60],
        [ 32,  28,  46],
        [ 32,  25,  35]],

       [[ 48,  99, 126],
        [ 55, 107, 129],
        [ 65, 118, 136],
        ...,
        [ 31,  37,  59],
        [ 36,  31,  50],
        [ 35,  19,  36]],

       [[ 55, 108, 134],
        [ 69, 123, 144],
        [ 77, 134, 146],
        ...,
        [ 33,  41,  63],
        [ 41,  36,  56],
        [ 41,  23,  40]]], dtype=uint8)]"
Image_238.jpg,188,103,336,275,1024,670,524,378,336,daskShared_local/images/Image_238.jpg,238,"[array([[[ 14,  28,  35],
        [ 23,  35,  43],
        [ 26,  36,  51],
        ...,
        [ 69, 164, 167],
        [ 60, 172, 191],
        [ 60, 195, 226]],

       [[ 13,  23,  32],
        [ 21,  28,  39],
        [ 28,  35,  52],
        ...,
        [ 19, 109,  92],
        [ 34, 146, 138],
        [ 87, 217, 219]],

       [[ 26,  31,  46],
        [ 31,  33,  50],
        [ 32,  38,  57],
        ...,
        [ 42, 137,  94],
        [  5,  88,  56],
        [ 61, 128, 113]],

       ...,

       [[  4,  14,  28],
        [  8,  17,  37],
        [ 24,  31,  42],
        ...,
        [ 72, 160, 170],
        [ 69, 133, 147],
        [ 36,  99, 107]],

       [[  2,  11,  13],
        [ 10,   7,  19],
        [ 19,  16,  27],
        ...,
        [ 31, 106, 112],
        [ 45,  99, 109],
        [ 51, 109, 112]],

       [[  6,  39,  26],
        [  4,   5,   4],
        [  4,   2,  13],
        ...,
        [ 33, 113, 109],
        [ 40, 105, 106],
        [ 54, 128, 125]]], dtype=uint8)]"
Image_239.jpg,252,217,128,120,775,518,380,337,128,daskShared_local/images/Image_239.jpg,239,"[array([[[171, 145, 129],
        [166, 140, 124],
        [159, 132, 114],
        ...,
        [115,  89,  54],
        [126,  99,  66],
        [132, 105,  74]],

       [[176, 150, 135],
        [176, 150, 134],
        [176, 149, 132],
        ...,
        [119,  93,  56],
        [128, 102,  68],
        [133, 107,  75]],

       [[189, 163, 148],
        [197, 170, 155],
        [207, 180, 163],
        ...,
        [121,  96,  58],
        [128, 102,  68],
        [132, 106,  72]],

       ...,

       [[182, 156, 107],
        [183, 156, 108],
        [185, 157, 110],
        ...,
        [173, 138, 100],
        [184, 149, 111],
        [191, 156, 118]],

       [[177, 151, 102],
        [173, 146,  98],
        [168, 139,  93],
        ...,
        [186, 151, 113],
        [197, 162, 125],
        [203, 167, 130]],

       [[175, 149, 100],
        [169, 142,  94],
        [159, 131,  84],
        ...,
        [192, 158, 120],
        [204, 169, 131],
        [208, 173, 136]]], dtype=uint8)]"
Image_24.jpg,704,663,405,276,2793,2090,1109,939,405,daskShared_local/images/Image_24.jpg,24,"[array([[[  4,  68, 191],
        [  4,  68, 191],
        [  4,  68, 191],
        ...,
        [  4,  67, 186],
        [  6,  66, 186],
        [  6,  66, 186]],

       [[  3,  67, 190],
        [  3,  67, 190],
        [  3,  67, 190],
        ...,
        [  4,  67, 186],
        [  6,  66, 186],
        [  6,  66, 186]],

       [[  3,  67, 190],
        [  3,  67, 190],
        [  3,  67, 190],
        ...,
        [  4,  67, 186],
        [  6,  66, 186],
        [  6,  66, 186]],

       ...,

       [[  1,  48, 152],
        [  3,  50, 154],
        [  4,  51, 155],
        ...,
        [113, 139, 115],
        [135, 162, 141],
        [122, 149, 129]],

       [[  3,  50, 154],
        [  3,  50, 154],
        [  3,  50, 154],
        ...,
        [ 54,  84,  64],
        [ 89, 119, 103],
        [111, 141, 124]],

       [[  3,  50, 154],
        [  3,  50, 154],
        [  3,  50, 154],
        ...,
        [ 33,  66,  50],
        [ 47,  77,  66],
        [104, 134, 122]]], dtype=uint8)]"
Image_240.jpg,310,311,137,124,966,642,447,435,137,daskShared_local/images/Image_240.jpg,240,"[array([[[ 15, 201, 212],
        [ 16, 203, 214],
        [ 20, 206, 217],
        ...,
        [ 75,  61,  23],
        [ 76,  59,  22],
        [ 77,  59,  23]],

       [[ 16, 201, 211],
        [ 17, 203, 212],
        [ 20, 205, 214],
        ...,
        [ 72,  57,  26],
        [ 59,  47,  16],
        [ 55,  43,  14]],

       [[ 19, 201, 209],
        [ 19, 201, 209],
        [ 21, 202, 210],
        ...,
        [ 73,  64,  43],
        [ 47,  43,  22],
        [ 33,  32,  12]],

       ...,

       [[ 22, 191, 204],
        [ 22, 191, 203],
        [ 20, 193, 204],
        ...,
        [ 47, 214, 222],
        [ 47, 216, 225],
        [ 48, 217, 226]],

       [[ 23, 193, 204],
        [ 23, 192, 204],
        [ 20, 193, 204],
        ...,
        [ 53, 217, 226],
        [ 53, 219, 229],
        [ 53, 219, 230]],

       [[ 24, 194, 205],
        [ 23, 194, 204],
        [ 20, 194, 204],
        ...,
        [ 58, 220, 229],
        [ 57, 222, 231],
        [ 57, 221, 231]]], dtype=uint8)]"
Image_241.jpg,728,344,181,132,1600,1000,909,476,181,daskShared_local/images/Image_241.jpg,241,"[array([[[  2,  83, 165],
        [  2,  83, 165],
        [  2,  83, 165],
        ...,
        [  0,  81, 163],
        [  0,  81, 163],
        [  0,  81, 163]],

       [[  2,  83, 165],
        [  2,  83, 165],
        [  2,  83, 165],
        ...,
        [  0,  81, 163],
        [  0,  81, 163],
        [  0,  81, 163]],

       [[  2,  83, 165],
        [  2,  83, 165],
        [  2,  83, 165],
        ...,
        [  0,  81, 163],
        [  0,  81, 163],
        [  0,  81, 163]],

       ...,

       [[  0,  64, 136],
        [  1,  70, 138],
        [  0,  70, 134],
        ...,
        [232, 213, 195],
        [196, 177, 161],
        [157, 137, 121]],

       [[  0,  64, 130],
        [  0,  68, 129],
        [  0,  73, 128],
        ...,
        [227, 208, 192],
        [210, 192, 178],
        [177, 159, 145]],

       [[  0,  63, 122],
        [  0,  67, 120],
        [  0,  76, 122],
        ...,
        [211, 190, 177],
        [181, 163, 151],
        [174, 157, 147]]], dtype=uint8)]"
Image_242.jpg,411,329,130,126,800,600,541,455,130,daskShared_local/images/Image_242.jpg,242,"[array([[[185, 190, 173],
        [190, 197, 178],
        [197, 206, 183],
        ...,
        [  3,  91, 101],
        [  3,  91, 101],
        [  3,  90, 100]],

       [[188, 190, 171],
        [194, 198, 177],
        [203, 210, 186],
        ...,
        [  4,  91, 101],
        [  4,  91, 101],
        [  4,  91, 101]],

       [[192, 191, 167],
        [201, 201, 177],
        [215, 216, 191],
        ...,
        [  4,  90, 101],
        [  4,  91, 101],
        [  5,  92, 102]],

       ...,

       [[ 29,  55,  52],
        [ 29,  55,  52],
        [ 30,  56,  53],
        ...,
        [ 41, 132,  85],
        [ 37, 129,  80],
        [ 34, 126,  77]],

       [[ 30,  56,  53],
        [ 31,  57,  54],
        [ 31,  58,  56],
        ...,
        [ 34, 115,  75],
        [ 35, 117,  76],
        [ 36, 118,  77]],

       [[ 31,  57,  54],
        [ 32,  58,  56],
        [ 33,  59,  58],
        ...,
        [ 28, 104,  67],
        [ 34, 109,  72],
        [ 38, 114,  76]]], dtype=uint8)]"
Image_243.jpg,695,306,498,473,1920,1080,1193,779,498,daskShared_local/images/Image_243.jpg,243,"[array([[[ 43,  62,  55],
        [ 44,  60,  49],
        [ 47,  65,  52],
        ...,
        [ 57,  79,  78],
        [ 44,  69,  71],
        [ 37,  61,  64]],

       [[ 44,  60,  57],
        [ 46,  62,  51],
        [ 47,  68,  54],
        ...,
        [ 54,  74,  73],
        [ 55,  78,  78],
        [ 47,  74,  75]],

       [[ 45,  62,  58],
        [ 46,  64,  54],
        [ 46,  69,  56],
        ...,
        [ 52,  74,  72],
        [ 52,  78,  77],
        [ 37,  74,  72]],

       ...,

       [[ 28,  96, 145],
        [ 28,  96, 146],
        [ 28,  94, 147],
        ...,
        [ 18,  35,  35],
        [ 21,  37,  36],
        [ 20,  33,  33]],

       [[ 30,  96, 146],
        [ 30,  97, 147],
        [ 29,  95, 147],
        ...,
        [ 15,  33,  32],
        [ 18,  35,  34],
        [ 19,  34,  33]],

       [[ 29,  95, 145],
        [ 29,  97, 146],
        [ 30,  96, 148],
        ...,
        [ 18,  36,  35],
        [ 20,  38,  36],
        [ 22,  38,  36]]], dtype=uint8)]"
Image_244.jpg,165,175,163,134,728,500,328,309,163,daskShared_local/images/Image_244.jpg,244,"[array([[[  1,  68, 217],
        [  2,  67, 218],
        [  1,  67, 218],
        ...,
        [  1,  79, 227],
        [  2,  80, 227],
        [  1,  80, 225]],

       [[  1,  68, 217],
        [  1,  68, 217],
        [  2,  68, 218],
        ...,
        [  1,  80, 226],
        [  2,  81, 226],
        [  1,  80, 225]],

       [[  0,  68, 216],
        [  0,  68, 216],
        [  1,  69, 217],
        ...,
        [  1,  80, 225],
        [  2,  81, 226],
        [  1,  80, 225]],

       ...,

       [[  8, 122, 143],
        [  8, 123, 143],
        [  9, 122, 141],
        ...,
        [248, 238, 196],
        [250, 243, 205],
        [253, 246, 211]],

       [[ 10, 124, 145],
        [  8, 124, 143],
        [  8, 124, 140],
        ...,
        [246, 236, 197],
        [247, 241, 205],
        [249, 241, 209]],

       [[ 13, 129, 149],
        [ 12, 129, 147],
        [ 13, 126, 142],
        ...,
        [245, 232, 194],
        [245, 233, 195],
        [244, 229, 193]]], dtype=uint8)]"
Image_245.jpg,811,334,150,121,1536,1024,961,455,150,daskShared_local/images/Image_245.jpg,245,"[array([[[ 43, 125, 211],
        [ 44, 125, 212],
        [ 45, 125, 212],
        ...,
        [ 45, 123, 213],
        [ 47, 123, 213],
        [ 49, 124, 213]],

       [[ 43, 124, 210],
        [ 44, 124, 211],
        [ 45, 125, 212],
        ...,
        [ 45, 123, 213],
        [ 47, 124, 213],
        [ 49, 124, 213]],

       [[ 42, 123, 210],
        [ 43, 123, 210],
        [ 44, 124, 211],
        ...,
        [ 45, 123, 213],
        [ 47, 124, 213],
        [ 48, 124, 213]],

       ...,

       [[ 18, 117, 203],
        [ 15, 116, 202],
        [ 14, 114, 202],
        ...,
        [ 14, 116, 206],
        [ 10, 116, 205],
        [  5, 115, 204]],

       [[ 17, 117, 204],
        [ 16, 116, 203],
        [ 14, 115, 202],
        ...,
        [ 12, 115, 205],
        [  9, 115, 205],
        [  8, 116, 204]],

       [[ 17, 117, 203],
        [ 16, 116, 202],
        [ 15, 116, 202],
        ...,
        [  9, 113, 203],
        [  9, 114, 204],
        [ 10, 116, 205]]], dtype=uint8)]"
Image_246.jpg,1842,2562,461,417,2720,4080,2303,2979,461,daskShared_local/images/Image_246.jpg,246,"[array([[[ 13, 119, 153],
        [  4, 132, 179],
        [  9, 137, 194],
        ...,
        [  6, 122, 196],
        [  3, 119, 193],
        [  3, 119, 193]],

       [[  9, 108, 139],
        [ 11, 132, 179],
        [  5, 130, 186],
        ...,
        [  8, 124, 197],
        [  3, 120, 194],
        [  3, 121, 194]],

       [[  5,  82, 112],
        [ 14, 113, 163],
        [  5, 129, 186],
        ...,
        [  5, 120, 193],
        [  6, 124, 196],
        [  2, 121, 192]],

       ...,

       [[  5, 117, 191],
        [  3, 112, 186],
        [  3, 111, 185],
        ...,
        [  1, 109, 185],
        [  5, 117, 193],
        [  3, 115, 191]],

       [[  3, 115, 189],
        [  2, 112, 186],
        [  6, 118, 192],
        ...,
        [  3, 111, 187],
        [  2, 111, 187],
        [  4, 115, 191]],

       [[  6, 118, 192],
        [  1, 111, 185],
        [  4, 114, 188],
        ...,
        [  5, 115, 191],
        [  4, 116, 192],
        [  1, 112, 188]]], dtype=uint8)]"
Image_247.jpg,80,87,115,129,637,450,195,216,129,daskShared_local/images/Image_247.jpg,247,"[array([[[  1, 172, 254],
        [  1, 172, 254],
        [  1, 172, 254],
        ...,
        [  0, 169, 254],
        [  1, 168, 254],
        [  1, 168, 254]],

       [[  1, 171, 254],
        [  1, 171, 254],
        [  1, 171, 254],
        ...,
        [  1, 168, 254],
        [  1, 167, 254],
        [  1, 167, 254]],

       [[  1, 170, 253],
        [  1, 170, 253],
        [  1, 170, 253],
        ...,
        [  1, 167, 253],
        [  0, 166, 254],
        [  0, 165, 254]],

       ...,

       [[  5, 154, 251],
        [  5, 156, 251],
        [  5, 159, 252],
        ...,
        [ 59, 117,  99],
        [ 58, 115,  96],
        [ 58, 114,  95]],

       [[  3, 152, 249],
        [  3, 154, 250],
        [  3, 158, 251],
        ...,
        [ 42, 109,  93],
        [ 46, 112,  95],
        [ 48, 114,  96]],

       [[  2, 152, 249],
        [  2, 154, 249],
        [  3, 158, 251],
        ...,
        [ 33, 105,  90],
        [ 40, 111,  94],
        [ 44, 114,  97]]], dtype=uint8)]"
Image_248.jpg,284,126,101,125,775,518,385,251,125,daskShared_local/images/Image_248.jpg,248,"[array([[[ 92, 163, 181],
        [ 91, 162, 180],
        [ 89, 160, 178],
        ...,
        [ 82, 151, 167],
        [ 85, 154, 170],
        [ 86, 155, 171]],

       [[ 89, 160, 178],
        [ 88, 159, 177],
        [ 87, 158, 176],
        ...,
        [ 85, 154, 170],
        [ 86, 155, 170],
        [ 86, 155, 171]],

       [[ 82, 154, 172],
        [ 82, 154, 172],
        [ 82, 154, 172],
        ...,
        [ 92, 161, 176],
        [ 88, 157, 172],
        [ 86, 155, 170]],

       ...,

       [[168, 125, 101],
        [174, 131, 107],
        [185, 142, 118],
        ...,
        [138, 111,  89],
        [ 78,  54,  47],
        [ 50,  27,  25]],

       [[151, 109,  84],
        [155, 113,  88],
        [164, 122,  97],
        ...,
        [148, 120,  98],
        [ 93,  68,  58],
        [ 65,  41,  37]],

       [[143, 101,  76],
        [146, 104,  79],
        [155, 113,  88],
        ...,
        [152, 124, 101],
        [100,  74,  64],
        [ 73,  48,  43]]], dtype=uint8)]"
Image_249.jpg,635,316,139,132,1440,960,774,448,139,daskShared_local/images/Image_249.jpg,249,"[array([[[  1, 141, 202],
        [  1, 141, 202],
        [  1, 141, 202],
        ...,
        [  2, 145, 213],
        [  2, 145, 213],
        [  2, 145, 213]],

       [[  0, 140, 201],
        [  0, 140, 201],
        [  0, 141, 202],
        ...,
        [  2, 145, 213],
        [  3, 146, 214],
        [  3, 146, 214]],

       [[  0, 139, 201],
        [  0, 139, 201],
        [  0, 140, 201],
        ...,
        [  3, 146, 214],
        [  3, 146, 214],
        [  3, 146, 214]],

       ...,

       [[138, 124,  88],
        [135, 121,  85],
        [133, 120,  84],
        ...,
        [  1,  76, 115],
        [  2,  77, 116],
        [  2,  78, 117]],

       [[149, 136, 101],
        [147, 134, 100],
        [144, 132,  98],
        ...,
        [  3,  77, 116],
        [  3,  77, 116],
        [  2,  77, 116]],

       [[145, 132,  97],
        [146, 133,  99],
        [149, 136, 102],
        ...,
        [  4,  78, 117],
        [  3,  77, 116],
        [  2,  77, 116]]], dtype=uint8)]"
Image_25.png,378,189,323,275,900,600,701,464,323,daskShared_local/images/Image_25.png,25,"[array([[[108, 108, 100],
        [110, 110, 103],
        [124, 119, 117],
        ...,
        [ 24, 151, 184],
        [ 14, 152, 182],
        [ 17, 150, 181]],

       [[124, 108,  93],
        [128, 110, 102],
        [133, 115,  97],
        ...,
        [ 31, 150, 181],
        [ 20, 147, 183],
        [ 21, 149, 183]],

       [[103,  86,  89],
        [102,  89,  91],
        [101,  90,  79],
        ...,
        [ 24, 149, 178],
        [ 18, 152, 182],
        [ 24, 149, 179]],

       ...,

       [[ 28,  72,  65],
        [ 26,  70,  63],
        [ 24,  67,  61],
        ...,
        [ 84, 146, 144],
        [ 91, 151, 145],
        [ 92, 154, 148]],

       [[ 26,  69,  66],
        [ 20,  66,  67],
        [ 26,  66,  62],
        ...,
        [ 89, 148, 147],
        [ 96, 145, 144],
        [ 93, 148, 145]],

       [[ 22,  71,  67],
        [ 22,  65,  65],
        [ 24,  67,  66],
        ...,
        [ 92, 152, 147],
        [ 93, 157, 151],
        [ 97, 155, 150]]], dtype=uint8)]"
Image_250.jpg,453,146,136,124,1024,512,589,270,136,daskShared_local/images/Image_250.jpg,250,"[array([[[  3, 138, 194],
        [  2, 137, 193],
        [  2, 137, 193],
        ...,
        [  0, 165, 209],
        [  0, 165, 209],
        [  0, 166, 210]],

       [[  3, 138, 194],
        [  2, 137, 193],
        [  2, 137, 193],
        ...,
        [  0, 165, 209],
        [  0, 165, 209],
        [  0, 165, 209]],

       [[  3, 138, 194],
        [  2, 137, 193],
        [  2, 137, 193],
        ...,
        [  0, 164, 208],
        [  0, 164, 208],
        [  0, 164, 208]],

       ...,

       [[120, 112,  81],
        [111, 104,  75],
        [ 97,  93,  66],
        ...,
        [  1, 145, 198],
        [  1, 145, 198],
        [  1, 145, 198]],

       [[168, 160, 129],
        [151, 144, 114],
        [119, 115,  87],
        ...,
        [  1, 145, 198],
        [  1, 145, 198],
        [  1, 145, 198]],

       [[207, 199, 168],
        [183, 176, 146],
        [135, 130, 102],
        ...,
        [  1, 145, 198],
        [  1, 145, 198],
        [  1, 145, 198]]], dtype=uint8)]"
Image_251.jpg,106,78,89,63,475,264,195,141,89,daskShared_local/images/Image_251.jpg,251,"[array([[[26, 40, 57],
        [26, 40, 57],
        [27, 40, 58],
        ...,
        [20, 38, 61],
        [20, 37, 61],
        [20, 37, 61]],

       [[27, 40, 58],
        [27, 40, 57],
        [28, 41, 59],
        ...,
        [21, 38, 61],
        [20, 37, 61],
        [20, 38, 61]],

       [[23, 37, 54],
        [23, 37, 54],
        [25, 38, 55],
        ...,
        [20, 37, 60],
        [19, 35, 60],
        [19, 36, 60]],

       ...,

       [[10, 19, 27],
        [10, 19, 26],
        [12, 21, 29],
        ...,
        [55, 72, 71],
        [54, 70, 70],
        [54, 71, 70]],

       [[ 9, 18, 27],
        [ 9, 18, 27],
        [11, 20, 29],
        ...,
        [67, 88, 83],
        [65, 85, 82],
        [66, 85, 82]],

       [[10, 19, 27],
        [ 9, 18, 27],
        [11, 20, 29],
        ...,
        [64, 84, 80],
        [63, 81, 80],
        [63, 82, 80]]], dtype=uint8)]"
Image_252.jpg,573,174,185,170,1000,665,758,344,185,daskShared_local/images/Image_252.jpg,252,"[array([[[ 35, 131, 199],
        [ 48, 135, 202],
        [ 47, 133, 200],
        ...,
        [ 28, 131, 197],
        [ 29, 129, 196],
        [ 18, 129, 195]],

       [[ 44, 134, 200],
        [ 49, 136, 201],
        [ 47, 134, 200],
        ...,
        [ 22, 128, 196],
        [ 25, 129, 195],
        [ 30, 131, 196]],

       [[ 43, 135, 200],
        [ 47, 135, 199],
        [ 47, 134, 201],
        ...,
        [ 21, 128, 197],
        [ 29, 129, 197],
        [ 26, 130, 196]],

       ...,

       [[ 13,  79,  90],
        [ 12,  75,  82],
        [  6,  72,  78],
        ...,
        [ 13,  86,  95],
        [  8,  85,  97],
        [  2,  83,  94]],

       [[ 42, 101, 120],
        [  6,  70,  80],
        [ 10,  71,  79],
        ...,
        [ 19,  84,  93],
        [ 11,  83,  92],
        [  9,  82,  91]],

       [[ 26,  94, 107],
        [ 12,  77,  86],
        [  7,  68,  74],
        ...,
        [ 25,  83,  90],
        [ 12,  81,  89],
        [ 17,  84,  90]]], dtype=uint8)]"
Image_253.jpg,801,532,1199,1483,3072,2304,2000,2015,1483,daskShared_local/images/Image_253.jpg,253,"[array([[[107, 111, 104],
        [ 84,  80,  70],
        [ 72,  64,  53],
        ...,
        [135, 102, 118],
        [132, 103, 119],
        [114,  95, 108]],

       [[ 99,  98,  87],
        [ 84,  79,  66],
        [ 75,  67,  57],
        ...,
        [131, 104, 117],
        [157, 136, 143],
        [171, 153, 157]],

       [[ 93,  89,  77],
        [ 84,  78,  67],
        [ 78,  70,  62],
        ...,
        [ 92,  68,  85],
        [125, 106, 116],
        [165, 146, 152]],

       ...,

       [[  6, 112, 119],
        [  6, 113, 120],
        [  6, 113, 119],
        ...,
        [  9,  95, 111],
        [ 21, 102, 123],
        [ 36, 116, 138]],

       [[  8, 111, 122],
        [  6, 112, 122],
        [  5, 112, 121],
        ...,
        [ 13, 101, 118],
        [ 25, 110, 129],
        [ 37, 118, 139]],

       [[  8, 110, 122],
        [  6, 112, 122],
        [  5, 112, 122],
        ...,
        [ 16, 109, 122],
        [ 25, 116, 133],
        [ 33, 121, 140]]], dtype=uint8)]"
Image_254.jpg,198,344,275,188,1024,768,473,532,275,daskShared_local/images/Image_254.jpg,254,"[array([[[ 98, 159, 177],
        [ 97, 157, 172],
        [116, 175, 189],
        ...,
        [ 18,  23,  43],
        [ 37,  39,  62],
        [ 36,  36,  62]],

       [[ 94, 155, 173],
        [ 86, 147, 164],
        [ 83, 142, 158],
        ...,
        [ 30,  33,  54],
        [ 23,  24,  47],
        [ 25,  25,  50]],

       [[ 66, 118, 145],
        [ 51, 106, 133],
        [ 98, 152, 180],
        ...,
        [ 17,  22,  44],
        [ 20,  25,  47],
        [ 16,  19,  42]],

       ...,

       [[ 15,  38,  85],
        [ 57,  99, 124],
        [ 79, 137, 138],
        ...,
        [ 17,   5,   5],
        [ 19,   7,   7],
        [ 11,   2,   2]],

       [[ 53,  76, 118],
        [ 89, 131, 153],
        [ 90, 148, 148],
        ...,
        [ 10,   0,   0],
        [ 15,   3,   3],
        [ 25,  13,  13]],

       [[ 64,  88, 128],
        [ 89, 131, 153],
        [ 80, 139, 137],
        ...,
        [ 10,   0,   0],
        [ 19,   7,   7],
        [ 22,  10,  10]]], dtype=uint8)]"
Image_255.jpg,499,139,206,159,800,600,705,298,206,daskShared_local/images/Image_255.jpg,255,"[array([[[  6,  38,  63],
        [  3,  34,  57],
        [  0,  23,  51],
        ...,
        [  5,   6,  10],
        [ 11,  12,  16],
        [ 16,  23,  31]],

       [[  5,  32,  59],
        [  2,  27,  52],
        [  0,  21,  49],
        ...,
        [  9,  12,  16],
        [ 15,  19,  24],
        [ 13,  22,  29]],

       [[  2,  25,  54],
        [  0,  21,  48],
        [  0,  19,  51],
        ...,
        [ 10,  15,  21],
        [ 14,  20,  27],
        [ 10,  19,  26]],

       ...,

       [[129, 125,  97],
        [166, 159, 127],
        [191, 175, 133],
        ...,
        [ 19,  45,  61],
        [ 19,  42,  53],
        [ 39,  45,  51]],

       [[162, 152, 125],
        [169, 155, 128],
        [189, 173, 137],
        ...,
        [ 24,  45,  52],
        [ 23,  41,  51],
        [ 34,  33,  44]],

       [[175, 164, 136],
        [179, 167, 139],
        [197, 180, 146],
        ...,
        [ 29,  45,  50],
        [ 21,  34,  40],
        [ 36,  37,  39]]], dtype=uint8)]"
Image_256.jpg,109,111,436,279,800,533,545,390,436,daskShared_local/images/Image_256.jpg,256,"[array([[[  3,  11,  54],
        [  3,  11,  54],
        [  3,  10,  56],
        ...,
        [ 10,  22,  76],
        [ 12,  25,  81],
        [ 13,  25,  81]],

       [[  3,  11,  56],
        [  3,   9,  55],
        [  4,  10,  58],
        ...,
        [ 11,  21,  76],
        [  9,  21,  77],
        [ 12,  25,  80]],

       [[  4,  10,  59],
        [  3,   8,  57],
        [  4,   9,  57],
        ...,
        [  8,  21,  74],
        [  6,  22,  74],
        [  8,  23,  76]],

       ...,

       [[  8,  14,  61],
        [  8,  15,  61],
        [  6,  15,  59],
        ...,
        [196, 153, 114],
        [191, 148, 111],
        [193, 154, 125]],

       [[  5,  14,  57],
        [  7,  15,  57],
        [  7,  15,  59],
        ...,
        [185, 150, 126],
        [177, 144, 120],
        [181, 151, 132]],

       [[  5,  12,  56],
        [  3,  13,  57],
        [  5,  16,  58],
        ...,
        [132, 115, 101],
        [111,  92,  80],
        [ 99,  79,  68]]], dtype=uint8)]"
Image_257.jpg,123,392,370,288,1715,1286,493,680,370,daskShared_local/images/Image_257.jpg,257,"[array([[[155, 168, 166],
        [155, 170, 167],
        [157, 170, 167],
        ...,
        [100, 103, 131],
        [113, 120, 149],
        [111, 135, 154]],

       [[155, 170, 167],
        [155, 171, 166],
        [153, 172, 168],
        ...,
        [ 96,  89, 112],
        [105, 100, 136],
        [115, 104, 146]],

       [[154, 170, 167],
        [154, 170, 165],
        [154, 172, 167],
        ...,
        [109,  97,  97],
        [117, 101, 104],
        [139, 117, 123]],

       ...,

       [[174, 169, 170],
        [177, 171, 166],
        [178, 171, 160],
        ...,
        [184, 189, 216],
        [182, 198, 220],
        [190, 201, 219]],

       [[165, 181, 163],
        [174, 187, 161],
        [181, 191, 150],
        ...,
        [183, 185, 214],
        [186, 186, 217],
        [187, 193, 215]],

       [[167, 180, 166],
        [172, 185, 170],
        [172, 200, 156],
        ...,
        [180, 185, 208],
        [182, 187, 210],
        [186, 192, 212]]], dtype=uint8)]"
Image_258.jpg,315,293,151,97,1280,720,466,390,151,daskShared_local/images/Image_258.jpg,258,"[array([[[  1,  61, 134],
        [  1,  61, 134],
        [  1,  61, 134],
        ...,
        [  0,  62, 139],
        [  0,  62, 139],
        [  0,  62, 139]],

       [[  0,  60, 133],
        [  0,  60, 133],
        [  0,  60, 133],
        ...,
        [  0,  62, 139],
        [  0,  62, 139],
        [  0,  62, 139]],

       [[  0,  60, 133],
        [  0,  60, 133],
        [  0,  60, 133],
        ...,
        [  0,  62, 139],
        [  0,  62, 139],
        [  0,  62, 139]],

       ...,

       [[ 39, 114, 136],
        [ 39, 114, 136],
        [ 39, 114, 136],
        ...,
        [ 27,  97, 136],
        [ 29,  97, 140],
        [ 29,  98, 140]],

       [[ 40, 115, 136],
        [ 40, 115, 136],
        [ 39, 115, 137],
        ...,
        [ 28,  99, 135],
        [ 31,  99, 138],
        [ 30,  99, 137]],

       [[ 39, 116, 136],
        [ 39, 115, 137],
        [ 39, 115, 137],
        ...,
        [ 28,  98, 130],
        [ 30,  97, 130],
        [ 29,  97, 128]]], dtype=uint8)]"
Image_259.jpg,331,23,627,495,1190,595,958,518,627,daskShared_local/images/Image_259.jpg,259,"[array([[[236, 251, 253],
        [237, 254, 254],
        [236, 254, 254],
        ...,
        [206, 218, 208],
        [204, 217, 207],
        [204, 217, 208]],

       [[233, 250, 253],
        [234, 251, 253],
        [227, 246, 251],
        ...,
        [206, 219, 209],
        [205, 217, 207],
        [204, 216, 206]],

       [[220, 238, 245],
        [230, 249, 253],
        [223, 242, 249],
        ...,
        [206, 219, 211],
        [205, 217, 208],
        [205, 217, 207]],

       ...,

       [[ 55,  46,  42],
        [ 41,  27,  26],
        [ 65,  49,  46],
        ...,
        [176, 128, 114],
        [174, 125, 112],
        [178, 127, 117]],

       [[ 55,  44,  43],
        [ 47,  33,  31],
        [ 51,  38,  35],
        ...,
        [169, 115, 103],
        [167, 116,  99],
        [169, 119, 107]],

       [[ 56,  45,  43],
        [ 62,  49,  50],
        [ 51,  36,  36],
        ...,
        [161, 103,  92],
        [160, 102,  88],
        [162, 103,  93]]], dtype=uint8)]"
Image_26.jpg,310,212,197,203,1000,600,507,415,203,daskShared_local/images/Image_26.jpg,26,"[array([[[  1, 146, 193],
        [  1, 146, 193],
        [  1, 146, 193],
        ...,
        [  1, 158, 201],
        [  1, 158, 201],
        [  1, 158, 201]],

       [[  1, 146, 193],
        [  1, 146, 193],
        [  1, 146, 193],
        ...,
        [  1, 158, 201],
        [  1, 158, 201],
        [  1, 158, 201]],

       [[  1, 146, 193],
        [  1, 146, 193],
        [  1, 146, 193],
        ...,
        [  1, 158, 201],
        [  1, 158, 201],
        [  1, 158, 201]],

       ...,

       [[115,  90,  31],
        [ 55,  33,  20],
        [ 40,  21,  16],
        ...,
        [245, 222, 155],
        [245, 221, 151],
        [246, 220, 146]],

       [[ 65,  43,  29],
        [ 31,  14,  30],
        [ 35,  27,  23],
        ...,
        [244, 222, 162],
        [245, 221, 157],
        [244, 219, 152]],

       [[ 40,  24,  24],
        [ 27,  22,  28],
        [ 32,  33,  28],
        ...,
        [242, 221, 166],
        [242, 220, 162],
        [242, 218, 156]]], dtype=uint8)]"
Image_260.jpg,1620,544,836,648,4100,2660,2456,1192,836,daskShared_local/images/Image_260.jpg,260,"[array([[[192, 181, 171],
        [195, 182, 171],
        [194, 182, 169],
        ...,
        [162, 151, 134],
        [159, 147, 131],
        [158, 146, 130]],

       [[189, 177, 167],
        [194, 182, 171],
        [199, 186, 175],
        ...,
        [162, 149, 135],
        [163, 151, 134],
        [164, 153, 136]],

       [[192, 178, 168],
        [186, 174, 159],
        [196, 183, 171],
        ...,
        [165, 152, 135],
        [163, 152, 134],
        [159, 148, 130]],

       ...,

       [[ 73,  59,  45],
        [ 69,  55,  43],
        [ 65,  50,  42],
        ...,
        [216, 222, 235],
        [218, 224, 233],
        [244, 247, 250]],

       [[ 76,  62,  45],
        [ 79,  65,  50],
        [ 78,  63,  50],
        ...,
        [218, 224, 235],
        [221, 228, 238],
        [234, 237, 242]],

       [[ 83,  68,  50],
        [ 82,  66,  50],
        [ 80,  64,  49],
        ...,
        [207, 211, 236],
        [207, 212, 235],
        [208, 211, 225]]], dtype=uint8)]"
Image_261.jpg,342,124,187,201,770,422,529,325,201,daskShared_local/images/Image_261.jpg,261,"[array([[[233, 190,  88],
        [245, 195,  64],
        [241, 188,  60],
        ...,
        [ 20, 103, 197],
        [ 22, 103, 195],
        [ 23, 104, 195]],

       [[226, 187,  92],
        [218, 182,  51],
        [219, 176,  46],
        ...,
        [ 22, 107, 199],
        [ 19, 102, 194],
        [ 20, 101, 192]],

       [[182, 159,  82],
        [186, 165,  88],
        [192, 164,  83],
        ...,
        [ 27, 112, 203],
        [ 25, 109, 199],
        [ 26, 107, 198]],

       ...,

       [[ 44,  60,  31],
        [ 39,  51,  28],
        [ 25,  37,  15],
        ...,
        [  2,  20,  42],
        [  5,  23,  47],
        [  5,  25,  49]],

       [[ 24,  38,  21],
        [ 15,  26,  20],
        [  5,  14,   9],
        ...,
        [  2,  20,  42],
        [  5,  23,  47],
        [  6,  27,  48]],

       [[  6,  18,  14],
        [  4,  13,  18],
        [  0,   6,  11],
        ...,
        [  0,  18,  40],
        [  3,  21,  43],
        [  3,  24,  45]]], dtype=uint8)]"
Image_262.jpg,440,201,200,193,900,600,640,394,200,daskShared_local/images/Image_262.jpg,262,"[array([[[  0, 130, 238],
        [  0, 131, 239],
        [  1, 132, 240],
        ...,
        [  1,  90, 210],
        [  1,  90, 210],
        [  1,  90, 210]],

       [[  0, 130, 238],
        [  0, 131, 239],
        [  1, 132, 240],
        ...,
        [  1,  90, 210],
        [  1,  90, 210],
        [  0,  89, 209]],

       [[  0, 131, 239],
        [  0, 131, 239],
        [  0, 130, 238],
        ...,
        [  1,  90, 210],
        [  0,  89, 209],
        [  0,  89, 209]],

       ...,

       [[158, 136,  63],
        [205, 179, 105],
        [181, 153,  79],
        ...,
        [ 17,  61, 109],
        [  1,  49, 120],
        [  9,  61, 144]],

       [[185, 166, 106],
        [208, 184, 124],
        [173, 147,  86],
        ...,
        [  5,  51, 107],
        [  9,  62, 139],
        [  0,  54, 147]],

       [[155, 139,  87],
        [187, 167, 114],
        [181, 160, 105],
        ...,
        [  8,  53, 117],
        [  8,  62, 149],
        [  0,  51, 154]]], dtype=uint8)]"
Image_263.jpg,105,108,136,128,500,375,241,236,136,daskShared_local/images/Image_263.jpg,263,"[array([[[ 55, 122, 148],
        [ 56, 123, 149],
        [ 58, 125, 151],
        ...,
        [ 30,  78, 116],
        [ 36,  85, 117],
        [ 41,  91, 118]],

       [[ 53, 120, 146],
        [ 53, 120, 146],
        [ 54, 121, 147],
        ...,
        [ 27,  75, 112],
        [ 33,  82, 113],
        [ 38,  87, 114]],

       [[ 53, 120, 146],
        [ 53, 120, 146],
        [ 52, 119, 145],
        ...,
        [ 23,  71, 107],
        [ 28,  77, 108],
        [ 32,  82, 109]],

       ...,

       [[ 29, 127, 152],
        [ 30, 128, 153],
        [ 31, 129, 154],
        ...,
        [209, 204, 209],
        [207, 204, 207],
        [205, 204, 204]],

       [[ 27, 124, 149],
        [ 27, 124, 149],
        [ 28, 125, 150],
        ...,
        [202, 195, 197],
        [204, 199, 200],
        [204, 202, 201]],

       [[ 26, 123, 148],
        [ 26, 123, 148],
        [ 27, 123, 148],
        ...,
        [196, 187, 188],
        [200, 194, 194],
        [203, 201, 199]]], dtype=uint8)]"
Image_264.jpg,337,278,241,222,750,740,578,500,241,daskShared_local/images/Image_264.jpg,264,"[array([[[ 95, 236, 244],
        [105, 240, 249],
        [116, 241, 253],
        ...,
        [ 14, 193, 215],
        [  8, 197, 212],
        [  7, 199, 212]],

       [[ 99, 232, 243],
        [112, 236, 248],
        [124, 238, 253],
        ...,
        [ 14, 193, 215],
        [  7, 196, 211],
        [  5, 197, 210]],

       [[ 82, 227, 233],
        [ 94, 229, 237],
        [113, 235, 247],
        ...,
        [ 11, 193, 219],
        [  7, 195, 212],
        [  5, 196, 208]],

       ...,

       [[120, 183, 161],
        [121, 182, 164],
        [125, 184, 169],
        ...,
        [140, 193, 196],
        [140, 192, 197],
        [137, 189, 194]],

       [[123, 181, 153],
        [126, 182, 158],
        [129, 184, 163],
        ...,
        [139, 188, 198],
        [139, 188, 198],
        [141, 190, 199]],

       [[126, 178, 145],
        [130, 181, 151],
        [131, 181, 155],
        ...,
        [135, 182, 198],
        [135, 181, 195],
        [140, 186, 199]]], dtype=uint8)]"
Image_265.jpg,632,446,216,193,1024,672,848,639,216,daskShared_local/images/Image_265.jpg,265,"[array([[[105, 102, 109],
        [117, 115, 120],
        [127, 125, 128],
        ...,
        [103, 111,  87],
        [122, 129, 103],
        [125, 131, 105]],

       [[103, 100, 107],
        [116, 114, 119],
        [125, 123, 128],
        ...,
        [ 54,  67,  43],
        [ 63,  75,  46],
        [ 65,  77,  47]],

       [[105, 102, 110],
        [112, 109, 116],
        [116, 114, 118],
        ...,
        [ 55,  71,  51],
        [ 61,  76,  54],
        [ 66,  81,  57]],

       ...,

       [[ 30,  85, 149],
        [ 31,  86, 150],
        [ 32,  87, 152],
        ...,
        [ 15, 114, 223],
        [ 16, 114, 223],
        [ 17, 115, 224]],

       [[ 28,  86, 149],
        [ 29,  87, 150],
        [ 31,  88, 153],
        ...,
        [ 20, 118, 227],
        [ 17, 115, 224],
        [ 14, 110, 220]],

       [[ 31,  90, 150],
        [ 30,  88, 151],
        [ 31,  89, 154],
        ...,
        [ 26, 124, 233],
        [ 20, 116, 226],
        [ 10, 106, 216]]], dtype=uint8)]"
Image_266.jpg,308,105,228,295,1000,667,536,400,295,daskShared_local/images/Image_266.jpg,266,"[array([[[ 59,  90, 124],
        [ 51,  84, 122],
        [ 63,  90, 122],
        ...,
        [119, 106,  90],
        [ 98,  86,  70],
        [ 97,  84,  68]],

       [[ 53,  94, 135],
        [ 79, 106, 135],
        [124, 135, 149],
        ...,
        [118, 105,  89],
        [116, 105,  88],
        [117, 104,  88]],

       [[125, 140, 154],
        [172, 168, 167],
        [208, 188, 175],
        ...,
        [122, 109,  91],
        [128, 116,  98],
        [143, 130, 114]],

       ...,

       [[ 23, 105, 161],
        [ 25, 107, 163],
        [ 28, 110, 166],
        ...,
        [115,  87,  50],
        [113,  84,  53],
        [ 88,  62,  37]],

       [[ 24, 106, 162],
        [ 25, 107, 163],
        [ 26, 108, 164],
        ...,
        [166, 131,  91],
        [110,  76,  43],
        [ 77,  52,  27]],

       [[ 24, 106, 162],
        [ 23, 105, 161],
        [ 22, 104, 160],
        ...,
        [101,  77,  52],
        [ 42,  21,   3],
        [ 55,  36,  14]]], dtype=uint8)]"
Image_267.jpg,397,5,81,66,530,180,478,71,81,daskShared_local/images/Image_267.jpg,267,"[array([[[  0,  21,  62],
        [  1,  21,  62],
        [  0,  21,  61],
        ...,
        [ 12,  29,  72],
        [  3,  21,  64],
        [  7,  24,  67]],

       [[  0,  21,  61],
        [  0,  21,  62],
        [  0,  21,  61],
        ...,
        [ 10,  28,  70],
        [  2,  21,  63],
        [  6,  24,  66]],

       [[  1,  21,  62],
        [  1,  21,  62],
        [  0,  21,  62],
        ...,
        [ 13,  30,  74],
        [  3,  20,  64],
        [  8,  24,  69]],

       ...,

       [[134, 143, 125],
        [115, 127, 112],
        [157, 162, 141],
        ...,
        [ 30,  24,  34],
        [ 40,  34,  42],
        [ 36,  30,  38]],

       [[ 84,  99, 104],
        [ 62,  82,  93],
        [111, 120, 117],
        ...,
        [ 40,  33,  43],
        [ 49,  42,  51],
        [ 45,  38,  47]],

       [[109, 121, 115],
        [ 89, 105, 103],
        [134, 142, 129],
        ...,
        [ 35,  29,  39],
        [ 44,  38,  46],
        [ 40,  34,  43]]], dtype=uint8)]"
Image_268.jpg,761,272,350,289,1200,906,1111,561,350,daskShared_local/images/Image_268.jpg,268,"[array([[[ 92,  87, 100],
        [ 91,  86, 101],
        [ 66,  60,  77],
        ...,
        [ 19,  54,  76],
        [ 19,  52,  75],
        [ 19,  51,  72]],

       [[ 76,  72,  87],
        [ 90,  87, 105],
        [ 79,  76,  97],
        ...,
        [ 15,  51,  73],
        [ 16,  51,  73],
        [ 16,  50,  72]],

       [[ 70,  67,  83],
        [ 72,  70,  91],
        [ 91,  90, 114],
        ...,
        [ 18,  54,  76],
        [ 16,  52,  74],
        [ 14,  50,  72]],

       ...,

       [[ 80, 126, 147],
        [ 92, 143, 164],
        [ 75, 130, 149],
        ...,
        [ 18,  63,  82],
        [ 17,  58,  78],
        [ 17,  55,  75]],

       [[ 84, 135, 155],
        [104, 155, 175],
        [ 76, 127, 146],
        ...,
        [ 17,  60,  79],
        [ 16,  55,  75],
        [ 16,  52,  72]],

       [[ 97, 149, 170],
        [112, 163, 183],
        [ 90, 137, 156],
        ...,
        [ 14,  57,  76],
        [ 17,  55,  75],
        [ 19,  53,  73]]], dtype=uint8)]"
Image_269.jpg,284,133,153,119,800,505,437,252,153,daskShared_local/images/Image_269.jpg,269,"[array([[[ 50,  63,  58],
        [ 49,  64,  59],
        [ 48,  67,  60],
        ...,
        [  7,  29,  42],
        [  6,  28,  41],
        [  5,  27,  39]],

       [[ 49,  64,  59],
        [ 48,  66,  60],
        [ 53,  75,  68],
        ...,
        [  6,  28,  42],
        [  6,  28,  40],
        [  5,  27,  39]],

       [[ 48,  67,  61],
        [ 49,  71,  64],
        [ 61,  86,  78],
        ...,
        [  6,  26,  40],
        [  5,  26,  39],
        [  4,  25,  38]],

       ...,

       [[ 90,  90,  53],
        [106, 106,  69],
        [121, 121,  84],
        ...,
        [191, 172, 142],
        [194, 174, 144],
        [197, 177, 147]],

       [[ 96,  97,  58],
        [108, 109,  70],
        [124, 124,  86],
        ...,
        [188, 170, 142],
        [190, 172, 143],
        [190, 172, 143]],

       [[ 99,  99,  60],
        [109, 110,  70],
        [125, 126,  87],
        ...,
        [187, 170, 144],
        [194, 176, 150],
        [191, 174, 148]]], dtype=uint8)]"
Image_27.jpg,429,152,252,265,1200,822,681,417,265,daskShared_local/images/Image_27.jpg,27,"[array([[[  1, 149, 175],
        [  0, 148, 174],
        [  1, 149, 175],
        ...,
        [  4, 168, 195],
        [  1, 167, 193],
        [  0, 166, 192]],

       [[  0, 150, 175],
        [  0, 149, 174],
        [  0, 150, 175],
        ...,
        [  3, 167, 194],
        [  1, 167, 193],
        [  0, 165, 191]],

       [[  2, 152, 177],
        [  0, 150, 175],
        [  0, 150, 175],
        ...,
        [  2, 166, 193],
        [  0, 166, 192],
        [  0, 165, 191]],

       ...,

       [[ 61,  69,  30],
        [ 68,  76,  44],
        [ 79,  85,  55],
        ...,
        [212, 190, 152],
        [228, 209, 174],
        [168, 151, 124]],

       [[ 57,  69,  23],
        [ 53,  62,  28],
        [ 73,  79,  54],
        ...,
        [217, 188, 143],
        [239, 211, 174],
        [206, 179, 152]],

       [[ 64,  77,  29],
        [ 41,  53,  15],
        [ 50,  56,  31],
        ...,
        [192, 175, 138],
        [222, 200, 164],
        [202, 172, 143]]], dtype=uint8)]"
Image_270.jpg,432,219,123,159,900,600,555,378,159,daskShared_local/images/Image_270.jpg,270,"[array([[[  5, 109, 164],
        [  4, 108, 163],
        [  3, 107, 162],
        ...,
        [  3, 117, 169],
        [  3, 117, 169],
        [  3, 117, 169]],

       [[  5, 109, 164],
        [  4, 108, 163],
        [  3, 107, 162],
        ...,
        [  3, 117, 169],
        [  3, 117, 169],
        [  3, 117, 169]],

       [[  5, 109, 164],
        [  4, 108, 163],
        [  3, 107, 162],
        ...,
        [  2, 116, 168],
        [  3, 117, 169],
        [  3, 117, 169]],

       ...,

       [[ 68,  71,  25],
        [ 64,  69,  23],
        [ 63,  68,  28],
        ...,
        [  5,  94, 142],
        [  5,  94, 142],
        [  5,  94, 142]],

       [[ 71,  74,  27],
        [ 76,  79,  33],
        [ 77,  81,  41],
        ...,
        [  7,  95, 143],
        [  7,  95, 143],
        [  7,  95, 143]],

       [[ 73,  75,  28],
        [ 78,  80,  33],
        [ 76,  79,  38],
        ...,
        [  7,  95, 143],
        [  7,  95, 143],
        [  7,  95, 143]]], dtype=uint8)]"
Image_271.jpg,769,161,230,183,1050,700,999,344,230,daskShared_local/images/Image_271.jpg,271,"[array([[[  3, 154, 145],
        [ 13, 163, 151],
        [  8, 157, 144],
        ...,
        [ 15,  49,  53],
        [ 12,  51,  56],
        [ 16,  62,  67]],

       [[  6, 158, 147],
        [ 16, 160, 148],
        [  6, 152, 137],
        ...,
        [ 12,  63,  66],
        [ 13,  74,  76],
        [ 16,  87,  89]],

       [[  6, 149, 137],
        [  5, 137, 126],
        [  1, 136, 121],
        ...,
        [ 19,  81,  84],
        [ 20,  91,  93],
        [ 14,  92,  94]],

       ...,

       [[ 42,  54,  57],
        [ 44,  55,  59],
        [ 38,  48,  52],
        ...,
        [ 71,  57,  64],
        [ 51,  44,  52],
        [ 35,  31,  40]],

       [[ 38,  49,  53],
        [ 41,  52,  56],
        [ 38,  48,  53],
        ...,
        [ 59,  47,  54],
        [ 45,  39,  46],
        [ 35,  31,  40]],

       [[ 34,  45,  49],
        [ 37,  47,  52],
        [ 37,  46,  51],
        ...,
        [ 50,  46,  51],
        [ 39,  39,  44],
        [ 32,  31,  39]]], dtype=uint8)]"
Image_272.jpg,353,106,308,278,1024,670,661,384,308,daskShared_local/images/Image_272.jpg,272,"[array([[[  0,  66, 116],
        [  2,  68, 118],
        [  4,  70, 118],
        ...,
        [  8,  20,  34],
        [  5,  17,  31],
        [  6,  18,  32]],

       [[  2,  65, 116],
        [  5,  69, 120],
        [  5,  69, 117],
        ...,
        [  6,  18,  32],
        [  6,  18,  32],
        [  7,  19,  33]],

       [[  1,  64, 115],
        [  1,  65, 113],
        [  2,  66, 113],
        ...,
        [  8,  20,  34],
        [  7,  19,  33],
        [  2,  14,  28]],

       ...,

       [[ 30,  90,  44],
        [ 64, 129,  74],
        [ 84, 148,  93],
        ...,
        [  9,  24,  29],
        [  7,  23,  28],
        [  5,  23,  27]],

       [[  7,  65,  26],
        [ 30,  78,  43],
        [ 37,  77,  41],
        ...,
        [  7,  21,  24],
        [  7,  21,  24],
        [  6,  21,  24]],

       [[ 17,  66,  35],
        [ 12,  40,  24],
        [ 24,  39,  19],
        ...,
        [  9,  19,  24],
        [  6,  18,  22],
        [  5,  18,  21]]], dtype=uint8)]"
Image_273.jpg,269,333,148,108,900,599,417,441,148,daskShared_local/images/Image_273.jpg,273,"[array([[[ 66, 133, 211],
        [ 66, 133, 211],
        [ 66, 133, 211],
        ...,
        [127, 186, 219],
        [162, 207, 225],
        [183, 211, 209]],

       [[ 66, 133, 211],
        [ 66, 133, 211],
        [ 66, 133, 211],
        ...,
        [147, 200, 227],
        [169, 207, 221],
        [189, 211, 207]],

       [[ 66, 133, 211],
        [ 66, 133, 211],
        [ 66, 133, 211],
        ...,
        [167, 210, 228],
        [180, 209, 216],
        [201, 215, 208]],

       ...,

       [[ 46,  85, 164],
        [ 46,  85, 164],
        [ 46,  85, 164],
        ...,
        [ 48,  91, 169],
        [ 48,  91, 169],
        [ 47,  90, 168]],

       [[ 46,  85, 164],
        [ 46,  85, 164],
        [ 46,  85, 164],
        ...,
        [ 47,  90, 168],
        [ 47,  90, 168],
        [ 47,  90, 168]],

       [[ 46,  85, 164],
        [ 46,  85, 164],
        [ 46,  85, 164],
        ...,
        [ 47,  90, 168],
        [ 47,  90, 168],
        [ 47,  90, 168]]], dtype=uint8)]"
Image_274.jpg,284,173,257,221,1000,541,541,394,257,daskShared_local/images/Image_274.jpg,274,"[array([[[ 52, 130, 167],
        [ 60, 122, 160],
        [ 62, 114, 153],
        ...,
        [ 13,  80,  98],
        [ 22,  77,  93],
        [ 28,  75,  90]],

       [[ 48, 133, 170],
        [ 57, 127, 164],
        [ 58, 118, 156],
        ...,
        [ 19,  75,  97],
        [ 25,  72,  91],
        [ 29,  70,  90]],

       [[ 41, 135, 172],
        [ 52, 130, 167],
        [ 54, 123, 159],
        ...,
        [ 14,  80, 101],
        [ 19,  77,  97],
        [ 25,  79, 100]],

       ...,

       [[  2,  47,  63],
        [  2,  42,  56],
        [  0,  34,  46],
        ...,
        [152, 172, 191],
        [141, 170, 188],
        [102, 133, 153]],

       [[  1,  46,  62],
        [  0,  43,  58],
        [  0,  42,  54],
        ...,
        [151, 176, 203],
        [ 99, 130, 154],
        [103, 136, 158]],

       [[  0,  46,  62],
        [  0,  45,  60],
        [  0,  46,  60],
        ...,
        [ 80, 112, 146],
        [ 80, 113, 143],
        [118, 153, 178]]], dtype=uint8)]"
Image_275.jpg,396,186,154,123,770,578,550,309,154,daskShared_local/images/Image_275.jpg,275,"[array([[[ 64,  70,  70],
        [ 62,  68,  68],
        [ 57,  63,  63],
        ...,
        [ 78,  78,  72],
        [ 85,  86,  82],
        [ 89,  91,  88]],

       [[ 65,  71,  70],
        [ 64,  70,  69],
        [ 60,  66,  65],
        ...,
        [ 77,  77,  73],
        [ 82,  83,  81],
        [ 86,  87,  86]],

       [[ 65,  72,  71],
        [ 65,  72,  70],
        [ 64,  70,  67],
        ...,
        [ 78,  77,  75],
        [ 81,  81,  81],
        [ 83,  85,  86]],

       ...,

       [[103, 107, 108],
        [ 80,  84,  85],
        [ 82,  86,  87],
        ...,
        [112, 112, 114],
        [ 94,  94,  96],
        [ 83,  83,  84]],

       [[103, 107, 108],
        [ 90,  94,  95],
        [ 91,  95,  96],
        ...,
        [ 60,  61,  60],
        [ 40,  39,  39],
        [ 39,  38,  37]],

       [[105, 109, 110],
        [ 97, 101, 102],
        [ 94,  98,  99],
        ...,
        [ 21,  21,  19],
        [ 13,  12,  11],
        [ 22,  21,  18]]], dtype=uint8)]"
Image_276.jpg,296,365,192,149,1024,683,488,514,192,daskShared_local/images/Image_276.jpg,276,"[array([[[144, 155, 141],
        [134, 144, 134],
        [149, 159, 155],
        ...,
        [136, 133,  84],
        [143, 135,  88],
        [148, 135,  91]],

       [[167, 175, 159],
        [144, 150, 138],
        [141, 148, 143],
        ...,
        [147, 143,  96],
        [154, 143,  98],
        [155, 142, 100]],

       [[189, 190, 173],
        [166, 169, 155],
        [152, 155, 146],
        ...,
        [141, 132,  89],
        [148, 135,  93],
        [159, 145, 104]],

       ...,

       [[  0, 106, 132],
        [  0, 106, 132],
        [  0, 106, 132],
        ...,
        [  0, 113, 139],
        [  0, 113, 139],
        [  0, 113, 139]],

       [[  0, 106, 132],
        [  0, 106, 132],
        [  0, 106, 132],
        ...,
        [  0, 113, 139],
        [  0, 113, 139],
        [  0, 113, 139]],

       [[  0, 106, 132],
        [  0, 106, 132],
        [  0, 106, 132],
        ...,
        [  0, 113, 139],
        [  0, 113, 139],
        [  0, 113, 139]]], dtype=uint8)]"
Image_277.jpg,189,207,466,317,1599,1065,655,524,466,daskShared_local/images/Image_277.jpg,277,"[array([[[  5,   1,   2],
        [  5,   1,   2],
        [  5,   1,   2],
        ...,
        [  3,   1,   2],
        [  3,   1,   2],
        [  3,   1,   2]],

       [[  3,   1,   2],
        [  5,   1,   2],
        [  5,   1,   2],
        ...,
        [  3,   1,   2],
        [  2,   0,   1],
        [  2,   0,   1]],

       [[  3,   1,   2],
        [  5,   1,   2],
        [  5,   1,   2],
        ...,
        [  3,   1,   2],
        [  2,   0,   1],
        [  2,   0,   1]],

       ...,

       [[  5,   1,   2],
        [  3,   1,   2],
        [  3,   1,   2],
        ...,
        [ 99, 142, 119],
        [133, 177, 180],
        [ 65,  94, 114]],

       [[  4,   0,   1],
        [  3,   0,   1],
        [  3,   1,   2],
        ...,
        [145, 182, 175],
        [112, 158, 157],
        [ 63, 103,  96]],

       [[  4,   0,   1],
        [  2,   0,   1],
        [  2,   0,   1],
        ...,
        [171, 203, 207],
        [151, 198, 192],
        [119, 171, 145]]], dtype=uint8)]"
Image_278.JPG,308,474,1500,1446,2560,1920,1808,1920,1500,daskShared_local/images/Image_278.JPG,278,"[array([[[ 86,  74,  26],
        [ 86,  71,  27],
        [ 86,  69,  29],
        ...,
        [129, 110,  68],
        [132, 118,  80],
        [151, 137, 111]],

       [[ 81,  69,  26],
        [ 76,  69,  30],
        [ 80,  67,  29],
        ...,
        [137, 115,  81],
        [136, 120,  87],
        [152, 139, 116]],

       [[ 77,  66,  26],
        [ 74,  68,  29],
        [ 81,  67,  31],
        ...,
        [133, 112,  80],
        [130, 115,  79],
        [145, 125,  83]],

       ...,

       [[ 77,  84,  19],
        [ 77,  84,  20],
        [ 75,  88,  41],
        ...,
        [ 91,  98,  32],
        [ 90, 101,  26],
        [ 91, 101,  33]],

       [[ 75,  84,  23],
        [ 75,  84,  25],
        [ 86,  93,  52],
        ...,
        [ 90, 100,  28],
        [ 91,  99,  29],
        [ 91, 100,  32]],

       [[ 68,  86,  24],
        [ 68,  85,  31],
        [ 93, 101,  58],
        ...,
        [ 90, 100,  19],
        [ 91,  99,  28],
        [ 89,  98,  37]]], dtype=uint8)]"
Image_279.jpg,294,409,190,192,1024,768,484,601,192,daskShared_local/images/Image_279.jpg,279,"[array([[[ 64,  55,  40],
        [ 66,  49,  39],
        [ 65,  48,  41],
        ...,
        [ 58,  41,  31],
        [ 71,  57,  48],
        [ 53,  39,  27]],

       [[129, 128, 125],
        [ 92,  81,  78],
        [ 80,  65,  62],
        ...,
        [ 44,  27,  18],
        [ 74,  59,  51],
        [ 66,  51,  43]],

       [[130, 128, 130],
        [110, 102, 102],
        [ 97,  83,  80],
        ...,
        [ 45,  31,  20],
        [ 59,  44,  37],
        [ 80,  64,  57]],

       ...,

       [[224, 198, 163],
        [217, 193, 159],
        [231, 209, 171],
        ...,
        [198, 167, 120],
        [203, 170, 123],
        [182, 150, 103]],

       [[228, 199, 165],
        [214, 189, 158],
        [212, 189, 157],
        ...,
        [201, 169, 122],
        [199, 165, 117],
        [188, 156, 109]],

       [[213, 187, 154],
        [236, 210, 180],
        [228, 205, 174],
        ...,
        [206, 173, 132],
        [205, 172, 129],
        [198, 167, 123]]], dtype=uint8)]"
Image_28.jpg,510,243,330,219,1200,900,840,462,330,daskShared_local/images/Image_28.jpg,28,"[array([[[ 60, 180, 198],
        [ 62, 182, 202],
        [ 58, 182, 201],
        ...,
        [ 79, 186, 207],
        [ 91, 191, 207],
        [ 84, 189, 208]],

       [[ 64, 184, 200],
        [ 60, 182, 197],
        [ 66, 183, 197],
        ...,
        [ 68, 186, 202],
        [ 76, 186, 201],
        [ 76, 186, 200]],

       [[ 64, 181, 197],
        [ 63, 181, 191],
        [ 57, 175, 183],
        ...,
        [ 72, 184, 201],
        [ 72, 184, 196],
        [ 76, 186, 201]],

       ...,

       [[132, 165, 155],
        [109, 157, 151],
        [124, 172, 175],
        ...,
        [165, 214, 227],
        [155, 210, 223],
        [147, 208, 222]],

       [[134, 161, 150],
        [154, 174, 163],
        [177, 207, 207],
        ...,
        [144, 208, 224],
        [148, 207, 221],
        [157, 212, 225]],

       [[134, 170, 159],
        [159, 202, 198],
        [211, 232, 234],
        ...,
        [139, 204, 217],
        [130, 198, 212],
        [138, 204, 217]]], dtype=uint8)]"
Image_280.jpg,537,205,307,271,986,653,844,476,307,daskShared_local/images/Image_280.jpg,280,"[array([[[ 57,  66,  45],
        [ 57,  65,  46],
        [ 63,  71,  50],
        ...,
        [ 60, 119,  97],
        [ 59, 118,  96],
        [ 60, 119,  97]],

       [[ 62,  70,  49],
        [ 52,  60,  39],
        [ 59,  67,  46],
        ...,
        [ 60, 118,  96],
        [ 60, 118,  96],
        [ 61, 119,  97]],

       [[ 69,  77,  56],
        [ 54,  62,  41],
        [ 59,  67,  45],
        ...,
        [ 60, 118,  96],
        [ 60, 118,  96],
        [ 61, 119,  97]],

       ...,

       [[ 79,  94,  53],
        [ 74,  89,  43],
        [ 74,  88,  37],
        ...,
        [ 54,  80,  42],
        [ 54,  80,  44],
        [ 54,  80,  44]],

       [[ 66,  81,  40],
        [ 62,  78,  32],
        [ 65,  79,  26],
        ...,
        [ 52,  78,  39],
        [ 53,  79,  41],
        [ 51,  77,  40]],

       [[ 64,  79,  36],
        [ 66,  82,  34],
        [ 71,  86,  30],
        ...,
        [ 51,  77,  38],
        [ 51,  77,  38],
        [ 50,  76,  38]]], dtype=uint8)]"
Image_281.jpg,663,235,370,320,2121,1063,1033,555,370,daskShared_local/images/Image_281.jpg,281,"[array([[[137, 152, 154],
        [146, 158, 159],
        [151, 164, 160],
        ...,
        [148, 169, 186],
        [146, 167, 182],
        [148, 167, 183]],

       [[140, 162, 169],
        [144, 164, 168],
        [139, 158, 158],
        ...,
        [140, 162, 176],
        [139, 161, 173],
        [137, 158, 170]],

       [[ 91, 124, 133],
        [119, 148, 154],
        [136, 162, 165],
        ...,
        [127, 149, 159],
        [125, 148, 156],
        [124, 144, 153]],

       ...,

       [[ 52, 103, 122],
        [ 54, 105, 124],
        [ 55, 106, 125],
        ...,
        [152, 146, 131],
        [144, 136, 119],
        [140, 130, 112]],

       [[ 54, 105, 124],
        [ 55, 106, 125],
        [ 53, 104, 123],
        ...,
        [159, 157, 142],
        [161, 161, 147],
        [152, 152, 139]],

       [[ 54, 105, 124],
        [ 55, 106, 125],
        [ 53, 104, 123],
        ...,
        [156, 152, 138],
        [159, 158, 144],
        [158, 159, 145]]], dtype=uint8)]"
Image_282.jpg,1046,1200,987,856,3840,2160,2033,2056,987,daskShared_local/images/Image_282.jpg,282,"[array([[[123, 123, 108],
        [168, 166, 155],
        [207, 211, 196],
        ...,
        [ 61,  50,  44],
        [ 61,  51,  46],
        [ 68,  58,  50]],

       [[106,  93,  91],
        [106,  95,  93],
        [156, 156, 150],
        ...,
        [ 61,  54,  45],
        [ 44,  39,  34],
        [ 60,  53,  47]],

       [[124, 104,  99],
        [112,  94,  92],
        [131, 120, 116],
        ...,
        [ 63,  56,  51],
        [ 27,  27,  21],
        [ 51,  45,  37]],

       ...,

       [[  5,  24,  30],
        [  5,  24,  30],
        [  5,  24,  30],
        ...,
        [  2,  12,  21],
        [  2,  12,  21],
        [  2,  12,  21]],

       [[  4,  23,  29],
        [  5,  24,  30],
        [  5,  24,  30],
        ...,
        [  2,  12,  21],
        [  4,  14,  23],
        [  2,  13,  21]],

       [[  4,  22,  28],
        [  4,  22,  29],
        [  4,  22,  29],
        ...,
        [  1,  11,  20],
        [  3,  13,  22],
        [  2,  11,  20]]], dtype=uint8)]"
Image_283.jpg,66,147,119,97,525,340,185,244,119,daskShared_local/images/Image_283.jpg,283,"[array([[[ 31,  81,  99],
        [ 32,  81,  99],
        [ 33,  82,  98],
        ...,
        [149, 170, 137],
        [174, 195, 159],
        [183, 203, 167]],

       [[ 32,  81,  99],
        [ 33,  81,  99],
        [ 35,  83,  99],
        ...,
        [144, 164, 132],
        [171, 191, 157],
        [181, 201, 165]],

       [[ 34,  81,  98],
        [ 36,  83,  99],
        [ 42,  88, 103],
        ...,
        [129, 148, 118],
        [162, 182, 148],
        [174, 193, 158]],

       ...,

       [[  3,  41,  21],
        [  7,  45,  25],
        [ 17,  56,  37],
        ...,
        [ 16,  33,  17],
        [  7,  24,   8],
        [  4,  21,   5]],

       [[ 26,  61,  43],
        [ 30,  65,  47],
        [ 44,  79,  62],
        ...,
        [127, 144, 128],
        [ 66,  83,  67],
        [ 45,  62,  46]],

       [[ 33,  68,  50],
        [ 38,  72,  55],
        [ 53,  87,  70],
        ...,
        [165, 182, 166],
        [ 85, 102,  86],
        [ 59,  76,  60]]], dtype=uint8)]"
Image_284.jpg,556,181,102,89,1000,700,658,270,102,daskShared_local/images/Image_284.jpg,284,"[array([[[  1, 156, 228],
        [  1, 156, 228],
        [  1, 157, 228],
        ...,
        [  0, 157, 226],
        [  0, 157, 226],
        [  0, 157, 226]],

       [[  1, 156, 228],
        [  1, 156, 228],
        [  1, 157, 228],
        ...,
        [  0, 157, 226],
        [  0, 157, 226],
        [  0, 157, 226]],

       [[  1, 155, 227],
        [  1, 155, 227],
        [  1, 156, 228],
        ...,
        [  0, 158, 227],
        [  0, 159, 227],
        [  0, 159, 227]],

       ...,

       [[ 88, 133, 143],
        [ 89, 133, 143],
        [ 93, 138, 145],
        ...,
        [  0, 147, 219],
        [  0, 148, 220],
        [  0, 148, 220]],

       [[103, 147, 154],
        [104, 147, 155],
        [115, 158, 163],
        ...,
        [  0, 148, 220],
        [  0, 148, 220],
        [  0, 148, 220]],

       [[104, 147, 155],
        [105, 148, 155],
        [116, 159, 164],
        ...,
        [  0, 148, 220],
        [  0, 148, 220],
        [  0, 148, 220]]], dtype=uint8)]"
Image_285.jpg,392,32,1107,976,1920,1080,1499,1008,1107,daskShared_local/images/Image_285.jpg,285,"[array([[[  0, 125, 157],
        [  0, 124, 157],
        [  1, 124, 156],
        ...,
        [ 48,  81,  87],
        [ 29,  58,  63],
        [ 15,  41,  47]],

       [[  0, 125, 156],
        [  0, 124, 156],
        [  0, 123, 155],
        ...,
        [ 45,  80,  83],
        [ 50,  91,  94],
        [ 29,  65,  69]],

       [[  0, 127, 157],
        [  1, 125, 156],
        [  0, 124, 156],
        ...,
        [ 38,  72,  71],
        [ 36,  76,  82],
        [ 33,  75,  80]],

       ...,

       [[ 70,  69,  36],
        [ 71,  69,  32],
        [ 79,  74,  37],
        ...,
        [ 12,  27,  28],
        [ 12,  26,  27],
        [ 12,  26,  27]],

       [[ 77,  72,  36],
        [ 86,  79,  38],
        [ 97,  88,  48],
        ...,
        [ 13,  26,  27],
        [ 13,  24,  26],
        [ 12,  24,  25]],

       [[ 96,  87,  48],
        [104,  95,  54],
        [109, 100,  61],
        ...,
        [ 13,  24,  25],
        [ 14,  23,  25],
        [ 13,  22,  24]]], dtype=uint8)]"
Image_286.jpg,296,89,173,163,732,420,469,252,173,daskShared_local/images/Image_286.jpg,286,"[array([[[  0, 166, 216],
        [  0, 166, 216],
        [  0, 166, 216],
        ...,
        [ 21, 182, 216],
        [  7, 180, 212],
        [  1, 179, 209]],

       [[  0, 166, 216],
        [  0, 166, 216],
        [  1, 167, 217],
        ...,
        [ 46, 192, 228],
        [ 26, 185, 221],
        [  5, 178, 210]],

       [[  0, 166, 216],
        [  1, 167, 217],
        [  1, 167, 217],
        ...,
        [ 67, 199, 238],
        [ 50, 194, 231],
        [ 21, 182, 216]],

       ...,

       [[200, 200, 182],
        [198, 198, 179],
        [202, 203, 184],
        ...,
        [  2,  28,  25],
        [ 11,  50,  40],
        [ 32,  71,  55]],

       [[192, 204, 190],
        [189, 200, 187],
        [189, 201, 187],
        ...,
        [  8,  21,  16],
        [ 34,  59,  47],
        [ 70,  92,  76]],

       [[207, 221, 214],
        [206, 218, 216],
        [205, 216, 216],
        ...,
        [ 18,  39,  20],
        [ 62,  90,  60],
        [ 82, 107,  71]]], dtype=uint8)]"
Image_287.jpg,440,366,211,215,1024,683,651,581,215,daskShared_local/images/Image_287.jpg,287,"[array([[[124, 112, 114],
        [ 84,  73,  76],
        [ 91,  77,  72],
        ...,
        [ 70,  50,  42],
        [ 64,  42,  32],
        [ 59,  39,  28]],

       [[ 97,  86,  91],
        [ 78,  67,  72],
        [115, 100,  94],
        ...,
        [ 62,  40,  35],
        [ 59,  40,  32],
        [ 56,  39,  30]],

       [[118,  97,  96],
        [101,  75,  70],
        [102,  84,  76],
        ...,
        [ 55,  39,  39],
        [ 50,  36,  33],
        [ 53,  42,  38]],

       ...,

       [[221, 206, 169],
        [159, 146, 108],
        [127, 114,  53],
        ...,
        [250, 222, 170],
        [214, 182, 132],
        [166, 126,  81]],

       [[187, 171, 137],
        [121, 112,  76],
        [ 99, 111,  70],
        ...,
        [213, 186, 136],
        [243, 219, 176],
        [211, 183, 147]],

       [[215, 188, 159],
        [197, 177, 148],
        [226, 224, 198],
        ...,
        [253, 235, 201],
        [239, 220, 190],
        [237, 218, 188]]], dtype=uint8)]"
Image_288.jpg,536,99,299,287,1024,770,835,386,299,daskShared_local/images/Image_288.jpg,288,"[array([[[  2, 113, 185],
        [  1, 112, 184],
        [  1, 112, 184],
        ...,
        [ 49,  54,  64],
        [ 52,  66,  74],
        [ 73,  86,  95]],

       [[  2, 113, 185],
        [  1, 112, 184],
        [  0, 111, 183],
        ...,
        [ 55,  61,  72],
        [ 66,  80,  89],
        [ 68,  84,  92]],

       [[  2, 112, 186],
        [  0, 111, 183],
        [  0, 111, 183],
        ...,
        [ 63,  67,  73],
        [ 38,  53,  60],
        [ 44,  60,  67]],

       ...,

       [[133, 133, 106],
        [ 76,  75,  57],
        [ 66,  63,  51],
        ...,
        [ 38,  37,  40],
        [ 37,  36,  36],
        [ 41,  39,  40]],

       [[122, 123,  96],
        [ 80,  81,  64],
        [ 60,  58,  48],
        ...,
        [ 47,  45,  46],
        [ 49,  47,  48],
        [ 50,  46,  47]],

       [[116, 116,  90],
        [ 82,  83,  67],
        [ 55,  55,  47],
        ...,
        [ 55,  51,  52],
        [ 54,  50,  51],
        [ 41,  37,  38]]], dtype=uint8)]"
Image_289.jpg,2239,276,608,490,3033,1757,2847,766,608,daskShared_local/images/Image_289.jpg,289,"[array([[[  0,  53, 217],
        [  0,  53, 217],
        [  0,  53, 217],
        ...,
        [  0,  53, 217],
        [  0,  53, 217],
        [  0,  53, 217]],

       [[  0,  53, 217],
        [  0,  53, 217],
        [  0,  53, 217],
        ...,
        [  0,  53, 217],
        [  0,  53, 217],
        [  0,  53, 217]],

       [[  0,  53, 217],
        [  0,  53, 217],
        [  0,  53, 217],
        ...,
        [  0,  53, 217],
        [  0,  53, 217],
        [  0,  53, 217]],

       ...,

       [[ 69,  75,  44],
        [ 73,  80,  47],
        [ 76,  84,  50],
        ...,
        [  0,  53, 217],
        [  0,  53, 217],
        [  0,  53, 217]],

       [[ 66,  72,  41],
        [ 64,  71,  38],
        [ 64,  73,  39],
        ...,
        [  0,  53, 217],
        [  0,  53, 217],
        [  0,  53, 217]],

       [[ 64,  71,  37],
        [ 61,  68,  35],
        [ 63,  71,  38],
        ...,
        [  0,  53, 217],
        [  0,  53, 217],
        [  0,  53, 217]]], dtype=uint8)]"
Image_29.jpg,359,98,148,197,728,486,507,295,197,daskShared_local/images/Image_29.jpg,29,"[array([[[  1,  66, 254],
        [  0,  69, 252],
        [  1,  66, 254],
        ...,
        [  2, 108, 252],
        [  0, 106, 254],
        [  0, 106, 254]],

       [[  1,  64, 253],
        [  1,  64, 255],
        [  1,  64, 255],
        ...,
        [  1, 105, 254],
        [  0, 106, 254],
        [  1, 107, 253]],

       [[  0,  63, 252],
        [  1,  64, 253],
        [  3,  63, 255],
        ...,
        [  0, 106, 254],
        [  0, 106, 254],
        [  3, 105, 252]],

       ...,

       [[192, 150, 112],
        [131, 100,  82],
        [ 86,  67,  53],
        ...,
        [132, 156, 142],
        [215, 220, 216],
        [205, 194, 177]],

       [[112,  90,  66],
        [ 78,  58,  49],
        [ 67,  50,  42],
        ...,
        [ 72,  85,  42],
        [127, 151, 153],
        [219, 221, 223]],

       [[ 88,  70,  58],
        [ 72,  55,  48],
        [ 62,  45,  35],
        ...,
        [ 78,  81,  52],
        [ 95, 101,  87],
        [172, 186, 197]]], dtype=uint8)]"
Image_290.jpg,507,375,186,161,1024,678,693,536,186,daskShared_local/images/Image_290.jpg,290,"[array([[[194, 165, 129],
        [199, 165, 121],
        [229, 192, 150],
        ...,
        [ 68,  86, 117],
        [ 89,  95, 112],
        [112, 105, 102]],

       [[184, 151, 130],
        [203, 161, 127],
        [242, 195, 155],
        ...,
        [121, 139, 163],
        [132, 136, 133],
        [120, 106,  70]],

       [[185, 157, 133],
        [226, 202, 167],
        [184, 164, 131],
        ...,
        [106, 112, 130],
        [119, 111, 100],
        [162, 136,  97]],

       ...,

       [[243, 238, 209],
        [242, 229, 198],
        [233, 216, 178],
        ...,
        [243, 224, 178],
        [241, 222, 172],
        [243, 221, 168]],

       [[243, 236, 207],
        [239, 226, 194],
        [238, 224, 188],
        ...,
        [243, 223, 180],
        [240, 216, 168],
        [235, 206, 152]],

       [[239, 229, 194],
        [238, 225, 190],
        [243, 226, 188],
        ...,
        [241, 224, 180],
        [233, 215, 171],
        [232, 210, 160]]], dtype=uint8)]"
Image_291.jpg,466,125,112,77,685,360,578,202,112,daskShared_local/images/Image_291.jpg,291,"[array([[[  0, 107, 149],
        [  0, 107, 149],
        [  1, 108, 150],
        ...,
        [  0, 101, 145],
        [  0, 101, 145],
        [  0, 101, 145]],

       [[  0, 107, 149],
        [  1, 107, 149],
        [  1, 108, 150],
        ...,
        [  0, 101, 145],
        [  0, 101, 145],
        [  0, 101, 145]],

       [[  1, 107, 149],
        [  1, 107, 149],
        [  1, 107, 149],
        ...,
        [  0, 101, 145],
        [  0, 101, 145],
        [  0, 101, 145]],

       ...,

       [[  1,  85, 121],
        [  1,  85, 121],
        [  1,  85, 121],
        ...,
        [  0,  81, 118],
        [  0,  81, 118],
        [  0,  81, 118]],

       [[  1,  85, 121],
        [  1,  85, 121],
        [  1,  85, 121],
        ...,
        [  0,  81, 118],
        [  0,  81, 118],
        [  0,  81, 118]],

       [[  1,  85, 121],
        [  1,  85, 121],
        [  1,  85, 121],
        ...,
        [  0,  81, 118],
        [  0,  81, 118],
        [  0,  81, 118]]], dtype=uint8)]"
Image_292.jpg,329,262,133,132,1000,667,462,394,133,daskShared_local/images/Image_292.jpg,292,"[array([[[  4, 209, 226],
        [  4, 209, 227],
        [  8, 209, 227],
        ...,
        [ 54, 214, 238],
        [ 48, 213, 238],
        [ 42, 212, 238]],

       [[  7, 209, 225],
        [  8, 209, 227],
        [ 11, 209, 227],
        ...,
        [ 39, 213, 237],
        [ 35, 213, 236],
        [ 33, 212, 236]],

       [[  9, 209, 225],
        [ 14, 210, 226],
        [ 20, 211, 227],
        ...,
        [ 24, 212, 235],
        [ 23, 212, 235],
        [ 28, 212, 235]],

       ...,

       [[129,  76,   1],
        [130,  77,   1],
        [137,  82,   1],
        ...,
        [244, 241, 247],
        [248, 242, 244],
        [249, 240, 241]],

       [[132,  86,   9],
        [126,  79,   5],
        [124,  73,   0],
        ...,
        [183, 205, 230],
        [194, 207, 231],
        [205, 211, 232]],

       [[140,  97,  15],
        [130,  84,   9],
        [121,  70,   0],
        ...,
        [141, 180, 218],
        [156, 183, 220],
        [174, 189, 224]]], dtype=uint8)]"
Image_293.jpg,583,51,167,166,930,500,750,217,167,daskShared_local/images/Image_293.jpg,293,"[array([[[ 11, 149, 211],
        [  8, 146, 209],
        [  8, 146, 209],
        ...,
        [ 10, 146, 204],
        [ 10, 146, 204],
        [ 10, 146, 204]],

       [[ 11, 149, 211],
        [  7, 145, 208],
        [  7, 145, 208],
        ...,
        [ 10, 146, 204],
        [ 10, 146, 204],
        [ 10, 146, 204]],

       [[ 10, 148, 211],
        [  7, 145, 208],
        [  7, 145, 208],
        ...,
        [ 11, 147, 205],
        [ 10, 146, 204],
        [  9, 145, 203]],

       ...,

       [[223, 221, 221],
        [231, 230, 227],
        [231, 231, 228],
        ...,
        [  8, 137, 202],
        [  8, 136, 201],
        [  7, 135, 200]],

       [[234, 230, 229],
        [243, 240, 233],
        [243, 242, 234],
        ...,
        [  7, 135, 200],
        [  7, 135, 200],
        [  6, 134, 199]],

       [[245, 241, 240],
        [252, 248, 243],
        [254, 251, 244],
        ...,
        [  7, 135, 200],
        [  6, 134, 199],
        [  6, 134, 199]]], dtype=uint8)]"
Image_294.jpg,1295,648,323,228,2106,1578,1618,876,323,daskShared_local/images/Image_294.jpg,294,"[array([[[ 27, 142, 141],
        [ 28, 144, 142],
        [ 29, 144, 142],
        ...,
        [ 17, 147, 147],
        [ 16, 146, 145],
        [ 14, 144, 147]],

       [[ 29, 143, 143],
        [ 25, 143, 139],
        [ 28, 145, 143],
        ...,
        [ 24, 147, 149],
        [ 21, 143, 146],
        [ 22, 144, 145]],

       [[ 27, 144, 143],
        [ 21, 138, 138],
        [ 27, 145, 142],
        ...,
        [ 23, 147, 144],
        [ 24, 146, 144],
        [ 24, 146, 147]],

       ...,

       [[ 35, 156, 147],
        [ 34, 153, 148],
        [ 32, 156, 151],
        ...,
        [ 28, 162, 155],
        [ 31, 164, 156],
        [ 31, 163, 157]],

       [[ 35, 156, 147],
        [ 31, 155, 147],
        [ 30, 156, 151],
        ...,
        [ 31, 165, 156],
        [ 33, 167, 158],
        [ 36, 167, 157]],

       [[ 32, 155, 151],
        [ 29, 155, 148],
        [ 33, 157, 153],
        ...,
        [ 30, 163, 154],
        [ 31, 165, 157],
        [ 32, 163, 155]]], dtype=uint8)]"
Image_295.jpg,956,255,214,167,1600,1280,1170,422,214,daskShared_local/images/Image_295.jpg,295,"[array([[[ 20,  98,  72],
        [ 15,  94,  62],
        [ 19,  99,  61],
        ...,
        [ 41, 153, 117],
        [ 42, 166, 143],
        [ 32, 158, 136]],

       [[ 21, 100,  70],
        [ 27, 107,  72],
        [ 22, 103,  62],
        ...,
        [ 52, 162, 123],
        [ 41, 166, 143],
        [ 36, 163, 142]],

       [[ 18,  94,  66],
        [ 32, 111,  74],
        [ 26, 106,  65],
        ...,
        [ 50, 160, 119],
        [ 34, 161, 139],
        [ 38, 165, 146]],

       ...,

       [[154, 128,  81],
        [132,  93,  85],
        [137,  96,  91],
        ...,
        [ 47, 161, 116],
        [ 41, 161, 112],
        [ 44, 169, 121]],

       [[138, 101,  48],
        [123,  86,  68],
        [131,  88,  89],
        ...,
        [ 47, 168, 119],
        [ 52, 179, 125],
        [ 49, 181, 129]],

       [[124,  73,  24],
        [112,  78,  51],
        [125,  82,  88],
        ...,
        [ 46, 173, 119],
        [ 53, 187, 129],
        [ 52, 189, 133]]], dtype=uint8)]"
Image_296.jpg,364,182,478,432,1280,854,842,614,478,daskShared_local/images/Image_296.jpg,296,"[array([[[115, 151, 177],
        [115, 151, 177],
        [115, 149, 176],
        ...,
        [ 76, 192, 220],
        [ 60, 195, 225],
        [ 39, 195, 227]],

       [[112, 149, 174],
        [112, 148, 174],
        [110, 145, 171],
        ...,
        [ 86, 187, 217],
        [ 74, 192, 223],
        [ 58, 198, 230]],

       [[108, 143, 168],
        [108, 143, 169],
        [107, 140, 165],
        ...,
        [ 93, 184, 215],
        [ 83, 189, 221],
        [ 71, 195, 228]],

       ...,

       [[ 22, 165, 196],
        [ 28, 169, 200],
        [ 33, 172, 202],
        ...,
        [ 16, 194, 240],
        [ 12, 187, 236],
        [ 11, 184, 234]],

       [[ 18, 162, 196],
        [ 22, 166, 199],
        [ 24, 168, 200],
        ...,
        [  9, 186, 234],
        [  8, 181, 231],
        [  5, 174, 226]],

       [[ 18, 165, 199],
        [ 18, 165, 199],
        [ 14, 164, 197],
        ...,
        [  6, 182, 231],
        [  7, 178, 230],
        [  7, 172, 226]]], dtype=uint8)]"
Image_297.jpg,61,122,202,175,600,350,263,297,202,daskShared_local/images/Image_297.jpg,297,"[array([[[ 27,  51,  37],
        [ 26,  53,  36],
        [ 25,  54,  34],
        ...,
        [ 76,  71,  65],
        [ 75,  70,  64],
        [ 76,  71,  67]],

       [[ 25,  52,  37],
        [ 25,  54,  36],
        [ 24,  53,  33],
        ...,
        [ 67,  56,  58],
        [ 81,  71,  70],
        [ 83,  73,  72]],

       [[ 25,  52,  37],
        [ 24,  53,  35],
        [ 21,  53,  33],
        ...,
        [ 42,  26,  41],
        [ 63,  48,  58],
        [ 64,  50,  57]],

       ...,

       [[168, 153, 124],
        [164, 147, 117],
        [161, 143, 113],
        ...,
        [157, 133,  95],
        [160, 137,  99],
        [163, 144, 107]],

       [[162, 143, 113],
        [153, 132, 103],
        [158, 138, 107],
        ...,
        [154, 130,  95],
        [162, 138, 102],
        [163, 143, 108]],

       [[154, 131, 100],
        [152, 129,  98],
        [164, 142, 109],
        ...,
        [161, 141, 108],
        [172, 149, 115],
        [171, 152, 120]]], dtype=uint8)]"
Image_298.jpg,132,92,152,121,500,333,284,213,152,daskShared_local/images/Image_298.jpg,298,"[array([[[ 27,  42,  61],
        [ 27,  42,  61],
        [ 27,  42,  61],
        ...,
        [ 26,  44,  66],
        [ 26,  44,  66],
        [ 26,  44,  66]],

       [[ 27,  42,  61],
        [ 27,  42,  61],
        [ 27,  42,  61],
        ...,
        [ 26,  44,  66],
        [ 26,  44,  66],
        [ 26,  44,  66]],

       [[ 27,  42,  61],
        [ 27,  42,  61],
        [ 27,  42,  61],
        ...,
        [ 26,  44,  66],
        [ 26,  44,  66],
        [ 26,  44,  66]],

       ...,

       [[ 25,  43,  57],
        [ 24,  42,  56],
        [ 24,  42,  56],
        ...,
        [114, 130, 122],
        [114, 130, 123],
        [115, 131, 123]],

       [[ 25,  43,  57],
        [ 25,  43,  57],
        [ 24,  42,  56],
        ...,
        [116, 133, 125],
        [116, 133, 125],
        [116, 133, 125]],

       [[ 25,  43,  57],
        [ 25,  43,  57],
        [ 24,  42,  56],
        ...,
        [118, 135, 127],
        [117, 134, 126],
        [117, 134, 126]]], dtype=uint8)]"
Image_299.jpg,400,184,90,54,800,600,490,238,90,daskShared_local/images/Image_299.jpg,299,"[array([[[ 66, 114, 145],
        [ 67, 115, 145],
        [ 66, 114, 144],
        ...,
        [ 57, 121, 173],
        [ 59, 123, 175],
        [ 58, 123, 174]],

       [[ 66, 114, 144],
        [ 66, 114, 144],
        [ 66, 113, 144],
        ...,
        [ 57, 121, 172],
        [ 59, 124, 174],
        [ 58, 123, 174]],

       [[ 67, 117, 147],
        [ 67, 117, 148],
        [ 66, 116, 147],
        ...,
        [ 58, 120, 177],
        [ 60, 122, 176],
        [ 59, 122, 176]],

       ...,

       [[ 87,  91, 150],
        [ 86,  89, 150],
        [ 93,  98, 150],
        ...,
        [ 24, 133, 251],
        [ 24, 133, 251],
        [ 24, 133, 251]],

       [[ 89,  90, 160],
        [ 88,  88, 160],
        [ 94,  96, 158],
        ...,
        [ 24, 133, 252],
        [ 25, 134, 251],
        [ 25, 134, 251]],

       [[ 89,  90, 158],
        [ 87,  88, 158],
        [ 94,  96, 157],
        ...,
        [ 24, 133, 252],
        [ 25, 134, 251],
        [ 25, 134, 251]]], dtype=uint8)]"
Image_3.jpg,378,429,156,119,1200,800,534,548,156,daskShared_local/images/Image_3.jpg,3,"[array([[[119, 128,  75],
        [121, 130,  78],
        [125, 134,  81],
        ...,
        [182, 166, 141],
        [181, 165, 141],
        [177, 161, 137]],

       [[119, 127,  76],
        [122, 130,  78],
        [125, 133,  82],
        ...,
        [166, 150, 126],
        [154, 138, 115],
        [143, 126, 104]],

       [[120, 128,  77],
        [122, 130,  79],
        [125, 133,  82],
        ...,
        [132, 116,  94],
        [118, 101,  80],
        [109,  92,  73]],

       ...,

       [[ 50, 112,  91],
        [ 50, 113,  92],
        [ 51, 113,  92],
        ...,
        [ 60, 113,  93],
        [ 60, 113,  93],
        [ 59, 112,  92]],

       [[ 49, 112,  91],
        [ 50, 113,  92],
        [ 50, 113,  92],
        ...,
        [ 60, 113,  93],
        [ 60, 113,  93],
        [ 59, 112,  92]],

       [[ 49, 112,  91],
        [ 50, 113,  92],
        [ 50, 113,  92],
        ...,
        [ 60, 113,  93],
        [ 60, 113,  93],
        [ 59, 112,  92]]], dtype=uint8)]"
Image_30.jpg,695,281,460,494,1920,1080,1155,775,494,daskShared_local/images/Image_30.jpg,30,"[array([[[  1, 120, 204],
        [  0, 119, 203],
        [  0, 119, 203],
        ...,
        [  1, 116, 199],
        [  1, 116, 199],
        [  1, 116, 199]],

       [[  0, 119, 203],
        [  0, 119, 203],
        [  0, 119, 203],
        ...,
        [  1, 116, 199],
        [  1, 116, 199],
        [  1, 116, 199]],

       [[  0, 119, 203],
        [  0, 119, 203],
        [  0, 119, 202],
        ...,
        [  2, 117, 200],
        [  1, 116, 199],
        [  1, 116, 199]],

       ...,

       [[163, 167, 139],
        [169, 167, 141],
        [157, 152, 124],
        ...,
        [151, 143, 100],
        [172, 167, 127],
        [206, 204, 163]],

       [[156, 162, 131],
        [142, 145, 109],
        [181, 181, 142],
        ...,
        [142, 131,  92],
        [148, 140, 100],
        [159, 154, 112]],

       [[ 98, 107,  82],
        [122, 127,  94],
        [186, 188, 151],
        ...,
        [152, 138, 103],
        [154, 143, 104],
        [151, 141, 100]]], dtype=uint8)]"
Image_300.jpg,888,524,208,186,1920,1200,1096,710,208,daskShared_local/images/Image_300.jpg,300,"[array([[[  2, 114, 115],
        [  0, 112, 114],
        [  0, 111, 113],
        ...,
        [  0, 123, 119],
        [  0, 121, 117],
        [  0, 119, 115]],

       [[  1, 113, 114],
        [  0, 111, 113],
        [  0, 110, 112],
        ...,
        [  0, 122, 119],
        [  0, 123, 119],
        [  0, 123, 119]],

       [[  1, 113, 114],
        [  0, 112, 114],
        [  0, 111, 113],
        ...,
        [  2, 122, 121],
        [  3, 123, 121],
        [  2, 124, 121]],

       ...,

       [[121, 105,  71],
        [106,  90,  56],
        [ 86,  70,  36],
        ...,
        [201, 189, 150],
        [243, 228, 192],
        [222, 204, 171]],

       [[122, 106,  70],
        [134, 118,  82],
        [100,  84,  50],
        ...,
        [142, 130,  88],
        [165, 151, 112],
        [203, 185, 149]],

       [[132, 117,  78],
        [135, 120,  81],
        [125, 111,  72],
        ...,
        [ 76,  72,  27],
        [ 83,  76,  34],
        [128, 118,  81]]], dtype=uint8)]"
Image_301.jpg,164,11,106,97,498,272,270,108,106,daskShared_local/images/Image_301.jpg,301,"[array([[[  1,  32,  66],
        [  1,  32,  66],
        [  1,  33,  67],
        ...,
        [  0,  29,  52],
        [  0,  30,  53],
        [  0,  30,  53]],

       [[  1,  32,  66],
        [  1,  32,  67],
        [  1,  33,  67],
        ...,
        [  0,  29,  52],
        [  0,  29,  52],
        [  0,  30,  53]],

       [[  2,  35,  72],
        [  2,  35,  72],
        [  2,  36,  72],
        ...,
        [  0,  29,  52],
        [  0,  29,  52],
        [  0,  29,  52]],

       ...,

       [[103, 103, 112],
        [103, 103, 112],
        [101, 104, 113],
        ...,
        [194, 208, 204],
        [198, 212, 209],
        [199, 213, 210]],

       [[113, 116, 117],
        [112, 115, 116],
        [107, 110, 111],
        ...,
        [205, 214, 220],
        [208, 217, 224],
        [208, 218, 225]],

       [[114, 118, 117],
        [114, 117, 116],
        [108, 110, 110],
        ...,
        [206, 215, 222],
        [209, 218, 226],
        [209, 219, 227]]], dtype=uint8)]"
Image_302.JPG,541,409,458,310,1600,1467,999,719,458,daskShared_local/images/Image_302.JPG,302,"[array([[[ 36,  47,  57],
        [ 34,  51,  62],
        [ 48,  67,  75],
        ...,
        [ 59,  60,  67],
        [ 85,  84,  94],
        [ 79,  79,  87]],

       [[ 40,  50,  61],
        [ 33,  50,  62],
        [ 43,  63,  73],
        ...,
        [ 58,  61,  69],
        [ 73,  75,  86],
        [ 73,  75,  84]],

       [[ 36,  46,  56],
        [ 35,  53,  64],
        [ 42,  62,  71],
        ...,
        [ 61,  66,  78],
        [ 66,  71,  83],
        [ 74,  78,  84]],

       ...,

       [[220, 226, 174],
        [221, 227, 178],
        [219, 227, 178],
        ...,
        [248, 252, 245],
        [249, 252, 246],
        [250, 253, 248]],

       [[227, 230, 174],
        [229, 235, 183],
        [229, 238, 186],
        ...,
        [234, 239, 234],
        [248, 252, 249],
        [251, 254, 254]],

       [[229, 236, 180],
        [233, 241, 187],
        [229, 237, 184],
        ...,
        [226, 231, 227],
        [240, 245, 242],
        [241, 245, 245]]], dtype=uint8)]"
Image_303.jpg,677,294,281,326,1600,900,958,620,326,daskShared_local/images/Image_303.jpg,303,"[array([[[  0, 116, 199],
        [  0, 116, 199],
        [  0, 116, 199],
        ...,
        [  0, 116, 201],
        [  0, 116, 201],
        [  1, 117, 202]],

       [[  0, 116, 199],
        [  0, 116, 199],
        [  0, 116, 199],
        ...,
        [  1, 117, 202],
        [  1, 117, 202],
        [  2, 118, 203]],

       [[  0, 116, 199],
        [  0, 116, 199],
        [  0, 116, 199],
        ...,
        [  2, 116, 202],
        [  2, 116, 202],
        [  1, 117, 202]],

       ...,

       [[200, 206, 134],
        [198, 206, 140],
        [202, 210, 151],
        ...,
        [ 82,  89,  59],
        [ 60,  66,  40],
        [ 66,  70,  49]],

       [[184, 192, 105],
        [189, 199, 112],
        [190, 199, 120],
        ...,
        [129, 137,  97],
        [ 92,  99,  65],
        [ 73,  77,  52]],

       [[179, 188,  95],
        [183, 191,  98],
        [179, 186,  99],
        ...,
        [141, 150, 106],
        [ 94, 102,  65],
        [103, 108,  82]]], dtype=uint8)]"
Image_304.jpg,73,73,92,87,300,260,165,160,92,daskShared_local/images/Image_304.jpg,304,"[array([[[  3, 228, 254],
        [  3, 228, 254],
        [  3, 228, 253],
        ...,
        [ 47, 201, 232],
        [ 62, 203, 235],
        [ 60, 202, 234]],

       [[  3, 228, 254],
        [  3, 228, 254],
        [  3, 227, 253],
        ...,
        [ 37, 197, 231],
        [ 50, 199, 233],
        [ 48, 198, 233]],

       [[  3, 228, 253],
        [  3, 228, 253],
        [  2, 228, 253],
        ...,
        [102, 219, 239],
        [130, 225, 244],
        [125, 224, 243]],

       ...,

       [[  0, 186, 237],
        [  0, 186, 237],
        [  0, 186, 237],
        ...,
        [  4,  58,  43],
        [  8,  67,  51],
        [  8,  66,  50]],

       [[  1, 187, 238],
        [  1, 187, 238],
        [  1, 187, 238],
        ...,
        [  3,  66,  45],
        [  3,  65,  44],
        [  3,  65,  44]],

       [[  1, 187, 238],
        [  1, 187, 238],
        [  1, 187, 238],
        ...,
        [  3,  64,  44],
        [  4,  66,  45],
        [  4,  65,  45]]], dtype=uint8)]"
Image_305.jpg,326,274,91,72,800,600,417,346,91,daskShared_local/images/Image_305.jpg,305,"[array([[[  1, 158, 255],
        [  1, 158, 255],
        [  1, 158, 255],
        ...,
        [  1, 162, 253],
        [  1, 162, 253],
        [  1, 162, 253]],

       [[  1, 158, 255],
        [  1, 158, 255],
        [  1, 158, 255],
        ...,
        [  1, 162, 253],
        [  2, 163, 254],
        [  1, 162, 253]],

       [[  0, 157, 254],
        [  0, 157, 254],
        [  0, 157, 254],
        ...,
        [  1, 162, 253],
        [  1, 162, 253],
        [  1, 162, 253]],

       ...,

       [[116, 158, 125],
        [115, 157, 124],
        [118, 161, 130],
        ...,
        [ 22,  26,  25],
        [ 24,  28,  26],
        [ 24,  28,  26]],

       [[111, 154, 121],
        [111, 154, 120],
        [111, 155, 124],
        ...,
        [ 19,  22,  22],
        [ 24,  28,  26],
        [ 23,  27,  26]],

       [[112, 155, 121],
        [111, 155, 121],
        [113, 157, 125],
        ...,
        [ 19,  23,  23],
        [ 24,  28,  26],
        [ 23,  27,  26]]], dtype=uint8)]"
Image_306.jpg,301,239,270,224,1000,664,571,463,270,daskShared_local/images/Image_306.jpg,306,"[array([[[180, 184, 187],
        [180, 184, 187],
        [179, 183, 186],
        ...,
        [190, 171, 156],
        [162, 143, 127],
        [154, 134, 119]],

       [[184, 188, 191],
        [184, 188, 191],
        [183, 187, 190],
        ...,
        [194, 171, 155],
        [187, 164, 148],
        [184, 162, 145]],

       [[189, 193, 196],
        [189, 193, 196],
        [189, 193, 196],
        ...,
        [198, 177, 160],
        [198, 175, 159],
        [183, 161, 145]],

       ...,

       [[166, 117,  76],
        [150,  96,  48],
        [149,  85,  42],
        ...,
        [190, 138,  80],
        [165, 114,  55],
        [159, 110,  53]],

       [[168, 121,  80],
        [155, 103,  58],
        [152,  91,  48],
        ...,
        [195, 147,  93],
        [173, 124,  70],
        [161, 114,  62]],

       [[171, 126,  88],
        [155, 107,  64],
        [151,  97,  53],
        ...,
        [186, 142,  92],
        [179, 134,  85],
        [174, 130,  81]]], dtype=uint8)]"
Image_307.jpg,632,183,479,439,2000,1000,1111,622,479,daskShared_local/images/Image_307.jpg,307,"[array([[[  1, 159, 207],
        [  2, 160, 208],
        [  2, 160, 208],
        ...,
        [  1, 152, 207],
        [  1, 152, 207],
        [  1, 152, 207]],

       [[  0, 160, 209],
        [  0, 160, 210],
        [  1, 161, 211],
        ...,
        [  1, 152, 207],
        [  0, 151, 206],
        [  1, 152, 207]],

       [[  0, 161, 210],
        [  0, 162, 211],
        [  0, 162, 211],
        ...,
        [  0, 153, 207],
        [  0, 154, 208],
        [  0, 153, 207]],

       ...,

       [[  2, 108, 146],
        [  2, 107, 146],
        [  1, 105, 144],
        ...,
        [  2,  60,  50],
        [  7,  70,  59],
        [  2,  94,  79]],

       [[  2, 112, 149],
        [  1, 111, 148],
        [  0, 108, 146],
        ...,
        [  3,  84,  70],
        [  4,  94,  79],
        [  6,  83,  70]],

       [[  1, 113, 150],
        [  1, 111, 148],
        [  0, 106, 145],
        ...,
        [  2,  93,  80],
        [  2,  84,  71],
        [  5,  82,  69]]], dtype=uint8)]"
Image_308.jpg,584,220,323,279,924,924,907,499,323,daskShared_local/images/Image_308.jpg,308,"[array([[[175, 159, 194],
        [138, 124, 160],
        [129, 115, 153],
        ...,
        [  2, 133, 161],
        [  4, 135, 163],
        [  4, 135, 163]],

       [[ 70,  60, 108],
        [ 71,  63, 112],
        [ 73,  64, 114],
        ...,
        [  2, 133, 161],
        [  2, 133, 161],
        [  2, 133, 161]],

       [[ 61,  54, 106],
        [ 55,  51, 102],
        [ 49,  45,  97],
        ...,
        [  2, 133, 161],
        [  2, 133, 161],
        [  2, 133, 161]],

       ...,

       [[ 51,  42,  13],
        [ 58,  48,  21],
        [ 63,  53,  27],
        ...,
        [ 62,  54,  33],
        [ 62,  51,  28],
        [ 60,  48,  24]],

       [[ 61,  51,  23],
        [ 70,  60,  33],
        [ 69,  58,  35],
        ...,
        [ 71,  63,  41],
        [ 54,  43,  21],
        [ 62,  51,  27]],

       [[ 77,  68,  39],
        [ 84,  74,  49],
        [ 88,  77,  55],
        ...,
        [ 65,  57,  35],
        [ 60,  50,  27],
        [ 63,  52,  28]]], dtype=uint8)]"
Image_309.jpg,1055,1514,1088,762,4613,2968,2143,2276,1088,daskShared_local/images/Image_309.jpg,309,"[array([[[138, 151, 154],
        [137, 151, 154],
        [124, 148, 144],
        ...,
        [ 87,  73,  61],
        [ 83,  67,  54],
        [ 71,  54,  41]],

       [[130, 145, 145],
        [127, 142, 142],
        [116, 137, 129],
        ...,
        [ 95,  83,  74],
        [ 97,  84,  75],
        [ 91,  78,  69]],

       [[125, 137, 135],
        [126, 130, 129],
        [118, 122, 117],
        ...,
        [ 91,  80,  72],
        [ 92,  81,  72],
        [ 88,  75,  66]],

       ...,

       [[ 66,  71,  74],
        [ 63,  70,  73],
        [ 65,  76,  79],
        ...,
        [124, 114,  98],
        [118, 111,  98],
        [ 93,  88,  83]],

       [[ 66,  72,  76],
        [ 67,  74,  76],
        [ 63,  69,  71],
        ...,
        [140, 122,  99],
        [126, 118, 103],
        [109, 104,  98]],

       [[ 51,  56,  59],
        [ 49,  53,  55],
        [ 53,  58,  59],
        ...,
        [138, 114,  85],
        [145, 125,  99],
        [129, 117, 101]]], dtype=uint8)]"
Image_31.jpg,37,84,231,165,800,600,268,249,231,daskShared_local/images/Image_31.jpg,31,"[array([[[ 10, 160, 208],
        [  7, 155, 203],
        [  6, 154, 202],
        ...,
        [ 24, 175, 222],
        [ 23, 174, 221],
        [ 24, 176, 223]],

       [[ 19, 170, 217],
        [ 14, 163, 213],
        [  8, 155, 203],
        ...,
        [ 25, 174, 223],
        [ 27, 175, 223],
        [ 24, 176, 223]],

       [[ 18, 169, 217],
        [ 19, 166, 218],
        [ 11, 158, 209],
        ...,
        [ 23, 176, 223],
        [ 24, 176, 223],
        [ 22, 175, 223]],

       ...,

       [[ 86, 150, 131],
        [ 85, 149, 130],
        [ 82, 147, 126],
        ...,
        [ 81,  33,  16],
        [ 84,  37,  19],
        [ 90,  42,  24]],

       [[ 89, 158, 135],
        [ 87, 156, 132],
        [ 83, 153, 127],
        ...,
        [ 79,  31,  12],
        [ 79,  32,  12],
        [ 75,  27,   5]],

       [[ 83, 156, 129],
        [ 81, 155, 128],
        [ 76, 152, 121],
        ...,
        [ 81,  33,  14],
        [ 82,  34,  13],
        [ 79,  33,   9]]], dtype=uint8)]"
Image_310.jpg,297,170,222,198,1000,664,519,368,222,daskShared_local/images/Image_310.jpg,310,"[array([[[  0,  79, 146],
        [  0,  79, 148],
        [  0,  79, 147],
        ...,
        [  0,  99, 168],
        [  0,  99, 167],
        [  0,  98, 169]],

       [[  0,  78, 145],
        [  1,  78, 146],
        [  0,  79, 147],
        ...,
        [  0,  99, 167],
        [  0,  99, 167],
        [  0, 100, 168]],

       [[  0,  77, 145],
        [  0,  79, 145],
        [  1,  80, 146],
        ...,
        [  0,  99, 167],
        [  0,  98, 168],
        [  1,  98, 167]],

       ...,

       [[ 42,  46,  39],
        [ 38,  46,  36],
        [ 37,  43,  34],
        ...,
        [185, 173, 149],
        [167, 142, 108],
        [172, 144, 100]],

       [[ 47,  52,  45],
        [ 40,  51,  40],
        [ 38,  47,  35],
        ...,
        [172, 148, 118],
        [177, 150, 106],
        [201, 185, 148]],

       [[ 47,  60,  50],
        [ 35,  47,  38],
        [ 35,  48,  38],
        ...,
        [165, 139, 112],
        [187, 165, 124],
        [221, 214, 190]]], dtype=uint8)]"
Image_311.jpg,416,142,235,218,1024,686,651,360,235,daskShared_local/images/Image_311.jpg,311,"[array([[[ 39, 191, 241],
        [ 39, 191, 241],
        [ 38, 190, 240],
        ...,
        [  1, 158, 219],
        [  2, 158, 219],
        [  2, 158, 219]],

       [[ 39, 192, 242],
        [ 39, 192, 242],
        [ 38, 191, 242],
        ...,
        [  1, 158, 219],
        [  1, 157, 218],
        [  1, 157, 218]],

       [[ 35, 191, 242],
        [ 35, 191, 242],
        [ 34, 190, 241],
        ...,
        [  0, 157, 218],
        [  0, 156, 217],
        [  0, 156, 217]],

       ...,

       [[217, 213, 210],
        [222, 218, 216],
        [221, 217, 215],
        ...,
        [  3, 115, 182],
        [  3, 114, 183],
        [  1, 112, 181]],

       [[191, 184, 181],
        [219, 214, 212],
        [223, 218, 218],
        ...,
        [  2, 112, 180],
        [  1, 111, 180],
        [  2, 113, 182]],

       [[188, 162, 152],
        [211, 187, 179],
        [223, 205, 201],
        ...,
        [  2, 115, 181],
        [  3, 116, 182],
        [  1, 114, 180]]], dtype=uint8)]"
Image_312.jpg,401,137,209,191,869,574,610,328,209,daskShared_local/images/Image_312.jpg,312,"[array([[[ 61, 174, 242],
        [ 64, 175, 244],
        [ 68, 175, 243],
        ...,
        [ 83, 166, 244],
        [ 78, 164, 241],
        [ 78, 164, 241]],

       [[ 42, 168, 234],
        [ 45, 168, 235],
        [ 47, 168, 234],
        ...,
        [ 83, 166, 244],
        [ 79, 164, 241],
        [ 79, 165, 242]],

       [[ 12, 151, 219],
        [ 14, 152, 218],
        [ 16, 152, 218],
        ...,
        [ 83, 167, 245],
        [ 80, 166, 243],
        [ 79, 165, 242]],

       ...,

       [[ 20,  79,  54],
        [ 16,  76,  48],
        [ 21,  79,  52],
        ...,
        [  0, 109, 180],
        [  1, 108, 180],
        [  1, 108, 180]],

       [[ 19,  79,  53],
        [ 26,  85,  57],
        [ 27,  85,  56],
        ...,
        [  0, 109, 180],
        [  1, 108, 180],
        [  1, 108, 180]],

       [[  6,  69,  40],
        [  7,  63,  36],
        [  8,  65,  37],
        ...,
        [  0, 108, 181],
        [  0, 110, 182],
        [  0, 110, 182]]], dtype=uint8)]"
Image_313.jpg,420,361,281,228,1536,1024,701,589,281,daskShared_local/images/Image_313.jpg,313,"[array([[[ 16, 136, 250],
        [ 13, 131, 247],
        [ 11, 130, 246],
        ...,
        [ 13, 148, 246],
        [ 11, 148, 246],
        [  8, 145, 244]],

       [[ 16, 133, 249],
        [ 15, 132, 248],
        [ 14, 131, 247],
        ...,
        [ 12, 145, 251],
        [ 12, 146, 252],
        [ 11, 148, 248]],

       [[ 13, 130, 246],
        [ 11, 128, 244],
        [ 10, 127, 243],
        ...,
        [ 17, 150, 241],
        [ 17, 151, 237],
        [ 15, 150, 232]],

       ...,

       [[  6,  58, 195],
        [  8,  61, 207],
        [ 10,  61, 214],
        ...,
        [ 24,  56,  53],
        [ 18,  62,  57],
        [ 20,  70,  64]],

       [[  6,  58, 193],
        [ 14,  65, 210],
        [ 14,  65, 218],
        ...,
        [ 27,  56,  55],
        [ 22,  64,  63],
        [ 16,  68,  66]],

       [[  8,  60, 197],
        [ 13,  64, 208],
        [ 16,  68, 217],
        ...,
        [ 30,  59,  60],
        [ 27,  70,  69],
        [ 13,  67,  66]]], dtype=uint8)]"
Image_314.jpg,727,438,435,347,2119,1414,1162,785,435,daskShared_local/images/Image_314.jpg,314,"[array([[[ 92, 145, 177],
        [ 92, 146, 177],
        [ 88, 143, 174],
        ...,
        [ 77, 142, 172],
        [ 76, 141, 171],
        [ 78, 143, 173]],

       [[ 91, 144, 176],
        [ 93, 146, 178],
        [ 89, 144, 175],
        ...,
        [ 81, 146, 176],
        [ 77, 142, 172],
        [ 75, 140, 170]],

       [[ 87, 140, 172],
        [ 93, 146, 178],
        [ 90, 144, 176],
        ...,
        [ 83, 149, 179],
        [ 79, 144, 175],
        [ 77, 143, 173]],

       ...,

       [[ 84, 176, 201],
        [ 87, 179, 204],
        [ 85, 177, 202],
        ...,
        [136, 139, 130],
        [185, 186, 180],
        [215, 221, 226]],

       [[ 84, 177, 202],
        [ 86, 178, 203],
        [ 85, 178, 203],
        ...,
        [138, 155, 171],
        [168, 182, 192],
        [201, 215, 210]],

       [[ 83, 177, 202],
        [ 84, 178, 203],
        [ 85, 179, 204],
        ...,
        [108, 156, 176],
        [117, 157, 171],
        [148, 177, 174]]], dtype=uint8)]"
Image_315.jpg,1392,431,498,380,2500,1667,1890,811,498,daskShared_local/images/Image_315.jpg,315,"[array([[[ 63, 142, 161],
        [ 66, 144, 164],
        [ 75, 153, 173],
        ...,
        [181, 205, 215],
        [192, 216, 226],
        [194, 219, 228]],

       [[ 67, 155, 176],
        [ 70, 153, 177],
        [ 72, 152, 177],
        ...,
        [167, 196, 204],
        [175, 205, 213],
        [181, 209, 219]],

       [[ 54, 152, 177],
        [ 55, 150, 176],
        [ 59, 150, 176],
        ...,
        [167, 196, 201],
        [170, 198, 204],
        [174, 199, 210]],

       ...,

       [[168, 150, 130],
        [156, 136, 114],
        [140, 118,  93],
        ...,
        [ 41, 127, 146],
        [  2, 125, 161],
        [  5, 128, 165]],

       [[125, 102,  76],
        [135, 110,  86],
        [127,  99,  77],
        ...,
        [  7, 123, 152],
        [  3, 125, 167],
        [  2, 126, 163]],

       [[133, 108,  77],
        [151, 124,  93],
        [151, 125,  94],
        ...,
        [  3, 121, 157],
        [  0, 122, 160],
        [  0, 122, 159]]], dtype=uint8)]"
Image_316.png,444,26,32,44,589,295,476,70,44,daskShared_local/images/Image_316.png,316,"[array([[[  0, 173, 193],
        [  0, 173, 194],
        [  0, 173, 194],
        ...,
        [  7, 172, 192],
        [ 10, 173, 193],
        [ 14, 174, 194]],

       [[  0, 171, 192],
        [  0, 172, 193],
        [  0, 172, 193],
        ...,
        [ 10, 173, 193],
        [ 13, 174, 194],
        [ 20, 176, 196]],

       [[  0, 171, 192],
        [  0, 171, 193],
        [  0, 171, 193],
        ...,
        [ 11, 174, 193],
        [ 15, 175, 194],
        [ 22, 177, 196]],

       ...,

       [[102, 114,  84],
        [100, 113,  83],
        [100, 113,  82],
        ...,
        [ 58,  73,  78],
        [ 58,  72,  77],
        [ 58,  70,  75]],

       [[104, 115,  86],
        [102, 114,  84],
        [102, 114,  84],
        ...,
        [ 57,  71,  76],
        [ 57,  70,  75],
        [ 57,  68,  74]],

       [[108, 117,  88],
        [107, 117,  88],
        [106, 117,  87],
        ...,
        [ 53,  66,  71],
        [ 54,  66,  71],
        [ 55,  65,  70]]], dtype=uint8)]"
Image_317.jpeg,644,149,250,222,1200,800,894,371,250,daskShared_local/images/Image_317.jpeg,317,"[array([[[166, 219, 233],
        [166, 219, 232],
        [162, 214, 227],
        ...,
        [183, 215, 229],
        [182, 214, 228],
        [182, 214, 227]],

       [[158, 211, 224],
        [164, 214, 228],
        [164, 215, 228],
        ...,
        [187, 219, 234],
        [184, 216, 231],
        [181, 213, 228]],

       [[156, 205, 219],
        [161, 209, 223],
        [163, 212, 224],
        ...,
        [185, 218, 233],
        [183, 216, 231],
        [181, 214, 229]],

       ...,

       [[203, 162, 100],
        [240, 197, 139],
        [226, 182, 126],
        ...,
        [234, 211, 187],
        [223, 195, 173],
        [197, 160, 138]],

       [[176, 135,  68],
        [219, 175, 114],
        [200, 155,  96],
        ...,
        [243, 208, 191],
        [243, 195, 186],
        [181, 118, 112]],

       [[177, 132,  40],
        [204, 160,  72],
        [171, 127,  51],
        ...,
        [248, 215, 217],
        [209, 169, 165],
        [141,  92,  74]]], dtype=uint8)]"
Image_318.jpg,376,430,150,117,1200,800,526,547,150,daskShared_local/images/Image_318.jpg,318,"[array([[[122, 130,  79],
        [123, 131,  80],
        [123, 131,  80],
        ...,
        [210, 210, 171],
        [228, 228, 190],
        [235, 235, 197]],

       [[124, 132,  81],
        [124, 132,  81],
        [124, 132,  81],
        ...,
        [229, 230, 191],
        [229, 229, 191],
        [216, 216, 178]],

       [[122, 132,  81],
        [122, 132,  81],
        [123, 133,  82],
        ...,
        [229, 222, 189],
        [210, 202, 170],
        [187, 179, 148]],

       ...,

       [[ 49, 111,  90],
        [ 49, 111,  90],
        [ 49, 111,  90],
        ...,
        [ 56, 111,  88],
        [ 56, 111,  88],
        [ 56, 111,  88]],

       [[ 49, 111,  90],
        [ 49, 111,  90],
        [ 49, 111,  90],
        ...,
        [ 56, 111,  88],
        [ 56, 111,  88],
        [ 56, 111,  88]],

       [[ 49, 111,  90],
        [ 49, 111,  90],
        [ 49, 111,  90],
        ...,
        [ 56, 111,  88],
        [ 56, 111,  88],
        [ 56, 111,  88]]], dtype=uint8)]"
Image_319.jpg,327,136,267,225,845,563,594,361,267,daskShared_local/images/Image_319.jpg,319,"[array([[[ 96, 204, 207],
        [110, 208, 214],
        [120, 210, 215],
        ...,
        [ 76, 191, 190],
        [ 69, 191, 188],
        [ 68, 193, 189]],

       [[ 89, 202, 203],
        [100, 205, 208],
        [109, 207, 210],
        ...,
        [ 88, 195, 195],
        [ 78, 194, 193],
        [ 70, 197, 193]],

       [[ 81, 198, 200],
        [ 88, 200, 201],
        [ 97, 202, 205],
        ...,
        [104, 203, 204],
        [ 89, 201, 201],
        [ 75, 201, 200]],

       ...,

       [[ 62, 113,  47],
        [ 66, 116,  50],
        [ 69, 116,  51],
        ...,
        [ 49, 194, 187],
        [ 53, 194, 190],
        [ 53, 195, 193]],

       [[ 56, 111,  49],
        [ 57, 111,  50],
        [ 61, 111,  51],
        ...,
        [ 45, 190, 184],
        [ 53, 193, 188],
        [ 56, 196, 191]],

       [[ 53,  99,  38],
        [ 59, 105,  44],
        [ 60, 105,  44],
        ...,
        [ 40, 184, 179],
        [ 51, 190, 184],
        [ 57, 196, 187]]], dtype=uint8)]"
Image_32.jpg,468,131,283,311,1600,1019,751,442,311,daskShared_local/images/Image_32.jpg,32,"[array([[[ 26, 109, 213],
        [ 26, 109, 213],
        [ 26, 109, 213],
        ...,
        [ 28, 116, 213],
        [ 28, 116, 213],
        [ 28, 116, 213]],

       [[ 26, 109, 213],
        [ 26, 109, 213],
        [ 26, 109, 213],
        ...,
        [ 28, 116, 213],
        [ 28, 116, 213],
        [ 28, 116, 213]],

       [[ 26, 109, 213],
        [ 26, 109, 213],
        [ 26, 109, 213],
        ...,
        [ 28, 116, 213],
        [ 28, 116, 213],
        [ 28, 116, 213]],

       ...,

       [[238, 240, 228],
        [216, 218, 207],
        [211, 213, 204],
        ...,
        [112, 100,  90],
        [162, 156, 145],
        [195, 191, 181]],

       [[247, 249, 238],
        [225, 227, 216],
        [218, 220, 209],
        ...,
        [101,  79,  71],
        [122, 101,  92],
        [130, 109, 102]],

       [[240, 242, 231],
        [213, 215, 204],
        [210, 212, 199],
        ...,
        [ 84,  49,  45],
        [103,  67,  61],
        [ 95,  55,  52]]], dtype=uint8)]"
Image_320.jpg,232,191,149,159,500,559,381,350,159,daskShared_local/images/Image_320.jpg,320,"[array([[[ 70, 166, 169],
        [ 70, 167, 170],
        [ 71, 169, 172],
        ...,
        [110, 202, 191],
        [115, 204, 192],
        [119, 204, 192]],

       [[ 86, 163, 168],
        [ 82, 165, 170],
        [ 80, 169, 175],
        ...,
        [123, 207, 197],
        [130, 208, 197],
        [133, 212, 200]],

       [[131, 180, 176],
        [124, 180, 177],
        [118, 181, 180],
        ...,
        [128, 211, 202],
        [134, 213, 203],
        [135, 216, 206]],

       ...,

       [[108,  95,  22],
        [101,  87,  13],
        [100,  85,  12],
        ...,
        [ 99, 120,  21],
        [103, 118,  17],
        [101, 115,  15]],

       [[ 89,  77,  10],
        [ 89,  76,   8],
        [ 93,  80,  11],
        ...,
        [ 97, 120,  18],
        [121, 134,  23],
        [123, 135,  28]],

       [[ 75,  65,   3],
        [ 80,  69,   6],
        [ 88,  77,  12],
        ...,
        [ 92, 115,  14],
        [124, 137,  22],
        [130, 142,  32]]], dtype=uint8)]"
Image_321.jpg,712,187,175,140,1000,600,887,327,175,daskShared_local/images/Image_321.jpg,321,"[array([[[  9, 157, 205],
        [ 11, 159, 207],
        [ 12, 160, 208],
        ...,
        [  5, 152, 206],
        [  5, 152, 206],
        [  5, 152, 206]],

       [[ 14, 160, 207],
        [ 14, 161, 208],
        [ 14, 161, 208],
        ...,
        [  3, 153, 206],
        [  3, 153, 206],
        [  4, 154, 207]],

       [[ 18, 164, 209],
        [ 17, 163, 208],
        [ 16, 161, 207],
        ...,
        [  3, 153, 206],
        [  4, 154, 207],
        [  4, 154, 207]],

       ...,

       [[175, 158,  27],
        [185, 165,  54],
        [196, 175,  80],
        ...,
        [200, 213, 123],
        [226, 233, 183],
        [224, 226, 210]],

       [[174, 153,  40],
        [170, 146,  55],
        [183, 159,  82],
        ...,
        [232, 239, 190],
        [247, 248, 231],
        [235, 234, 238]],

       [[178, 153,  65],
        [187, 158,  97],
        [193, 165, 114],
        ...,
        [242, 242, 227],
        [243, 241, 242],
        [239, 238, 245]]], dtype=uint8)]"
Image_322.jpg,693,276,460,505,1920,1080,1153,781,505,daskShared_local/images/Image_322.jpg,322,"[array([[[  0, 119, 203],
        [  0, 119, 203],
        [  0, 119, 203],
        ...,
        [  1, 116, 199],
        [  1, 116, 199],
        [  1, 116, 199]],

       [[  0, 119, 203],
        [  0, 119, 203],
        [  0, 119, 203],
        ...,
        [  1, 116, 199],
        [  1, 116, 199],
        [  1, 116, 199]],

       [[  0, 118, 202],
        [  0, 119, 203],
        [  0, 119, 203],
        ...,
        [  1, 116, 199],
        [  1, 116, 199],
        [  1, 116, 199]],

       ...,

       [[ 78,  80,  68],
        [ 81,  87,  77],
        [ 94, 104,  87],
        ...,
        [156, 144, 106],
        [158, 146, 106],
        [161, 148, 108]],

       [[ 73,  76,  59],
        [ 73,  80,  63],
        [ 77,  89,  66],
        ...,
        [160, 148, 117],
        [167, 154, 122],
        [172, 159, 125]],

       [[ 79,  85,  65],
        [ 68,  78,  59],
        [ 88, 102,  80],
        ...,
        [154, 147, 118],
        [158, 149, 121],
        [173, 162, 132]]], dtype=uint8)]"
Image_323.jpg,1731,558,1371,1540,4631,3087,3102,2098,1540,daskShared_local/images/Image_323.jpg,323,"[array([[[ 21,  92, 239],
        [ 21,  91, 239],
        [ 21,  91, 239],
        ...,
        [  1,  59, 195],
        [  0,  59, 195],
        [  0,  59, 195]],

       [[ 21,  91, 239],
        [ 21,  91, 239],
        [ 21,  90, 239],
        ...,
        [  1,  59, 195],
        [  0,  59, 195],
        [  0,  59, 195]],

       [[ 22,  90, 238],
        [ 22,  90, 238],
        [ 21,  90, 238],
        ...,
        [  1,  59, 194],
        [  0,  58, 194],
        [  0,  58, 193]],

       ...,

       [[ 65,  54,  42],
        [ 92,  80,  61],
        [112, 104,  78],
        ...,
        [ 32,  33,  18],
        [ 32,  33,  17],
        [ 33,  33,  17]],

       [[107,  93,  66],
        [110,  99,  75],
        [ 98,  89,  73],
        ...,
        [ 31,  33,  18],
        [ 31,  33,  18],
        [ 31,  33,  17]],

       [[113,  98,  72],
        [ 97,  80,  64],
        [103,  95,  97],
        ...,
        [ 27,  30,  15],
        [ 28,  32,  16],
        [ 31,  34,  18]]], dtype=uint8)]"
Image_324.jpg,614,317,192,150,1400,933,806,467,192,daskShared_local/images/Image_324.jpg,324,"[array([[[  0, 171, 229],
        [  0, 172, 230],
        [  0, 172, 228],
        ...,
        [  2, 209, 251],
        [  2, 209, 251],
        [  2, 209, 251]],

       [[  0, 171, 229],
        [  0, 172, 230],
        [  0, 173, 229],
        ...,
        [  1, 208, 250],
        [  0, 207, 249],
        [  0, 207, 249]],

       [[  0, 172, 230],
        [  0, 172, 230],
        [  0, 173, 229],
        ...,
        [  0, 206, 248],
        [  0, 205, 247],
        [  0, 206, 248]],

       ...,

       [[239, 215, 169],
        [216, 189, 137],
        [233, 209, 174],
        ...,
        [  0, 184, 236],
        [  0, 184, 236],
        [  0, 184, 236]],

       [[229, 206, 165],
        [155, 128,  83],
        [127,  93,  64],
        ...,
        [  0, 184, 236],
        [  0, 184, 236],
        [  0, 184, 236]],

       [[210, 188, 151],
        [215, 190, 150],
        [237, 195, 180],
        ...,
        [  0, 184, 236],
        [  0, 184, 236],
        [  0, 184, 236]]], dtype=uint8)]"
Image_325.jpg,450,235,162,159,900,586,612,394,162,daskShared_local/images/Image_325.jpg,325,"[array([[[176, 230, 236],
        [160, 229, 237],
        [136, 222, 234],
        ...,
        [ 95, 203, 226],
        [ 97, 203, 227],
        [ 97, 203, 227]],

       [[186, 234, 233],
        [180, 234, 237],
        [169, 231, 240],
        ...,
        [ 93, 202, 225],
        [ 94, 202, 226],
        [ 95, 203, 226]],

       [[183, 228, 230],
        [182, 227, 232],
        [182, 226, 234],
        ...,
        [ 90, 201, 225],
        [ 91, 202, 226],
        [ 93, 202, 226]],

       ...,

       [[  0,  54,  46],
        [  0,  50,  43],
        [  7,  58,  52],
        ...,
        [  1, 163, 209],
        [  1, 163, 209],
        [  1, 163, 209]],

       [[  1,  60,  52],
        [  0,  45,  39],
        [  0,  43,  38],
        ...,
        [  1, 163, 209],
        [  1, 163, 209],
        [  1, 163, 209]],

       [[  5,  65,  57],
        [  1,  44,  38],
        [  0,  36,  32],
        ...,
        [  1, 163, 209],
        [  1, 163, 209],
        [  1, 163, 209]]], dtype=uint8)]"
Image_326.jpg,3232,764,874,868,5616,2633,4106,1632,874,daskShared_local/images/Image_326.jpg,326,"[array([[[  1, 197, 245],
        [  0, 197, 245],
        [  0, 198, 245],
        ...,
        [  1, 209, 255],
        [  0, 210, 255],
        [  0, 210, 255]],

       [[  0, 196, 244],
        [  0, 196, 244],
        [  0, 197, 245],
        ...,
        [  0, 208, 255],
        [  0, 208, 255],
        [  1, 208, 255]],

       [[  0, 195, 243],
        [  0, 196, 244],
        [  0, 197, 244],
        ...,
        [  0, 208, 255],
        [  0, 208, 255],
        [  0, 208, 255]],

       ...,

       [[  0, 133, 181],
        [  1, 133, 181],
        [  1, 133, 180],
        ...,
        [201, 159, 138],
        [201, 139, 111],
        [228, 161, 137]],

       [[  0, 134, 180],
        [  1, 133, 181],
        [  1, 133, 181],
        ...,
        [168, 127, 109],
        [193, 131, 107],
        [218, 154, 131]],

       [[  0, 136, 179],
        [  1, 134, 180],
        [  1, 134, 181],
        ...,
        [142,  97,  76],
        [177, 113,  91],
        [198, 133, 115]]], dtype=uint8)]"
Image_327.jpg,36,84,223,158,800,600,259,242,223,daskShared_local/images/Image_327.jpg,327,"[array([[[ 11, 163, 210],
        [ 18, 169, 216],
        [ 12, 161, 210],
        ...,
        [ 14, 173, 221],
        [ 13, 174, 220],
        [ 16, 174, 219]],

       [[  8, 160, 207],
        [ 20, 170, 218],
        [ 21, 168, 219],
        ...,
        [ 12, 173, 219],
        [ 14, 175, 220],
        [ 21, 178, 225]],

       [[  4, 157, 205],
        [ 14, 164, 215],
        [ 11, 158, 211],
        ...,
        [ 15, 176, 220],
        [ 16, 175, 219],
        [ 21, 177, 224]],

       ...,

       [[ 64, 134, 115],
        [ 65, 134, 115],
        [ 65, 132, 114],
        ...,
        [ 93,  68,  46],
        [102,  78,  55],
        [109,  84,  62]],

       [[ 61, 129, 110],
        [ 60, 127, 109],
        [ 61, 127, 110],
        ...,
        [ 94,  66,  44],
        [ 99,  71,  49],
        [ 94,  64,  42]],

       [[ 55, 122, 105],
        [ 65, 129, 113],
        [ 66, 130, 113],
        ...,
        [ 94,  63,  40],
        [ 96,  64,  43],
        [ 97,  63,  44]]], dtype=uint8)]"
Image_328.jpg,459,275,154,172,850,567,613,447,172,daskShared_local/images/Image_328.jpg,328,"[array([[[122,  63,  52],
        [175, 127, 108],
        [226, 186, 167],
        ...,
        [ 40,  55,  79],
        [ 34,  50,  70],
        [ 31,  45,  71]],

       [[147,  88,  75],
        [194, 146, 130],
        [238, 199, 179],
        ...,
        [ 32,  47,  67],
        [ 30,  45,  65],
        [ 34,  44,  75]],

       [[218, 170, 142],
        [198, 150, 129],
        [183, 136, 119],
        ...,
        [ 35,  51,  67],
        [ 30,  44,  64],
        [ 30,  38,  70]],

       ...,

       [[  8, 122, 234],
        [  8, 122, 234],
        [  8, 122, 234],
        ...,
        [ 10, 128, 234],
        [ 10, 128, 234],
        [  9, 127, 233]],

       [[  8, 122, 234],
        [  8, 122, 234],
        [  9, 123, 235],
        ...,
        [ 11, 129, 235],
        [ 11, 129, 235],
        [  9, 127, 233]],

       [[  8, 122, 234],
        [  8, 122, 234],
        [  9, 123, 235],
        ...,
        [ 11, 129, 235],
        [ 11, 129, 235],
        [ 10, 128, 234]]], dtype=uint8)]"
Image_329.jpg,517,241,321,225,1200,900,838,466,321,daskShared_local/images/Image_329.jpg,329,"[array([[[ 62, 180, 193],
        [ 63, 177, 184],
        [ 49, 172, 176],
        ...,
        [ 80, 187, 204],
        [ 84, 188, 203],
        [ 73, 185, 201]],

       [[ 62, 177, 190],
        [ 40, 170, 185],
        [ 12, 153, 164],
        ...,
        [ 70, 184, 200],
        [ 79, 188, 210],
        [ 77, 187, 209]],

       [[ 61, 180, 197],
        [ 60, 177, 190],
        [ 41, 164, 180],
        ...,
        [ 89, 189, 204],
        [ 95, 192, 205],
        [ 86, 190, 210]],

       ...,

       [[197, 227, 232],
        [221, 239, 242],
        [218, 238, 241],
        ...,
        [129, 197, 210],
        [147, 206, 212],
        [174, 217, 226]],

       [[220, 238, 241],
        [218, 236, 242],
        [214, 235, 240],
        ...,
        [137, 200, 212],
        [153, 208, 221],
        [159, 213, 224]],

       [[217, 237, 240],
        [205, 230, 237],
        [188, 224, 229],
        ...,
        [158, 212, 226],
        [168, 216, 228],
        [159, 211, 225]]], dtype=uint8)]"
Image_33.jpg,254,389,840,617,1512,1231,1094,1006,840,daskShared_local/images/Image_33.jpg,33,"[array([[[ 75,  88,  80],
        [ 73,  86,  79],
        [ 73,  86,  79],
        ...,
        [ 99, 131,  99],
        [ 85, 120,  87],
        [ 81, 118,  84]],

       [[ 77,  87,  79],
        [ 74,  85,  77],
        [ 74,  85,  77],
        ...,
        [106, 136, 105],
        [ 92, 125,  94],
        [ 82, 118,  85]],

       [[ 76,  86,  78],
        [ 73,  84,  76],
        [ 74,  85,  77],
        ...,
        [104, 133, 103],
        [101, 132,  98],
        [ 91, 127,  91]],

       ...,

       [[255, 241, 215],
        [255, 241, 215],
        [255, 241, 215],
        ...,
        [242, 219, 185],
        [241, 217, 181],
        [246, 224, 192]],

       [[254, 241, 215],
        [255, 241, 215],
        [255, 241, 215],
        ...,
        [237, 214, 177],
        [233, 204, 162],
        [236, 206, 169]],

       [[254, 241, 215],
        [255, 241, 215],
        [255, 241, 215],
        ...,
        [246, 225, 193],
        [235, 206, 163],
        [223, 191, 146]]], dtype=uint8)]"
Image_330.jpg,357,97,149,198,728,486,506,295,198,daskShared_local/images/Image_330.jpg,330,"[array([[[  2,  65, 254],
        [  1,  64, 253],
        [  2,  66, 252],
        ...,
        [  2, 106, 253],
        [  3, 107, 254],
        [  1, 107, 255]],

       [[  2,  63, 252],
        [  1,  64, 253],
        [  1,  66, 254],
        ...,
        [  0, 106, 254],
        [  2, 108, 252],
        [  0, 106, 254]],

       [[  0,  63, 252],
        [  1,  64, 253],
        [  1,  64, 253],
        ...,
        [  0, 106, 254],
        [  1, 105, 254],
        [  0, 106, 254]],

       ...,

       [[193, 145,  97],
        [196, 154, 112],
        [193, 151, 113],
        ...,
        [ 89,  99,  65],
        [132, 156, 142],
        [216, 221, 217]],

       [[201, 153, 117],
        [202, 157, 118],
        [112,  90,  66],
        ...,
        [ 89,  99,  62],
        [ 71,  84,  41],
        [127, 151, 153]],

       [[193, 133,  97],
        [177, 128,  96],
        [ 88,  70,  58],
        ...,
        [ 82,  84,  71],
        [ 78,  81,  52],
        [ 94, 100,  86]]], dtype=uint8)]"
Image_331.jpg,279,160,172,170,800,533,451,330,172,daskShared_local/images/Image_331.jpg,331,"[array([[[253, 254, 251],
        [254, 254, 252],
        [254, 254, 252],
        ...,
        [ 46,  56,  75],
        [ 53,  63,  82],
        [ 60,  70,  89]],

       [[249, 244, 219],
        [253, 243, 223],
        [255, 241, 222],
        ...,
        [ 29,  28,  58],
        [ 62,  62,  90],
        [ 79,  79, 107]],

       [[222, 212, 181],
        [233, 213, 185],
        [234, 210, 183],
        ...,
        [ 47,  44,  75],
        [ 42,  39,  70],
        [ 44,  41,  70]],

       ...,

       [[129, 102,  83],
        [132, 104,  91],
        [132, 104,  92],
        ...,
        [110,  91,  85],
        [104,  85,  79],
        [ 97,  78,  72]],

       [[129, 102,  84],
        [146, 118, 105],
        [154, 126, 114],
        ...,
        [ 90,  71,  65],
        [ 84,  65,  59],
        [ 79,  60,  54]],

       [[155, 128, 109],
        [167, 139, 126],
        [166, 138, 126],
        ...,
        [ 88,  69,  62],
        [ 81,  62,  55],
        [ 76,  57,  50]]], dtype=uint8)]"
Image_332.jpg,609,217,389,423,1600,1070,998,640,423,daskShared_local/images/Image_332.jpg,332,"[array([[[ 24,  74, 145],
        [ 24,  74, 145],
        [ 24,  74, 145],
        ...,
        [ 28,  69, 133],
        [ 28,  69, 133],
        [ 28,  69, 133]],

       [[ 24,  74, 145],
        [ 24,  74, 145],
        [ 24,  74, 145],
        ...,
        [ 28,  69, 133],
        [ 28,  69, 133],
        [ 28,  69, 133]],

       [[ 24,  74, 145],
        [ 24,  74, 145],
        [ 24,  74, 145],
        ...,
        [ 28,  69, 133],
        [ 28,  69, 133],
        [ 28,  69, 133]],

       ...,

       [[189, 173, 140],
        [176, 157, 125],
        [179, 157, 124],
        ...,
        [125, 101,  53],
        [150, 125,  75],
        [202, 176, 124]],

       [[208, 192, 160],
        [173, 160, 134],
        [131, 123,  99],
        ...,
        [191, 172, 125],
        [218, 197, 150],
        [228, 205, 158]],

       [[165, 157, 127],
        [150, 147, 128],
        [128, 134, 125],
        ...,
        [176, 163, 133],
        [159, 142, 112],
        [198, 177, 143]]], dtype=uint8)]"
Image_333.jpg,1426,1122,400,382,2522,3332,1826,1504,400,daskShared_local/images/Image_333.jpg,333,"[array([[[ 95,  84,  89],
        [118, 105, 101],
        [165, 149, 136],
        ...,
        [ 10, 171, 173],
        [  4, 171, 171],
        [ 16, 145, 156]],

       [[163, 154, 155],
        [193, 181, 173],
        [206, 191, 174],
        ...,
        [  6, 159, 167],
        [  7, 151, 162],
        [ 11, 128, 144]],

       [[206, 195, 181],
        [212, 199, 177],
        [209, 194, 167],
        ...,
        [  2, 157, 163],
        [  2, 144, 154],
        [  3, 126, 142]],

       ...,

       [[ 55,  80,  71],
        [ 53,  76,  68],
        [ 42,  65,  58],
        ...,
        [  0, 124, 198],
        [  1, 125, 199],
        [  0, 123, 197]],

       [[ 54,  78,  71],
        [ 51,  75,  68],
        [ 45,  69,  63],
        ...,
        [  0, 124, 198],
        [  0, 124, 198],
        [  1, 124, 198]],

       [[ 50,  75,  69],
        [ 48,  74,  68],
        [ 46,  72,  67],
        ...,
        [  0, 124, 198],
        [  0, 123, 197],
        [  2, 126, 200]]], dtype=uint8)]"
Image_334.jpg,307,215,198,203,1000,600,505,418,203,daskShared_local/images/Image_334.jpg,334,"[array([[[  1, 146, 193],
        [  1, 146, 193],
        [  1, 146, 193],
        ...,
        [  1, 158, 201],
        [  1, 158, 201],
        [  1, 158, 201]],

       [[  0, 145, 190],
        [  0, 145, 190],
        [  0, 145, 190],
        ...,
        [  2, 160, 207],
        [  2, 160, 207],
        [  2, 160, 207]],

       [[  0, 145, 190],
        [  0, 145, 190],
        [  0, 145, 190],
        ...,
        [  2, 160, 207],
        [  2, 160, 207],
        [  2, 160, 207]],

       ...,

       [[121,  92,  26],
        [ 56,  32,  26],
        [ 38,  29,  20],
        ...,
        [239, 223, 174],
        [239, 221, 171],
        [240, 220, 167]],

       [[ 87,  60,  16],
        [ 38,  17,  26],
        [ 34,  25,  47],
        ...,
        [241, 220, 167],
        [240, 219, 166],
        [240, 219, 166]],

       [[ 64,  41,   9],
        [ 32,  15,  26],
        [ 33,  26,  43],
        ...,
        [239, 217, 160],
        [238, 216, 159],
        [237, 215, 158]]], dtype=uint8)]"
Image_335.jpg,420,2,398,545,1280,720,818,547,545,daskShared_local/images/Image_335.jpg,335,"[array([[[157, 226, 237],
        [158, 227, 238],
        [160, 229, 239],
        ...,
        [ 70, 185, 215],
        [ 72, 186, 215],
        [ 81, 192, 220]],

       [[162, 229, 239],
        [166, 232, 242],
        [166, 230, 239],
        ...,
        [ 69, 185, 213],
        [ 64, 187, 212],
        [ 79, 191, 217]],

       [[170, 234, 240],
        [174, 236, 243],
        [169, 234, 241],
        ...,
        [ 64, 185, 213],
        [ 61, 185, 212],
        [ 77, 190, 216]],

       ...,

       [[105,  81,  35],
        [109,  84,  42],
        [ 99,  76,  31],
        ...,
        [  3,  61,  79],
        [  2,  64,  82],
        [  3,  65,  85]],

       [[ 98,  75,  30],
        [103,  80,  40],
        [ 95,  73,  29],
        ...,
        [  3,  62,  72],
        [  3,  66,  81],
        [  4,  67,  84]],

       [[100,  77,  30],
        [104,  79,  40],
        [ 97,  74,  33],
        ...,
        [  1,  52,  55],
        [  3,  61,  70],
        [  2,  56,  69]]], dtype=uint8)]"
Image_336.jpg,165,180,167,133,728,500,332,313,167,daskShared_local/images/Image_336.jpg,336,"[array([[[  0,  67, 216],
        [  0,  69, 216],
        [  1,  70, 217],
        ...,
        [  0,  81, 224],
        [  0,  81, 224],
        [  0,  81, 224]],

       [[  0,  68, 215],
        [  1,  69, 216],
        [  0,  70, 216],
        ...,
        [  1,  81, 224],
        [  1,  81, 225],
        [  0,  81, 224]],

       [[  1,  68, 216],
        [  1,  69, 216],
        [  1,  69, 216],
        ...,
        [  2,  80, 225],
        [  2,  81, 225],
        [  1,  80, 224]],

       ...,

       [[ 17, 124, 139],
        [ 23, 132, 146],
        [ 32, 145, 152],
        ...,
        [230, 204, 166],
        [231, 202, 173],
        [241, 212, 178]],

       [[ 17, 126, 145],
        [ 28, 138, 155],
        [ 39, 152, 160],
        ...,
        [224, 203, 167],
        [216, 179, 152],
        [230, 197, 170]],

       [[ 17, 131, 152],
        [ 24, 135, 157],
        [ 26, 143, 157],
        ...,
        [222, 200, 168],
        [201, 154, 128],
        [221, 178, 147]]], dtype=uint8)]"
Image_337.jpg,627,224,124,104,1000,667,751,328,124,daskShared_local/images/Image_337.jpg,337,"[array([[[ 61, 114, 117],
        [ 60, 113, 116],
        [ 58, 111, 113],
        ...,
        [ 60, 118, 118],
        [ 55, 117, 118],
        [ 53, 116, 118]],

       [[ 61, 113, 116],
        [ 61, 112, 115],
        [ 59, 110, 113],
        ...,
        [ 64, 121, 121],
        [ 58, 120, 120],
        [ 56, 119, 120]],

       [[ 62, 110, 114],
        [ 61, 110, 114],
        [ 60, 107, 111],
        ...,
        [ 71, 129, 127],
        [ 65, 126, 126],
        [ 62, 125, 125]],

       ...,

       [[ 90,  89,  60],
        [ 89,  88,  59],
        [ 87,  87,  58],
        ...,
        [  3,  96, 111],
        [ 15, 107, 122],
        [ 20, 112, 127]],

       [[108, 107,  77],
        [104, 103,  73],
        [ 94,  94,  64],
        ...,
        [ 18, 110, 125],
        [ 32, 124, 138],
        [ 38, 130, 144]],

       [[116, 115,  85],
        [110, 110,  80],
        [ 98,  98,  67],
        ...,
        [ 25, 117, 132],
        [ 39, 131, 145],
        [ 45, 137, 151]]], dtype=uint8)]"
Image_338.jpg,658,293,294,321,1600,1000,952,614,321,daskShared_local/images/Image_338.jpg,338,"[array([[[  0,  69, 162],
        [  0,  69, 162],
        [  0,  69, 162],
        ...,
        [  1,  68, 159],
        [  1,  68, 159],
        [  1,  68, 159]],

       [[  0,  69, 162],
        [  0,  69, 162],
        [  0,  69, 162],
        ...,
        [  1,  68, 159],
        [  1,  68, 159],
        [  0,  67, 158]],

       [[  0,  69, 162],
        [  0,  69, 162],
        [  0,  69, 162],
        ...,
        [  1,  68, 159],
        [  1,  68, 159],
        [  1,  68, 159]],

       ...,

       [[ 69,  85,  55],
        [ 86,  98,  64],
        [110, 115,  71],
        ...,
        [ 91,  78,  45],
        [ 98,  89,  50],
        [109, 103,  59]],

       [[ 38,  55,  32],
        [ 44,  54,  30],
        [117, 119,  84],
        ...,
        [ 98,  85,  50],
        [103,  91,  53],
        [105,  92,  53]],

       [[ 28,  44,  26],
        [ 34,  42,  26],
        [ 79,  80,  56],
        ...,
        [ 93,  83,  48],
        [110,  95,  61],
        [119, 102,  68]]], dtype=uint8)]"
Image_339.jpg,700,660,402,265,2793,2090,1102,925,402,daskShared_local/images/Image_339.jpg,339,"[array([[[  5,  69, 192],
        [  5,  69, 192],
        [  5,  69, 192],
        ...,
        [  3,  68, 186],
        [  3,  68, 186],
        [  3,  68, 186]],

       [[  5,  69, 192],
        [  5,  69, 192],
        [  5,  69, 192],
        ...,
        [  3,  68, 186],
        [  3,  68, 186],
        [  3,  68, 186]],

       [[  5,  69, 192],
        [  5,  69, 192],
        [  5,  69, 192],
        ...,
        [  3,  68, 186],
        [  3,  68, 186],
        [  3,  68, 186]],

       ...,

       [[  3,  50, 154],
        [  3,  50, 154],
        [  1,  48, 152],
        ...,
        [175, 184, 151],
        [173, 190, 159],
        [131, 153, 121]],

       [[  3,  50, 154],
        [  3,  50, 154],
        [  1,  48, 152],
        ...,
        [169, 178, 146],
        [190, 207, 175],
        [162, 184, 151]],

       [[  0,  52, 148],
        [  0,  52, 148],
        [  1,  48, 152],
        ...,
        [157, 175, 145],
        [165, 185, 155],
        [189, 207, 176]]], dtype=uint8)]"
Image_34.jpg,657,290,300,328,1600,1000,957,618,328,daskShared_local/images/Image_34.jpg,34,"[array([[[  0,  71, 163],
        [  0,  71, 163],
        [  0,  71, 163],
        ...,
        [  1,  68, 159],
        [  1,  68, 159],
        [  1,  68, 159]],

       [[  1,  70, 163],
        [  0,  69, 162],
        [  0,  69, 162],
        ...,
        [  1,  68, 159],
        [  1,  68, 159],
        [  1,  68, 159]],

       [[  1,  70, 163],
        [  0,  69, 162],
        [  0,  69, 162],
        ...,
        [  0,  67, 158],
        [  1,  68, 159],
        [  1,  68, 159]],

       ...,

       [[ 26,  38,  23],
        [ 27,  44,  27],
        [ 44,  54,  39],
        ...,
        [128, 111,  75],
        [148, 134,  96],
        [158, 147, 110]],

       [[ 28,  40,  23],
        [ 50,  67,  49],
        [ 79,  89,  77],
        ...,
        [120, 102,  68],
        [154, 142, 102],
        [179, 174, 128]],

       [[ 56,  69,  51],
        [ 73,  90,  69],
        [ 71,  81,  66],
        ...,
        [122, 108,  75],
        [119, 110,  73],
        [141, 138,  97]]], dtype=uint8)]"
Image_340.jpg,474,126,274,319,1600,1019,748,445,319,daskShared_local/images/Image_340.jpg,340,"[array([[[ 30, 107, 213],
        [ 30, 107, 213],
        [ 30, 107, 213],
        ...,
        [ 28, 116, 213],
        [ 28, 116, 213],
        [ 28, 116, 213]],

       [[ 26, 109, 213],
        [ 26, 109, 213],
        [ 26, 109, 213],
        ...,
        [ 28, 116, 213],
        [ 28, 116, 213],
        [ 28, 116, 213]],

       [[ 26, 109, 213],
        [ 26, 109, 213],
        [ 26, 109, 213],
        ...,
        [ 28, 116, 213],
        [ 28, 116, 213],
        [ 28, 116, 213]],

       ...,

       [[249, 251, 241],
        [243, 245, 234],
        [224, 226, 215],
        ...,
        [ 78,  40,  34],
        [109,  44,  47],
        [139,  80,  81]],

       [[253, 253, 247],
        [235, 236, 228],
        [214, 216, 204],
        ...,
        [ 95,  36,  34],
        [110,  25,  30],
        [112,  34,  37]],

       [[253, 253, 249],
        [233, 234, 226],
        [216, 218, 206],
        ...,
        [106,  30,  30],
        [155,  54,  59],
        [155,  61,  64]]], dtype=uint8)]"
Image_341.jpg,367,23,147,126,550,380,514,149,147,daskShared_local/images/Image_341.jpg,341,"[array([[[ 75,  95, 150],
        [ 77,  96, 151],
        [ 78,  98, 151],
        ...,
        [ 69,  84, 143],
        [ 68,  83, 142],
        [ 69,  84, 143]],

       [[ 76,  95, 151],
        [ 77,  96, 150],
        [ 77,  97, 150],
        ...,
        [ 69,  84, 143],
        [ 68,  83, 142],
        [ 69,  84, 143]],

       [[ 76,  95, 151],
        [ 76,  96, 150],
        [ 76,  96, 149],
        ...,
        [ 69,  84, 143],
        [ 68,  83, 142],
        [ 69,  84, 143]],

       ...,

       [[151, 136, 105],
        [164, 147, 115],
        [169, 151, 119],
        ...,
        [ 64,  78, 139],
        [ 64,  78, 139],
        [ 64,  78, 139]],

       [[148, 133, 105],
        [150, 131, 102],
        [160, 140, 109],
        ...,
        [ 65,  79, 140],
        [ 64,  78, 139],
        [ 64,  78, 139]],

       [[150, 134, 109],
        [141, 122,  93],
        [150, 130,  99],
        ...,
        [ 65,  79, 140],
        [ 65,  79, 140],
        [ 65,  79, 140]]], dtype=uint8)]"
Image_342.jpg,427,1016,790,581,4601,3200,1217,1597,790,daskShared_local/images/Image_342.jpg,342,"[array([[[ 34, 165, 243],
        [ 25, 153, 229],
        [ 28, 161, 241],
        ...,
        [ 48, 162, 234],
        [ 52, 160, 229],
        [ 62, 170, 241]],

       [[ 34, 163, 240],
        [ 31, 157, 234],
        [ 30, 165, 246],
        ...,
        [ 48, 160, 235],
        [ 51, 158, 228],
        [ 56, 159, 233]],

       [[ 27, 159, 233],
        [ 29, 166, 237],
        [ 28, 167, 245],
        ...,
        [ 53, 167, 237],
        [ 53, 161, 231],
        [ 51, 152, 221]],

       ...,

       [[ 38, 164, 223],
        [ 35, 159, 217],
        [ 28, 158, 223],
        ...,
        [ 49, 157, 219],
        [ 48, 155, 216],
        [ 42, 146, 206]],

       [[ 24, 161, 214],
        [ 26, 162, 211],
        [ 21, 156, 217],
        ...,
        [ 45, 154, 211],
        [ 48, 157, 216],
        [ 51, 164, 225]],

       [[ 28, 154, 209],
        [ 33, 161, 214],
        [ 28, 157, 219],
        ...,
        [ 40, 148, 206],
        [ 44, 153, 213],
        [ 41, 152, 211]]], dtype=uint8)]"
Image_343.jpg,515,82,144,192,1200,630,659,274,192,daskShared_local/images/Image_343.jpg,343,"[array([[[  2, 155, 222],
        [  2, 155, 222],
        [  2, 155, 222],
        ...,
        [  3, 155, 222],
        [  3, 155, 222],
        [  3, 155, 222]],

       [[  2, 155, 222],
        [  2, 155, 222],
        [  2, 155, 222],
        ...,
        [  3, 155, 222],
        [  3, 155, 222],
        [  3, 155, 222]],

       [[  2, 155, 222],
        [  2, 155, 222],
        [  2, 155, 222],
        ...,
        [  3, 155, 222],
        [  3, 155, 222],
        [  3, 155, 222]],

       ...,

       [[ 20,  10,  19],
        [ 26,  15,  23],
        [ 23,  13,  19],
        ...,
        [  4,  83, 122],
        [  2,  81, 120],
        [  0,  78, 116]],

       [[  9,   1,   3],
        [ 23,  10,  19],
        [ 28,  15,  24],
        ...,
        [  1,  81, 118],
        [  0,  82, 119],
        [  2,  84, 121]],

       [[ 22,   9,  16],
        [ 30,  17,  26],
        [ 28,  15,  24],
        ...,
        [  0,  79, 116],
        [  0,  80, 117],
        [  1,  83, 120]]], dtype=uint8)]"
Image_344.jpg,215,39,206,166,900,521,421,205,206,daskShared_local/images/Image_344.jpg,344,"[array([[[ 17,  59, 171],
        [ 17,  59, 171],
        [ 17,  59, 171],
        ...,
        [ 32,  69, 184],
        [ 32,  69, 184],
        [ 32,  69, 184]],

       [[ 17,  59, 171],
        [ 17,  59, 171],
        [ 17,  59, 171],
        ...,
        [ 32,  69, 184],
        [ 32,  69, 184],
        [ 32,  69, 184]],

       [[ 17,  59, 171],
        [ 17,  59, 171],
        [ 17,  59, 171],
        ...,
        [ 32,  69, 184],
        [ 32,  69, 184],
        [ 32,  69, 184]],

       ...,

       [[  3,  53, 138],
        [  3,  53, 140],
        [  3,  53, 140],
        ...,
        [205, 222, 216],
        [211, 228, 222],
        [208, 225, 219]],

       [[  3,  53, 138],
        [  3,  53, 140],
        [  3,  53, 140],
        ...,
        [207, 224, 218],
        [215, 232, 226],
        [211, 228, 222]],

       [[  2,  52, 139],
        [  0,  54, 142],
        [  0,  54, 142],
        ...,
        [216, 233, 227],
        [222, 238, 234],
        [218, 234, 231]]], dtype=uint8)]"
Image_345.png,379,59,175,144,600,600,554,203,175,daskShared_local/images/Image_345.png,345,"[array([[[  1, 101, 247],
        [  0, 101, 246],
        [  0, 101, 246],
        ...,
        [  0, 118, 254],
        [  0, 118, 254],
        [  0, 118, 254]],

       [[  0, 102, 248],
        [  0, 101, 246],
        [  0, 102, 247],
        ...,
        [  0, 117, 255],
        [  1, 117, 254],
        [  1, 117, 254]],

       [[  1, 103, 250],
        [  0, 102, 249],
        [  0, 104, 249],
        ...,
        [  0, 117, 255],
        [  1, 117, 254],
        [  1, 117, 254]],

       ...,

       [[184, 218, 226],
        [141, 146, 178],
        [127,  92,  65],
        ...,
        [240, 254, 230],
        [239, 253, 235],
        [239, 251, 235]],

       [[121, 147, 160],
        [ 81,  90, 116],
        [126, 120,  62],
        ...,
        [240, 254, 231],
        [241, 254, 234],
        [241, 253, 231]],

       [[179, 168, 147],
        [141, 114,  88],
        [158, 145,  82],
        ...,
        [240, 252, 232],
        [241, 254, 226],
        [242, 253, 222]]], dtype=uint8)]"
Image_346.png,211,6,363,420,860,460,574,426,420,daskShared_local/images/Image_346.png,346,"[array([[[ 86,  90,  63],
        [ 74,  76,  54],
        [ 58,  60,  50],
        ...,
        [ 17, 200, 187],
        [ 16, 217, 201],
        [ 16, 216, 208]],

       [[ 64,  66,  56],
        [ 66,  67,  54],
        [ 61,  62,  55],
        ...,
        [ 27, 187, 183],
        [ 23, 192, 190],
        [ 12, 206, 203]],

       [[ 59,  62,  56],
        [ 59,  61,  52],
        [ 57,  60,  51],
        ...,
        [ 16, 185, 184],
        [ 17, 217, 213],
        [ 12, 209, 209]],

       ...,

       [[ 60, 105, 108],
        [ 59, 106, 109],
        [ 67, 115, 118],
        ...,
        [ 43, 167, 181],
        [ 40, 170, 184],
        [ 36, 168, 184]],

       [[ 68, 115, 117],
        [ 67, 115, 117],
        [ 61, 108, 110],
        ...,
        [ 44, 164, 180],
        [ 40, 165, 180],
        [ 40, 167, 182]],

       [[ 67, 117, 118],
        [ 64, 112, 113],
        [ 66, 113, 114],
        ...,
        [ 44, 164, 180],
        [ 43, 164, 180],
        [ 43, 164, 181]]], dtype=uint8)]"
Image_347.jpg,402,7,75,58,530,180,477,65,75,daskShared_local/images/Image_347.jpg,347,"[array([[[  5,  20,  65],
        [  3,  18,  63],
        [  6,  22,  66],
        ...,
        [ 17,  31,  76],
        [  3,  18,  61],
        [ 12,  26,  71]],

       [[  5,  21,  65],
        [  3,  18,  63],
        [  6,  22,  66],
        ...,
        [ 16,  30,  76],
        [  3,  17,  64],
        [ 11,  25,  72]],

       [[  4,  20,  65],
        [  3,  17,  63],
        [  5,  22,  67],
        ...,
        [ 18,  32,  75],
        [  3,  18,  60],
        [ 13,  27,  70]],

       ...,

       [[209, 144,  93],
        [201, 129,  81],
        [213, 152,  99],
        ...,
        [ 59,  53,  66],
        [ 53,  44,  61],
        [ 57,  50,  64]],

       [[233, 189, 133],
        [227, 175, 125],
        [237, 197, 138],
        ...,
        [ 72,  68,  80],
        [ 62,  57,  75],
        [ 69,  64,  78]],

       [[217, 158, 106],
        [209, 144,  96],
        [221, 167, 112],
        ...,
        [ 63,  58,  70],
        [ 56,  48,  65],
        [ 61,  54,  68]]], dtype=uint8)]"
Image_348.jpg,358,125,201,183,1280,720,559,308,201,daskShared_local/images/Image_348.jpg,348,"[array([[[  9, 105, 192],
        [  8, 104, 191],
        [ 13, 109, 196],
        ...,
        [ 19, 130, 212],
        [ 19, 130, 212],
        [ 19, 130, 212]],

       [[ 11, 105, 193],
        [  9, 105, 192],
        [ 14, 110, 197],
        ...,
        [ 21, 132, 214],
        [ 20, 131, 213],
        [ 20, 131, 213]],

       [[ 14, 108, 196],
        [ 12, 106, 194],
        [ 14, 110, 197],
        ...,
        [ 16, 127, 209],
        [ 16, 127, 209],
        [ 19, 130, 212]],

       ...,

       [[ 10,  80, 168],
        [ 12,  82, 170],
        [  6,  76, 164],
        ...,
        [178, 171, 143],
        [105,  96,  63],
        [ 77,  69,  30]],

       [[  9,  79, 167],
        [ 11,  81, 169],
        [  8,  78, 166],
        ...,
        [ 99,  93,  67],
        [ 89,  83,  53],
        [ 91,  85,  50]],

       [[  9,  79, 167],
        [ 11,  81, 169],
        [ 13,  83, 171],
        ...,
        [150, 148, 125],
        [153, 149, 123],
        [105, 101,  72]]], dtype=uint8)]"
Image_349.png,386,189,309,277,900,600,695,466,309,daskShared_local/images/Image_349.png,349,"[array([[[114,  94,  90],
        [122, 104,  93],
        [119, 110, 105],
        ...,
        [ 25, 147, 180],
        [ 19, 149, 177],
        [ 16, 151, 180]],

       [[115, 104,  94],
        [129, 109,  99],
        [126, 108, 104],
        ...,
        [ 20, 150, 179],
        [ 21, 148, 180],
        [ 22, 149, 181]],

       [[117, 115,  99],
        [121, 111,  93],
        [121, 109, 101],
        ...,
        [ 20, 149, 179],
        [ 19, 151, 178],
        [ 23, 150, 181]],

       ...,

       [[ 77, 121,  95],
        [ 61, 120,  88],
        [ 46, 113,  95],
        ...,
        [ 73, 150, 138],
        [ 78, 149, 137],
        [ 81, 153, 139]],

       [[ 35,  94,  88],
        [ 25,  78,  77],
        [ 20,  68,  78],
        ...,
        [ 73, 147, 140],
        [ 73, 149, 139],
        [ 80, 149, 141]],

       [[ 21,  66,  64],
        [ 24,  64,  60],
        [ 20,  60,  59],
        ...,
        [ 81, 145, 138],
        [ 78, 146, 136],
        [ 76, 150, 140]]], dtype=uint8)]"
Image_35.jpg,358,130,228,187,1280,720,586,317,228,daskShared_local/images/Image_35.jpg,35,"[array([[[ 16, 112, 199],
        [ 16, 112, 199],
        [ 15, 111, 198],
        ...,
        [ 12, 134, 209],
        [ 13, 135, 210],
        [ 13, 135, 210]],

       [[ 14, 110, 197],
        [ 11, 108, 195],
        [ 12, 109, 196],
        ...,
        [ 16, 136, 211],
        [ 18, 137, 212],
        [ 16, 136, 211]],

       [[ 22, 118, 205],
        [ 16, 114, 201],
        [ 13, 111, 198],
        ...,
        [ 24, 136, 212],
        [ 23, 135, 211],
        [ 22, 134, 210]],

       ...,

       [[ 10,  75, 167],
        [ 12,  77, 169],
        [ 14,  79, 171],
        ...,
        [  8,   7,   5],
        [ 36,  32,  27],
        [138, 132, 121]],

       [[ 10,  75, 165],
        [ 10,  74, 165],
        [ 12,  77, 167],
        ...,
        [ 23,  25,  15],
        [ 97,  98,  86],
        [111, 111,  98]],

       [[ 13,  77, 167],
        [ 11,  75, 165],
        [ 12,  76, 166],
        ...,
        [ 84,  86,  74],
        [121, 123, 110],
        [ 65,  67,  53]]], dtype=uint8)]"
Image_350.jpg,912,452,674,529,3008,2000,1586,981,674,daskShared_local/images/Image_350.jpg,350,"[array([[[148, 187, 194],
        [148, 187, 194],
        [148, 187, 194],
        ...,
        [135, 177, 189],
        [135, 177, 189],
        [135, 177, 189]],

       [[148, 187, 194],
        [148, 187, 194],
        [148, 187, 194],
        ...,
        [137, 179, 191],
        [137, 179, 191],
        [136, 178, 190]],

       [[148, 187, 194],
        [148, 187, 194],
        [148, 187, 194],
        ...,
        [137, 179, 191],
        [137, 179, 191],
        [136, 178, 190]],

       ...,

       [[116, 169, 177],
        [116, 169, 177],
        [116, 169, 177],
        ...,
        [ 59,  78,  82],
        [ 52,  71,  75],
        [ 52,  67,  75]],

       [[115, 168, 176],
        [115, 168, 176],
        [115, 168, 176],
        ...,
        [ 79,  98, 102],
        [ 72,  91,  95],
        [ 72,  87,  96]],

       [[115, 168, 176],
        [115, 168, 176],
        [116, 169, 177],
        ...,
        [ 84, 103, 107],
        [ 77,  96, 100],
        [ 75,  90,  99]]], dtype=uint8)]"
Image_351.jpg,105,261,159,106,900,600,264,367,159,daskShared_local/images/Image_351.jpg,351,"[array([[[  3,  81,  94],
        [  1,  80,  93],
        [  0,  81,  96],
        ...,
        [ 95, 165, 170],
        [ 85, 155, 156],
        [ 70, 140, 139]],

       [[  3,  82,  91],
        [  1,  80,  89],
        [  0,  79,  89],
        ...,
        [ 71, 143, 150],
        [ 70, 142, 145],
        [ 61, 134, 135]],

       [[  3,  84,  89],
        [  1,  80,  86],
        [  0,  77,  83],
        ...,
        [ 40, 115, 123],
        [ 45, 121, 127],
        [ 44, 120, 123]],

       ...,

       [[  0,  65,  79],
        [  0,  65,  78],
        [  0,  65,  78],
        ...,
        [  7,  36,  36],
        [  9,  38,  39],
        [ 12,  41,  42]],

       [[  1,  66,  78],
        [  1,  67,  79],
        [  1,  67,  79],
        ...,
        [  5,  34,  32],
        [  7,  37,  36],
        [ 10,  40,  40]],

       [[  2,  66,  78],
        [  3,  67,  79],
        [  2,  67,  79],
        ...,
        [  6,  35,  33],
        [  7,  37,  36],
        [ 10,  40,  40]]], dtype=uint8)]"
Image_352.jpg,386,320,310,242,1904,803,696,562,310,daskShared_local/images/Image_352.jpg,352,"[array([[[  0,  52, 108],
        [  1,  53, 110],
        [  1,  53, 111],
        ...,
        [ 40, 149, 129],
        [ 24, 133, 117],
        [ 27, 135, 126]],

       [[  1,  51, 106],
        [  2,  51, 107],
        [  3,  53, 109],
        ...,
        [ 57, 156, 145],
        [ 28, 145, 131],
        [ 26, 155, 140]],

       [[  1,  50, 106],
        [  2,  51, 107],
        [  3,  52, 108],
        ...,
        [ 64, 161, 152],
        [ 38, 154, 141],
        [ 37, 165, 149]],

       ...,

       [[  5,   4,   5],
        [  4,   5,  17],
        [  2,   4,  32],
        ...,
        [  1,  57,  90],
        [  4,  74, 103],
        [ 13,  93, 116]],

       [[  5,   1,   5],
        [  5,   5,  21],
        [  1,   6,  46],
        ...,
        [  0,  60, 104],
        [  4,  80, 115],
        [ 11,  96, 124]],

       [[  0,   3,  12],
        [  0,   6,  28],
        [  0,  13,  56],
        ...,
        [  0,  67, 106],
        [  6,  85, 116],
        [ 12, 100, 124]]], dtype=uint8)]"
Image_353.jpg,414,132,116,89,759,422,530,221,116,daskShared_local/images/Image_353.jpg,353,"[array([[[147, 217, 218],
        [147, 217, 218],
        [148, 218, 219],
        ...,
        [  0, 131, 149],
        [  0, 135, 152],
        [  0, 136, 153]],

       [[146, 216, 216],
        [144, 214, 215],
        [140, 210, 211],
        ...,
        [  0, 131, 148],
        [  0, 134, 152],
        [  0, 135, 153]],

       [[140, 210, 212],
        [134, 204, 206],
        [114, 184, 186],
        ...,
        [  0, 130, 147],
        [  0, 134, 151],
        [  0, 135, 152]],

       ...,

       [[  0, 155, 185],
        [  0, 155, 185],
        [  0, 155, 185],
        ...,
        [  2, 141, 164],
        [  1, 140, 163],
        [  1, 140, 163]],

       [[  0, 155, 186],
        [  0, 155, 186],
        [  0, 155, 186],
        ...,
        [  3, 140, 162],
        [  2, 140, 162],
        [  2, 139, 162]],

       [[  0, 155, 186],
        [  0, 155, 186],
        [  0, 155, 186],
        ...,
        [  3, 139, 162],
        [  3, 139, 161],
        [  3, 139, 161]]], dtype=uint8)]"
Image_354.jpg,69,86,203,158,640,427,272,244,203,daskShared_local/images/Image_354.jpg,354,"[array([[[182, 233, 224],
        [186, 236, 227],
        [190, 237, 231],
        ...,
        [143, 222, 217],
        [142, 221, 218],
        [140, 220, 217]],

       [[183, 234, 225],
        [185, 235, 226],
        [188, 235, 227],
        ...,
        [140, 219, 214],
        [139, 218, 215],
        [137, 217, 214]],

       [[183, 235, 223],
        [185, 235, 224],
        [187, 234, 224],
        ...,
        [138, 217, 214],
        [138, 217, 214],
        [138, 217, 214]],

       ...,

       [[101, 181, 190],
        [ 99, 179, 188],
        [ 99, 177, 187],
        ...,
        [ 94, 133, 128],
        [ 93, 128, 122],
        [ 90, 125, 121]],

       [[102, 180, 190],
        [100, 178, 188],
        [ 99, 177, 187],
        ...,
        [ 84, 121, 119],
        [ 94, 130, 126],
        [ 85, 119, 118]],

       [[102, 181, 188],
        [101, 178, 186],
        [100, 177, 185],
        ...,
        [ 73, 107, 109],
        [ 90, 124, 125],
        [ 83, 117, 118]]], dtype=uint8)]"
Image_355.jpg,251,217,129,130,775,518,380,347,130,daskShared_local/images/Image_355.jpg,355,"[array([[[206, 179, 168],
        [191, 165, 153],
        [164, 138, 125],
        ...,
        [137, 113,  83],
        [125,  99,  71],
        [116,  90,  63]],

       [[191, 164, 153],
        [178, 152, 140],
        [157, 131, 118],
        ...,
        [133, 109,  80],
        [129, 103,  77],
        [124,  98,  73]],

       [[163, 135, 124],
        [155, 128, 116],
        [145, 119, 106],
        ...,
        [120,  97,  71],
        [129, 105,  80],
        [132, 107,  83]],

       ...,

       [[132, 107,  63],
        [138, 113,  68],
        [150, 123,  78],
        ...,
        [207, 169, 133],
        [217, 179, 143],
        [225, 187, 151]],

       [[124,  99,  54],
        [139, 113,  68],
        [163, 136,  91],
        ...,
        [207, 169, 133],
        [217, 178, 142],
        [223, 184, 148]],

       [[120,  96,  50],
        [139, 114,  69],
        [170, 143,  98],
        ...,
        [208, 170, 133],
        [216, 177, 140],
        [220, 181, 145]]], dtype=uint8)]"
Image_356.jpg,108,80,92,59,475,264,200,139,92,daskShared_local/images/Image_356.jpg,356,"[array([[[ 22,  42,  60],
        [ 22,  42,  60],
        [ 22,  42,  59],
        ...,
        [ 54,  81, 110],
        [ 49,  77, 105],
        [ 49,  78, 106]],

       [[ 22,  43,  61],
        [ 22,  43,  61],
        [ 22,  42,  60],
        ...,
        [ 55,  82, 111],
        [ 49,  78, 106],
        [ 50,  79, 107]],

       [[ 23,  40,  58],
        [ 23,  40,  59],
        [ 22,  40,  57],
        ...,
        [ 48,  75, 103],
        [ 44,  71,  99],
        [ 45,  72,  99]],

       ...,

       [[ 11,  20,  29],
        [ 11,  20,  29],
        [ 12,  21,  30],
        ...,
        [ 36,  53,  59],
        [ 31,  45,  51],
        [ 32,  47,  53]],

       [[ 11,  20,  29],
        [ 11,  20,  29],
        [ 12,  21,  30],
        ...,
        [ 41,  58,  65],
        [ 37,  52,  58],
        [ 38,  53,  59]],

       [[ 11,  20,  29],
        [ 11,  20,  29],
        [ 12,  21,  30],
        ...,
        [ 40,  58,  64],
        [ 36,  51,  57],
        [ 37,  52,  58]]], dtype=uint8)]"
Image_357.jpg,218,211,131,146,800,600,349,357,146,daskShared_local/images/Image_357.jpg,357,"[array([[[ 74, 189, 210],
        [ 73, 188, 210],
        [ 72, 188, 209],
        ...,
        [ 28, 166, 195],
        [ 28, 166, 195],
        [ 29, 167, 196]],

       [[ 73, 188, 210],
        [ 72, 188, 210],
        [ 71, 187, 209],
        ...,
        [ 27, 166, 195],
        [ 28, 166, 195],
        [ 28, 166, 195]],

       [[ 70, 188, 210],
        [ 70, 187, 210],
        [ 69, 186, 209],
        ...,
        [ 26, 166, 194],
        [ 26, 166, 194],
        [ 25, 166, 194]],

       ...,

       [[ 11, 144, 149],
        [ 12, 144, 148],
        [ 13, 143, 147],
        ...,
        [223, 197, 145],
        [228, 202, 160],
        [231, 205, 175]],

       [[ 15, 143, 145],
        [ 14, 142, 143],
        [ 15, 141, 142],
        ...,
        [224, 197, 150],
        [228, 203, 158],
        [227, 205, 157]],

       [[ 18, 143, 143],
        [ 17, 141, 140],
        [ 16, 139, 138],
        ...,
        [227, 198, 156],
        [230, 205, 159],
        [226, 205, 145]]], dtype=uint8)]"
Image_358.jpg,1883,623,1199,1160,4752,3168,3082,1783,1199,daskShared_local/images/Image_358.jpg,358,"[array([[[ 67,  61,  33],
        [ 71,  64,  38],
        [ 74,  66,  39],
        ...,
        [ 48, 120, 148],
        [ 49, 120, 148],
        [ 50, 121, 148]],

       [[ 69,  62,  35],
        [ 73,  66,  39],
        [ 76,  69,  39],
        ...,
        [ 43, 117, 147],
        [ 43, 117, 147],
        [ 45, 118, 149]],

       [[ 76,  69,  39],
        [ 80,  72,  42],
        [ 77,  67,  41],
        ...,
        [ 42, 116, 147],
        [ 42, 117, 148],
        [ 42, 117, 149]],

       ...,

       [[  8,  96, 141],
        [  6,  97, 141],
        [  3,  96, 140],
        ...,
        [138, 117,  87],
        [119,  97,  74],
        [102,  83,  70]],

       [[ 12,  97, 141],
        [ 11,  97, 141],
        [  9,  98, 141],
        ...,
        [170, 154, 116],
        [143, 124,  96],
        [111,  95,  79]],

       [[ 15, 100, 141],
        [ 20, 100, 142],
        [ 19, 101, 142],
        ...,
        [189, 176, 135],
        [160, 148, 117],
        [115, 102,  87]]], dtype=uint8)]"
Image_359.jpg,538,234,162,191,990,681,700,425,191,daskShared_local/images/Image_359.jpg,359,"[array([[[ 40,  37,  22],
        [ 37,  34,  19],
        [ 33,  30,  15],
        ...,
        [ 27,  19,   8],
        [ 29,  17,   3],
        [ 31,  18,   1]],

       [[ 40,  37,  22],
        [ 39,  36,  21],
        [ 36,  33,  18],
        ...,
        [ 35,  27,  11],
        [ 37,  25,   8],
        [ 39,  25,   6]],

       [[ 37,  34,  19],
        [ 37,  34,  19],
        [ 37,  34,  19],
        ...,
        [ 37,  31,   9],
        [ 40,  29,   7],
        [ 44,  29,   6]],

       ...,

       [[126, 118,  81],
        [130, 122,  83],
        [130, 123,  81],
        ...,
        [ 49,  56,  40],
        [ 53,  58,  43],
        [ 54,  58,  41]],

       [[124, 119,  81],
        [131, 126,  87],
        [125, 120,  80],
        ...,
        [ 44,  51,  35],
        [ 48,  55,  39],
        [ 52,  56,  39]],

       [[169, 164, 126],
        [131, 126,  86],
        [ 92,  87,  47],
        ...,
        [ 41,  48,  32],
        [ 46,  53,  36],
        [ 55,  62,  44]]], dtype=uint8)]"
Image_36.jpg,452,283,161,164,850,567,613,447,164,daskShared_local/images/Image_36.jpg,36,"[array([[[ 90,  57,  45],
        [106,  69,  60],
        [146,  99,  87],
        ...,
        [103,  93, 120],
        [ 54,  58,  87],
        [ 41,  59,  76]],

       [[108,  69,  63],
        [142, 101,  91],
        [191, 138, 121],
        ...,
        [ 96,  79, 103],
        [ 51,  53,  83],
        [ 37,  55,  78]],

       [[145,  94,  95],
        [168, 116, 110],
        [192, 135, 116],
        ...,
        [108,  84,  89],
        [ 80,  75,  90],
        [ 52,  63,  88]],

       ...,

       [[  8, 122, 234],
        [  8, 122, 234],
        [  8, 122, 234],
        ...,
        [ 10, 128, 233],
        [ 10, 128, 233],
        [  9, 128, 233]],

       [[  8, 122, 234],
        [  9, 123, 235],
        [  9, 123, 235],
        ...,
        [  9, 127, 233],
        [  9, 127, 233],
        [ 10, 128, 234]],

       [[  8, 122, 234],
        [  9, 123, 235],
        [  9, 123, 235],
        ...,
        [  9, 127, 233],
        [  9, 127, 233],
        [ 10, 128, 234]]], dtype=uint8)]"
Image_360.jpg,993,139,242,328,1686,1216,1235,467,328,daskShared_local/images/Image_360.jpg,360,"[array([[[128, 185, 215],
        [126, 183, 213],
        [125, 182, 212],
        ...,
        [161, 201, 226],
        [161, 201, 226],
        [161, 201, 226]],

       [[125, 182, 212],
        [124, 181, 211],
        [124, 181, 211],
        ...,
        [160, 200, 225],
        [160, 200, 225],
        [160, 200, 225]],

       [[123, 180, 210],
        [122, 179, 209],
        [124, 181, 211],
        ...,
        [160, 200, 225],
        [160, 200, 225],
        [160, 200, 225]],

       ...,

       [[133, 159, 124],
        [130, 162, 125],
        [140, 176, 142],
        ...,
        [ 90, 166, 202],
        [ 90, 166, 202],
        [ 90, 166, 202]],

       [[149, 165, 128],
        [141, 161, 126],
        [143, 170, 139],
        ...,
        [ 84, 164, 201],
        [ 85, 165, 202],
        [ 86, 166, 203]],

       [[149, 166, 130],
        [141, 162, 128],
        [141, 169, 138],
        ...,
        [ 88, 168, 205],
        [ 90, 170, 207],
        [ 89, 169, 206]]], dtype=uint8)]"
Image_361.jpg,257,386,840,653,1512,1231,1097,1039,840,daskShared_local/images/Image_361.jpg,361,"[array([[[ 73,  85,  74],
        [ 75,  87,  77],
        [ 79,  92,  83],
        ...,
        [103, 130, 101],
        [105, 136, 103],
        [ 90, 125,  91]],

       [[ 72,  84,  70],
        [ 73,  87,  75],
        [ 77,  93,  83],
        ...,
        [ 89, 117,  90],
        [109, 137, 108],
        [ 96, 129,  97]],

       [[ 71,  83,  70],
        [ 74,  88,  76],
        [ 76,  91,  81],
        ...,
        [ 81, 111,  85],
        [101, 129, 100],
        [102, 133, 101]],

       ...,

       [[255, 240, 215],
        [255, 241, 215],
        [255, 241, 215],
        ...,
        [237, 214, 179],
        [239, 211, 169],
        [227, 192, 147]],

       [[254, 237, 216],
        [254, 239, 215],
        [255, 240, 214],
        ...,
        [236, 212, 171],
        [236, 212, 171],
        [228, 200, 160]],

       [[254, 237, 215],
        [253, 237, 214],
        [254, 237, 215],
        ...,
        [233, 209, 167],
        [231, 207, 169],
        [236, 213, 179]]], dtype=uint8)]"
Image_362.jpg,777,265,326,302,1200,906,1103,567,326,daskShared_local/images/Image_362.jpg,362,"[array([[[122, 112, 123],
        [ 93,  87, 101],
        [ 59,  56,  72],
        ...,
        [ 25,  54,  76],
        [ 28,  56,  78],
        [ 26,  54,  76]],

       [[115, 106, 117],
        [ 69,  65,  79],
        [ 58,  56,  73],
        ...,
        [ 25,  53,  75],
        [ 27,  55,  77],
        [ 27,  53,  76]],

       [[157, 155, 180],
        [ 85,  85, 114],
        [ 58,  56,  82],
        ...,
        [ 18,  52,  72],
        [ 19,  51,  72],
        [ 20,  51,  72]],

       ...,

       [[ 52,  69,  84],
        [ 51,  69,  83],
        [ 47,  66,  80],
        ...,
        [ 36,  67,  82],
        [ 33,  66,  81],
        [ 37,  72,  85]],

       [[ 55,  72,  88],
        [ 54,  71,  87],
        [ 52,  71,  86],
        ...,
        [ 33,  61,  82],
        [ 31,  62,  82],
        [ 34,  65,  85]],

       [[ 51,  69,  85],
        [ 51,  70,  85],
        [ 49,  70,  84],
        ...,
        [ 25,  57,  77],
        [ 26,  58,  77],
        [ 30,  64,  83]]], dtype=uint8)]"
Image_363.jpg,2423,897,620,571,3840,2160,3043,1468,620,daskShared_local/images/Image_363.jpg,363,"[array([[[174, 157, 141],
        [125, 106,  92],
        [119,  96,  85],
        ...,
        [  0, 131, 178],
        [  0, 131, 178],
        [  1, 134, 178]],

       [[103,  85,  69],
        [110,  91,  76],
        [148, 126, 113],
        ...,
        [  1, 130, 179],
        [  0, 130, 179],
        [  0, 133, 176]],

       [[112,  94,  77],
        [124, 104,  89],
        [126, 104,  91],
        ...,
        [  2, 131, 178],
        [  1, 129, 177],
        [  1, 133, 177]],

       ...,

       [[  2, 127, 161],
        [  2, 125, 159],
        [  1, 123, 159],
        ...,
        [  0, 121, 166],
        [  0, 121, 166],
        [  3, 121, 167]],

       [[  3, 128, 161],
        [  2, 125, 159],
        [  1, 122, 157],
        ...,
        [  0, 121, 166],
        [  0, 121, 166],
        [  2, 121, 165]],

       [[  5, 132, 164],
        [  3, 127, 161],
        [  1, 124, 158],
        ...,
        [  0, 121, 166],
        [  0, 121, 166],
        [  2, 121, 164]]], dtype=uint8)]"
Image_364.jpg,479,160,229,268,981,650,708,428,268,daskShared_local/images/Image_364.jpg,364,"[array([[[244, 244, 244],
        [244, 244, 244],
        [244, 244, 244],
        ...,
        [242, 242, 242],
        [242, 242, 242],
        [242, 242, 242]],

       [[244, 244, 244],
        [244, 244, 244],
        [244, 244, 244],
        ...,
        [242, 242, 242],
        [242, 242, 242],
        [242, 242, 242]],

       [[244, 244, 244],
        [244, 244, 244],
        [244, 244, 244],
        ...,
        [242, 242, 242],
        [242, 242, 242],
        [242, 242, 242]],

       ...,

       [[ 29,  96, 175],
        [ 28,  95, 174],
        [ 26,  93, 172],
        ...,
        [ 25,  93, 174],
        [ 23,  92, 170],
        [ 21,  90, 167]],

       [[ 28,  95, 176],
        [ 27,  94, 174],
        [ 26,  93, 172],
        ...,
        [ 24,  92, 173],
        [ 22,  91, 169],
        [ 21,  90, 167]],

       [[ 27,  94, 174],
        [ 28,  95, 174],
        [ 27,  94, 173],
        ...,
        [ 23,  91, 172],
        [ 22,  91, 169],
        [ 21,  90, 168]]], dtype=uint8)]"
Image_365.jpg,498,166,96,79,660,438,594,245,96,daskShared_local/images/Image_365.jpg,365,"[array([[[  1,  16,  63],
        [  1,  16,  63],
        [  0,  15,  63],
        ...,
        [  2,  24,  54],
        [  5,  30,  63],
        [  4,  29,  62]],

       [[  1,  16,  63],
        [  1,  16,  63],
        [  0,  15,  63],
        ...,
        [  2,  23,  54],
        [  5,  30,  63],
        [  5,  29,  62]],

       [[  2,  16,  63],
        [  2,  16,  63],
        [  1,  15,  63],
        ...,
        [  1,  26,  55],
        [  3,  30,  61],
        [  3,  30,  61]],

       ...,

       [[236, 206, 139],
        [237, 208, 140],
        [214, 173, 118],
        ...,
        [ 58,  50,  54],
        [ 66,  56,  62],
        [ 65,  55,  61]],

       [[246, 219, 150],
        [247, 220, 151],
        [234, 207, 148],
        ...,
        [ 58,  50,  55],
        [ 59,  49,  57],
        [ 59,  49,  57]],

       [[245, 218, 150],
        [246, 219, 150],
        [232, 205, 146],
        ...,
        [ 58,  50,  55],
        [ 60,  49,  57],
        [ 60,  49,  57]]], dtype=uint8)]"
Image_366.jpg,734,346,170,136,1600,1000,904,482,170,daskShared_local/images/Image_366.jpg,366,"[array([[[  0,  81, 163],
        [  0,  81, 163],
        [  0,  81, 163],
        ...,
        [  0,  81, 163],
        [  0,  81, 163],
        [  0,  81, 163]],

       [[  0,  81, 163],
        [  0,  81, 163],
        [  0,  81, 163],
        ...,
        [  0,  81, 163],
        [  0,  81, 163],
        [  0,  81, 163]],

       [[  0,  81, 163],
        [  0,  81, 163],
        [  0,  81, 163],
        ...,
        [  0,  81, 163],
        [  0,  81, 163],
        [  0,  81, 163]],

       ...,

       [[  0,  68, 125],
        [  0,  68, 125],
        [  3,  71, 138],
        ...,
        [192, 166, 129],
        [185, 161, 124],
        [165, 143, 108]],

       [[  1,  81, 134],
        [  1,  81, 134],
        [ 10,  98, 149],
        ...,
        [163, 135,  98],
        [170, 144, 108],
        [174, 150, 116]],

       [[  3,  93, 140],
        [  4,  96, 141],
        [ 19, 116, 149],
        ...,
        [170, 138, 103],
        [182, 153, 119],
        [199, 173, 140]]], dtype=uint8)]"
Image_367.jpg,314,290,149,106,1280,720,463,396,149,daskShared_local/images/Image_367.jpg,367,"[array([[[  0,  60, 133],
        [  0,  60, 133],
        [  0,  60, 133],
        ...,
        [  0,  62, 139],
        [  0,  62, 139],
        [  0,  62, 139]],

       [[  0,  60, 133],
        [  0,  60, 133],
        [  0,  60, 133],
        ...,
        [  0,  62, 139],
        [  0,  62, 139],
        [  0,  62, 139]],

       [[  0,  60, 133],
        [  0,  60, 133],
        [  0,  60, 133],
        ...,
        [  0,  62, 139],
        [  0,  62, 139],
        [  0,  62, 139]],

       ...,

       [[ 39, 116, 136],
        [ 39, 116, 136],
        [ 39, 115, 136],
        ...,
        [ 25, 100, 130],
        [ 25, 100, 130],
        [ 24,  99, 129]],

       [[ 40, 116, 137],
        [ 40, 116, 137],
        [ 40, 116, 137],
        ...,
        [ 25, 100, 129],
        [ 25, 100, 129],
        [ 24,  99, 128]],

       [[ 42, 117, 138],
        [ 42, 117, 138],
        [ 42, 117, 138],
        ...,
        [ 25, 100, 129],
        [ 25, 100, 129],
        [ 25, 100, 129]]], dtype=uint8)]"
Image_368.jpg,450,218,170,191,1200,630,620,409,191,daskShared_local/images/Image_368.jpg,368,"[array([[[ 23,  95, 167],
        [ 27,  99, 171],
        [ 31, 104, 173],
        ...,
        [ 17,  48,  48],
        [ 33,  61,  64],
        [ 36,  61,  65]],

       [[ 22,  95, 164],
        [ 25,  98, 167],
        [ 26, 101, 169],
        ...,
        [ 20,  50,  50],
        [ 29,  55,  56],
        [ 41,  62,  67]],

       [[ 28, 101, 170],
        [ 28, 101, 170],
        [ 27, 102, 170],
        ...,
        [ 21,  51,  51],
        [ 24,  48,  50],
        [ 34,  53,  59]],

       ...,

       [[ 44,  92, 115],
        [ 33,  79, 103],
        [ 26,  71,  95],
        ...,
        [ 29,  29,  31],
        [ 22,  23,  25],
        [ 13,  14,  16]],

       [[ 37,  85, 108],
        [ 33,  79, 103],
        [ 34,  78, 103],
        ...,
        [ 25,  25,  27],
        [ 22,  24,  26],
        [ 21,  25,  26]],

       [[ 22,  73,  94],
        [ 31,  77, 101],
        [ 36,  81, 106],
        ...,
        [ 20,  21,  23],
        [ 14,  18,  19],
        [ 16,  20,  21]]], dtype=uint8)]"
Image_369.jpg,211,431,168,205,2015,1510,379,636,205,daskShared_local/images/Image_369.jpg,369,"[array([[[ 81,  58,  42],
        [ 93,  73,  56],
        [ 99,  83,  67],
        ...,
        [ 10,   9,   5],
        [  7,   6,   2],
        [  8,   7,   3]],

       [[ 74,  69,  50],
        [ 77,  72,  53],
        [ 77,  72,  53],
        ...,
        [ 12,   6,   6],
        [ 13,   7,   7],
        [ 14,   5,   6]],

       [[ 66,  61,  42],
        [ 67,  62,  43],
        [ 74,  69,  50],
        ...,
        [ 17,  11,  11],
        [ 18,  12,  12],
        [ 18,   9,  10]],

       ...,

       [[158, 148, 138],
        [163, 151, 139],
        [164, 152, 139],
        ...,
        [146, 150, 153],
        [131, 135, 138],
        [130, 134, 137]],

       [[163, 151, 139],
        [169, 157, 143],
        [164, 152, 137],
        ...,
        [153, 157, 160],
        [144, 148, 151],
        [137, 141, 144]],

       [[177, 165, 151],
        [174, 162, 148],
        [144, 131, 115],
        ...,
        [148, 152, 153],
        [144, 148, 149],
        [136, 140, 141]]], dtype=uint8)]"
Image_37.jpg,3378,1250,113,131,3840,2160,3491,1381,131,daskShared_local/images/Image_37.jpg,37,"[array([[[ 28, 103, 126],
        [ 29, 104, 126],
        [ 30, 104, 125],
        ...,
        [  4,  55,  56],
        [  4,  55,  56],
        [  4,  55,  56]],

       [[ 31, 105, 127],
        [ 31, 105, 127],
        [ 32, 105, 126],
        ...,
        [  4,  55,  56],
        [  4,  55,  56],
        [  4,  55,  56]],

       [[ 35, 109, 130],
        [ 35, 108, 130],
        [ 35, 107, 128],
        ...,
        [  4,  55,  56],
        [  4,  55,  56],
        [  5,  56,  57]],

       ...,

       [[  0, 113, 163],
        [  1, 113, 163],
        [  1, 113, 163],
        ...,
        [  2, 108, 156],
        [  2, 108, 156],
        [  2, 108, 156]],

       [[  0, 113, 163],
        [  0, 113, 163],
        [  1, 113, 163],
        ...,
        [  2, 108, 156],
        [  2, 108, 156],
        [  2, 108, 156]],

       [[  0, 113, 163],
        [  0, 113, 163],
        [  1, 113, 163],
        ...,
        [  2, 108, 156],
        [  2, 108, 156],
        [  2, 108, 156]]], dtype=uint8)]"
Image_370.jpg,116,386,392,322,1715,1286,508,708,392,daskShared_local/images/Image_370.jpg,370,"[array([[[145, 148, 147],
        [147, 154, 153],
        [152, 162, 158],
        ...,
        [ 42,  43,  53],
        [ 38,  40,  63],
        [ 44,  51,  72]],

       [[144, 153, 150],
        [149, 159, 154],
        [154, 165, 160],
        ...,
        [ 38,  38,  47],
        [ 40,  37,  55],
        [ 55,  51,  71]],

       [[144, 154, 151],
        [149, 160, 156],
        [152, 165, 162],
        ...,
        [ 41,  40,  43],
        [ 46,  41,  50],
        [ 83,  66,  73]],

       ...,

       [[185, 187, 187],
        [186, 188, 189],
        [183, 190, 190],
        ...,
        [193, 192, 209],
        [193, 195, 209],
        [191, 195, 209]],

       [[193, 195, 187],
        [189, 194, 185],
        [186, 190, 189],
        ...,
        [187, 195, 208],
        [189, 192, 207],
        [190, 191, 209]],

       [[188, 201, 187],
        [187, 199, 187],
        [185, 193, 191],
        ...,
        [176, 195, 204],
        [183, 192, 204],
        [186, 194, 207]]], dtype=uint8)]"
Image_371.jpg,417,165,853,653,1500,1000,1270,818,853,daskShared_local/images/Image_371.jpg,371,"[array([[[  3,  58,  65],
        [  3,  58,  65],
        [  3,  58,  65],
        ...,
        [107, 107, 153],
        [101, 101, 149],
        [ 96,  96, 144]],

       [[  3,  58,  65],
        [  3,  58,  65],
        [  3,  57,  65],
        ...,
        [ 88,  92, 141],
        [ 83,  88, 139],
        [ 77,  82, 132]],

       [[  3,  58,  65],
        [  3,  57,  65],
        [  3,  56,  64],
        ...,
        [ 79,  84, 134],
        [ 70,  76, 124],
        [ 67,  73, 114]],

       ...,

       [[104, 129, 174],
        [145, 160, 193],
        [172, 182, 201],
        ...,
        [ 57,  98,  58],
        [ 62, 103,  61],
        [ 65, 104,  60]],

       [[106, 129, 176],
        [141, 155, 191],
        [164, 176, 201],
        ...,
        [ 57,  98,  58],
        [ 61, 102,  60],
        [ 63, 105,  60]],

       [[115, 135, 177],
        [145, 158, 192],
        [162, 173, 201],
        ...,
        [ 58,  99,  59],
        [ 60, 102,  60],
        [ 62, 106,  61]]], dtype=uint8)]"
Image_372.jpg,599,83,212,173,1068,601,811,256,212,daskShared_local/images/Image_372.jpg,372,"[array([[[  0,  73, 255],
        [  2,  75, 255],
        [  0,  75, 254],
        ...,
        [  2,  87, 255],
        [  2,  87, 255],
        [  2,  87, 255]],

       [[  0,  73, 255],
        [  0,  73, 253],
        [  0,  73, 252],
        ...,
        [  2,  87, 255],
        [  2,  87, 255],
        [  2,  87, 255]],

       [[  0,  72, 254],
        [  0,  71, 251],
        [  0,  71, 251],
        ...,
        [  2,  87, 255],
        [  2,  87, 255],
        [  2,  87, 255]],

       ...,

       [[196, 201, 195],
        [173, 176, 168],
        [127, 126, 114],
        ...,
        [209, 228, 222],
        [209, 224, 226],
        [208, 220, 232]],

       [[166, 171, 167],
        [193, 195, 190],
        [145, 145, 136],
        ...,
        [212, 230, 224],
        [211, 226, 226],
        [209, 219, 229]],

       [[ 95, 100,  96],
        [ 76,  81,  77],
        [ 43,  43,  38],
        ...,
        [212, 229, 223],
        [211, 226, 226],
        [211, 220, 227]]], dtype=uint8)]"
Image_373.jpg,829,179,139,107,1080,522,968,286,139,daskShared_local/images/Image_373.jpg,373,"[array([[[ 17,  56, 177],
        [ 17,  56, 177],
        [ 16,  55, 176],
        ...,
        [ 15,  41, 138],
        [ 15,  41, 138],
        [ 15,  41, 138]],

       [[ 17,  56, 177],
        [ 17,  56, 177],
        [ 17,  56, 177],
        ...,
        [ 15,  41, 138],
        [ 15,  41, 138],
        [ 15,  41, 138]],

       [[ 17,  56, 177],
        [ 17,  56, 177],
        [ 17,  56, 177],
        ...,
        [ 15,  41, 138],
        [ 15,  41, 138],
        [ 15,  41, 138]],

       ...,

       [[206, 148, 111],
        [229, 183, 141],
        [253, 228, 190],
        ...,
        [ 16,  65, 170],
        [ 16,  65, 170],
        [ 16,  65, 170]],

       [[222, 164, 126],
        [238, 193, 152],
        [252, 229, 192],
        ...,
        [ 16,  65, 170],
        [ 16,  65, 170],
        [ 16,  65, 170]],

       [[232, 175, 136],
        [243, 200, 160],
        [252, 230, 194],
        ...,
        [ 16,  65, 170],
        [ 16,  65, 170],
        [ 16,  65, 170]]], dtype=uint8)]"
Image_374.jpg,283,128,99,118,775,518,382,246,118,daskShared_local/images/Image_374.jpg,374,"[array([[[ 85, 162, 182],
        [ 85, 162, 182],
        [ 84, 161, 181],
        ...,
        [ 93, 160, 177],
        [ 97, 164, 181],
        [ 98, 165, 182]],

       [[ 86, 163, 183],
        [ 86, 163, 183],
        [ 85, 162, 182],
        ...,
        [ 93, 160, 177],
        [ 97, 164, 181],
        [ 98, 165, 182]],

       [[ 88, 165, 185],
        [ 88, 165, 185],
        [ 87, 164, 184],
        ...,
        [ 90, 157, 174],
        [ 98, 165, 182],
        [100, 167, 184]],

       ...,

       [[169, 129, 104],
        [162, 122,  97],
        [142, 102,  77],
        ...,
        [134,  89,  66],
        [111,  69,  50],
        [103,  63,  45]],

       [[167, 126, 101],
        [166, 126, 101],
        [165, 125, 100],
        ...,
        [158, 112,  86],
        [141,  97,  78],
        [136,  92,  75]],

       [[166, 125, 100],
        [168, 127, 102],
        [173, 133, 107],
        ...,
        [166, 119,  92],
        [151, 106,  87],
        [146, 101,  85]]], dtype=uint8)]"
Image_375.jpg,110,108,401,299,800,533,511,407,401,daskShared_local/images/Image_375.jpg,375,"[array([[[  4,  11,  55],
        [  6,  13,  57],
        [ 10,  13,  57],
        ...,
        [  5,  19,  72],
        [  4,  17,  70],
        [  7,  20,  73]],

       [[  4,  11,  57],
        [  8,  13,  59],
        [ 10,  12,  59],
        ...,
        [  8,  22,  75],
        [  8,  22,  74],
        [  9,  20,  75]],

       [[  5,  11,  56],
        [  6,  13,  57],
        [  8,  11,  57],
        ...,
        [  9,  24,  76],
        [ 15,  31,  83],
        [ 10,  22,  79]],

       ...,

       [[  9,  14,  59],
        [  7,  13,  58],
        [  4,  11,  55],
        ...,
        [ 63,  50,   6],
        [ 86,  65,  23],
        [122, 100,  60]],

       [[  8,  15,  59],
        [  6,  15,  58],
        [  6,  15,  58],
        ...,
        [ 60,  50,   6],
        [ 79,  63,  19],
        [106,  88,  48]],

       [[  6,  13,  58],
        [  4,  11,  55],
        [  6,  14,  57],
        ...,
        [ 79,  72,  24],
        [ 90,  79,  33],
        [ 87,  79,  39]]], dtype=uint8)]"
Image_376.jpg,632,318,146,129,1440,960,778,447,146,daskShared_local/images/Image_376.jpg,376,"[array([[[  0, 142, 204],
        [  0, 142, 204],
        [  0, 143, 204],
        ...,
        [  2, 145, 214],
        [  1, 144, 212],
        [  1, 144, 212]],

       [[  1, 143, 205],
        [  1, 143, 205],
        [  1, 143, 205],
        ...,
        [  1, 144, 213],
        [  1, 144, 212],
        [  1, 144, 212]],

       [[  1, 144, 205],
        [  1, 144, 205],
        [  1, 144, 205],
        ...,
        [  1, 144, 212],
        [  1, 144, 213],
        [  1, 144, 213]],

       ...,

       [[ 77,  67,  46],
        [ 98,  89,  67],
        [123, 114,  92],
        ...,
        [  2,  78, 116],
        [  2,  77, 116],
        [  1,  77, 116]],

       [[ 60,  57,  39],
        [ 87,  83,  65],
        [116, 112,  95],
        ...,
        [  2,  77, 115],
        [  2,  76, 115],
        [  2,  77, 116]],

       [[ 50,  50,  34],
        [ 65,  65,  49],
        [ 84,  84,  68],
        ...,
        [  0,  76, 114],
        [  1,  75, 114],
        [  2,  76, 115]]], dtype=uint8)]"
Image_377.jpg,1022,164,2543,2576,4608,3072,3565,2740,2576,daskShared_local/images/Image_377.jpg,377,"[array([[[ 30,  30,  28],
        [ 31,  31,  30],
        [ 33,  34,  31],
        ...,
        [119, 123, 116],
        [119, 124, 117],
        [127, 131, 124]],

       [[ 28,  28,  26],
        [ 29,  30,  30],
        [ 32,  34,  32],
        ...,
        [123, 126, 119],
        [114, 118, 112],
        [114, 121, 114]],

       [[ 28,  28,  27],
        [ 31,  31,  31],
        [ 42,  45,  45],
        ...,
        [127, 130, 124],
        [118, 121, 113],
        [109, 115, 109]],

       ...,

       [[101,  84,  57],
        [102,  85,  59],
        [101,  85,  59],
        ...,
        [170, 154, 107],
        [170, 140,  76],
        [154, 117,  61]],

       [[ 99,  82,  54],
        [ 99,  82,  51],
        [ 99,  82,  54],
        ...,
        [167, 156, 119],
        [170, 155,  98],
        [172, 149,  76]],

       [[ 98,  80,  51],
        [ 97,  80,  48],
        [ 98,  81,  50],
        ...,
        [158, 147, 117],
        [155, 144, 113],
        [156, 146, 110]]], dtype=uint8)]"
Image_378.jpg,1234,1056,415,394,2592,1944,1649,1450,415,daskShared_local/images/Image_378.jpg,378,"[array([[[156, 133,  98],
        [131, 107,  74],
        [156, 130,  97],
        ...,
        [ 42, 117, 174],
        [ 40, 115, 172],
        [ 45, 121, 176]],

       [[150, 125,  89],
        [128, 101,  66],
        [169, 140, 103],
        ...,
        [ 42, 117, 174],
        [ 42, 117, 173],
        [ 43, 118, 174]],

       [[154, 125,  93],
        [144, 113,  78],
        [167, 135,  98],
        ...,
        [ 42, 117, 172],
        [ 42, 117, 172],
        [ 43, 118, 173]],

       ...,

       [[ 45, 121, 172],
        [ 46, 123, 173],
        [ 38, 118, 167],
        ...,
        [ 38, 119, 167],
        [ 39, 119, 167],
        [ 39, 120, 167]],

       [[ 41, 121, 172],
        [ 40, 120, 171],
        [ 38, 118, 168],
        ...,
        [ 39, 121, 168],
        [ 39, 121, 168],
        [ 39, 121, 168]],

       [[ 41, 121, 172],
        [ 40, 120, 171],
        [ 39, 119, 168],
        ...,
        [ 40, 122, 169],
        [ 41, 123, 170],
        [ 38, 121, 167]]], dtype=uint8)]"
Image_379.jpg,626,353,309,298,2361,1176,935,651,309,daskShared_local/images/Image_379.jpg,379,"[array([[[  9, 145, 197],
        [  8, 145, 197],
        [  9, 146, 198],
        ...,
        [ 48, 172, 210],
        [ 47, 171, 209],
        [ 45, 169, 207]],

       [[ 10, 146, 198],
        [  9, 146, 198],
        [ 10, 147, 199],
        ...,
        [ 49, 173, 211],
        [ 49, 173, 211],
        [ 48, 170, 209]],

       [[ 10, 146, 198],
        [ 10, 147, 199],
        [  9, 146, 198],
        ...,
        [ 49, 172, 210],
        [ 49, 172, 211],
        [ 49, 172, 211]],

       ...,

       [[  8, 173, 237],
        [  8, 173, 237],
        [  8, 173, 237],
        ...,
        [ 22,  60,  59],
        [ 30,  60,  63],
        [ 28,  61,  64]],

       [[  8, 173, 237],
        [  8, 173, 237],
        [  8, 173, 237],
        ...,
        [ 27,  64,  63],
        [ 31,  59,  62],
        [ 30,  60,  63]],

       [[  8, 173, 237],
        [  9, 174, 238],
        [  7, 174, 238],
        ...,
        [ 20,  65,  63],
        [ 20,  67,  68],
        [ 21,  74,  76]]], dtype=uint8)]"
Image_38.jpg,418,3,403,504,1280,720,821,507,504,daskShared_local/images/Image_38.jpg,38,"[array([[[158, 226, 237],
        [157, 227, 237],
        [154, 227, 236],
        ...,
        [ 26, 176, 203],
        [ 34, 177, 201],
        [ 59, 180, 208]],

       [[158, 226, 237],
        [158, 228, 238],
        [155, 228, 237],
        ...,
        [ 42, 178, 204],
        [ 54, 180, 206],
        [ 38, 179, 204]],

       [[161, 226, 240],
        [160, 227, 241],
        [158, 227, 239],
        ...,
        [ 49, 179, 207],
        [ 54, 180, 210],
        [ 39, 178, 205]],

       ...,

       [[ 44,  39,  29],
        [ 49,  44,  38],
        [ 78,  69,  55],
        ...,
        [  3,  75,  99],
        [  3,  75,  99],
        [  3,  75,  99]],

       [[ 64,  59,  42],
        [ 62,  55,  45],
        [ 87,  73,  61],
        ...,
        [  2,  74,  98],
        [  2,  74,  98],
        [  2,  74,  98]],

       [[110,  96,  62],
        [ 98,  84,  57],
        [ 95,  81,  62],
        ...,
        [  4,  74,  99],
        [  3,  73,  98],
        [  2,  72,  97]]], dtype=uint8)]"
Image_380.jpg,1828,2583,482,403,2720,4080,2310,2986,482,daskShared_local/images/Image_380.jpg,380,"[array([[[  5,  18,  29],
        [  7,  19,  28],
        [ 20,  35,  42],
        ...,
        [  5, 122, 193],
        [  4, 119, 191],
        [  2, 117, 189]],

       [[  2,  12,  24],
        [  4,  15,  24],
        [ 18,  33,  40],
        ...,
        [  3, 122, 192],
        [  2, 121, 190],
        [  4, 122, 193]],

       [[ 23,  35,  46],
        [ 20,  33,  42],
        [ 20,  34,  42],
        ...,
        [  3, 122, 191],
        [  3, 122, 190],
        [  2, 121, 190]],

       ...,

       [[  5, 117, 191],
        [  3, 113, 187],
        [  2, 111, 185],
        ...,
        [  4, 112, 189],
        [  2, 109, 186],
        [  5, 115, 192]],

       [[  6, 118, 192],
        [  6, 118, 192],
        [  3, 113, 187],
        ...,
        [  8, 118, 194],
        [  6, 115, 192],
        [  3, 111, 188]],

       [[  6, 116, 190],
        [  4, 113, 187],
        [  2, 113, 187],
        ...,
        [  3, 107, 182],
        [ 10, 118, 193],
        [  3, 112, 186]]], dtype=uint8)]"
Image_381.jpg,764,160,240,175,1050,700,1004,335,240,daskShared_local/images/Image_381.jpg,381,"[array([[[  2, 138, 134],
        [ 10, 133, 137],
        [ 16, 160, 157],
        ...,
        [ 12,  31,  47],
        [ 33,  49,  64],
        [ 39,  51,  65]],

       [[ 15, 171, 166],
        [  7, 134, 136],
        [ 12, 132, 134],
        ...,
        [ 16,  32,  45],
        [ 30,  44,  56],
        [ 36,  46,  58]],

       [[ 17, 178, 167],
        [  3, 130, 125],
        [  1,  92,  94],
        ...,
        [ 23,  34,  44],
        [ 29,  38,  48],
        [ 34,  43,  53]],

       ...,

       [[ 33,  47,  50],
        [ 37,  49,  53],
        [ 36,  47,  51],
        ...,
        [ 29,  23,  31],
        [ 31,  21,  36],
        [ 26,  19,  34]],

       [[ 33,  45,  49],
        [ 34,  45,  49],
        [ 32,  43,  47],
        ...,
        [ 42,  33,  43],
        [ 38,  28,  41],
        [ 23,  25,  35]],

       [[ 33,  44,  46],
        [ 31,  42,  45],
        [ 37,  47,  49],
        ...,
        [ 30,  33,  40],
        [ 39,  39,  47],
        [ 42,  38,  45]]], dtype=uint8)]"
Image_382.jpg,498,74,164,139,1024,335,662,213,164,daskShared_local/images/Image_382.jpg,382,"[array([[[ 70, 225, 242],
        [ 56, 220, 239],
        [ 37, 214, 233],
        ...,
        [  1, 178, 222],
        [  1, 178, 222],
        [  1, 178, 220]],

       [[ 29, 212, 230],
        [ 18, 210, 228],
        [ 10, 208, 228],
        ...,
        [  2, 178, 223],
        [  2, 178, 222],
        [  2, 178, 221]],

       [[ 10, 210, 232],
        [  4, 207, 230],
        [  1, 205, 229],
        ...,
        [  2, 178, 221],
        [  2, 178, 221],
        [  2, 178, 221]],

       ...,

       [[106, 113,  72],
        [129, 132,  79],
        [143, 146,  80],
        ...,
        [190, 197, 157],
        [184, 194, 154],
        [177, 188, 146]],

       [[144, 146,  84],
        [159, 163,  89],
        [167, 172,  88],
        ...,
        [192, 195, 148],
        [184, 187, 141],
        [173, 178, 131]],

       [[162, 158,  92],
        [183, 181, 105],
        [188, 187, 103],
        ...,
        [188, 190, 140],
        [179, 183, 134],
        [174, 178, 128]]], dtype=uint8)]"
Image_383.jpg,297,364,178,151,1024,683,475,515,178,daskShared_local/images/Image_383.jpg,383,"[array([[[233, 236, 216],
        [224, 227, 212],
        [212, 217, 205],
        ...,
        [100, 101, 103],
        [ 89,  90,  87],
        [ 80,  82,  74]],

       [[187, 207, 197],
        [197, 209, 198],
        [204, 209, 197],
        ...,
        [ 94, 102,  93],
        [ 91,  98,  88],
        [ 92,  97,  86]],

       [[161, 183, 179],
        [174, 189, 183],
        [186, 193, 185],
        ...,
        [ 81,  87,  77],
        [ 91,  95,  85],
        [ 97, 100,  89]],

       ...,

       [[  0, 107, 130],
        [  0, 107, 130],
        [  0, 108, 131],
        ...,
        [  0, 113, 139],
        [  0, 113, 139],
        [  0, 113, 139]],

       [[  0, 107, 130],
        [  0, 107, 130],
        [  0, 107, 130],
        ...,
        [  0, 113, 139],
        [  0, 113, 139],
        [  0, 113, 139]],

       [[  0, 106, 132],
        [  0, 106, 132],
        [  0, 106, 132],
        ...,
        [  0, 114, 140],
        [  0, 114, 140],
        [  0, 114, 140]]], dtype=uint8)]"
Image_384.jpg,439,203,201,191,900,600,640,394,201,daskShared_local/images/Image_384.jpg,384,"[array([[[  0, 133, 238],
        [  0, 130, 238],
        [  0, 131, 239],
        ...,
        [  1,  90, 210],
        [  1,  90, 210],
        [  1,  90, 210]],

       [[  0, 133, 238],
        [  0, 130, 238],
        [  0, 131, 239],
        ...,
        [  1,  90, 210],
        [  1,  90, 210],
        [  0,  89, 209]],

       [[  0, 131, 239],
        [  0, 131, 239],
        [  0, 131, 239],
        ...,
        [  1,  90, 210],
        [  0,  89, 209],
        [  0,  89, 209]],

       ...,

       [[125, 110,  53],
        [185, 165, 106],
        [208, 183, 123],
        ...,
        [  5,  52, 107],
        [  9,  61, 139],
        [  0,  54, 147]],

       [[171, 159, 109],
        [156, 140,  88],
        [187, 167, 114],
        ...,
        [  8,  53, 117],
        [  8,  62, 149],
        [  0,  51, 154]],

       [[165, 156,  99],
        [176, 166, 105],
        [188, 173, 110],
        ...,
        [ 10,  57, 126],
        [  0,  55, 148],
        [  0,  56, 166]]], dtype=uint8)]"
Image_385.jpg,398,179,89,66,800,600,487,245,89,daskShared_local/images/Image_385.jpg,385,"[array([[[ 66, 110, 145],
        [ 65, 109, 143],
        [ 71, 113, 150],
        ...,
        [ 60, 122, 177],
        [ 61, 123, 178],
        [ 61, 123, 178]],

       [[ 66, 109, 144],
        [ 64, 108, 142],
        [ 71, 113, 150],
        ...,
        [ 61, 123, 177],
        [ 61, 124, 178],
        [ 61, 124, 178]],

       [[ 66, 113, 148],
        [ 65, 112, 147],
        [ 69, 114, 152],
        ...,
        [ 60, 121, 176],
        [ 61, 122, 178],
        [ 61, 121, 177]],

       ...,

       [[ 96, 102, 130],
        [ 96, 102, 131],
        [ 95, 101, 128],
        ...,
        [ 24, 131, 243],
        [ 24, 132, 242],
        [ 24, 132, 242]],

       [[ 97, 101, 135],
        [ 96, 101, 134],
        [ 99, 103, 137],
        ...,
        [ 24, 135, 238],
        [ 24, 135, 236],
        [ 24, 135, 236]],

       [[ 97, 101, 134],
        [ 96, 101, 133],
        [ 98, 102, 135],
        ...,
        [ 24, 134, 239],
        [ 24, 134, 237],
        [ 24, 134, 237]]], dtype=uint8)]"
Image_386.jpg,797,339,159,116,1536,1024,956,455,159,daskShared_local/images/Image_386.jpg,386,"[array([[[  0,  29,  50],
        [  0,  33,  58],
        [  6,  45,  74],
        ...,
        [ 46, 123, 213],
        [ 46, 123, 213],
        [ 45, 122, 212]],

       [[  0,  29,  50],
        [  0,  32,  58],
        [  6,  44,  75],
        ...,
        [ 46, 123, 213],
        [ 45, 122, 212],
        [ 44, 121, 211]],

       [[  1,  29,  51],
        [  0,  33,  64],
        [  3,  50,  92],
        ...,
        [ 44, 123, 213],
        [ 43, 122, 212],
        [ 43, 122, 212]],

       ...,

       [[ 19, 114, 201],
        [ 19, 115, 201],
        [ 18, 116, 201],
        ...,
        [ 17, 113, 205],
        [ 15, 114, 205],
        [ 14, 113, 204]],

       [[ 20, 115, 202],
        [ 20, 116, 202],
        [ 18, 117, 202],
        ...,
        [ 16, 114, 204],
        [ 15, 114, 204],
        [ 14, 113, 204]],

       [[ 21, 117, 203],
        [ 19, 117, 202],
        [ 17, 117, 202],
        ...,
        [ 15, 115, 203],
        [ 14, 114, 203],
        [ 12, 113, 203]]], dtype=uint8)]"
Image_387.jpg,382,161,121,121,900,600,503,282,121,daskShared_local/images/Image_387.jpg,387,"[array([[[ 45, 120, 186],
        [ 44, 121, 186],
        [ 41, 123, 187],
        ...,
        [121, 120, 137],
        [131, 126, 140],
        [134, 129, 141]],

       [[ 41, 119, 185],
        [ 40, 120, 186],
        [ 38, 122, 186],
        ...,
        [113, 118, 138],
        [119, 122, 140],
        [121, 124, 141]],

       [[ 32, 117, 184],
        [ 31, 118, 184],
        [ 30, 119, 185],
        ...,
        [ 89, 110, 143],
        [ 86, 111, 143],
        [ 84, 111, 142]],

       ...,

       [[  0,  84, 169],
        [  0,  83, 168],
        [  0,  80, 165],
        ...,
        [108,  78, 104],
        [119,  89, 114],
        [123,  93, 117]],

       [[  0,  86, 170],
        [  0,  84, 169],
        [  0,  79, 164],
        ...,
        [115,  85, 109],
        [123,  93, 116],
        [126,  96, 118]],

       [[  0,  87, 171],
        [  0,  85, 169],
        [  0,  79, 164],
        ...,
        [117,  88, 111],
        [124,  95, 116],
        [126,  97, 118]]], dtype=uint8)]"
Image_388.jpg,73,72,90,92,300,260,163,164,92,daskShared_local/images/Image_388.jpg,388,"[array([[[  3, 229, 253],
        [  3, 229, 254],
        [  2, 228, 253],
        ...,
        [107, 223, 227],
        [136, 231, 238],
        [132, 230, 236]],

       [[  3, 229, 254],
        [  3, 229, 254],
        [  2, 228, 253],
        ...,
        [ 96, 221, 225],
        [128, 229, 237],
        [123, 228, 235]],

       [[  3, 229, 253],
        [  3, 229, 253],
        [  2, 228, 253],
        ...,
        [169, 236, 240],
        [181, 242, 245],
        [180, 241, 244]],

       ...,

       [[  0, 188, 239],
        [  0, 188, 239],
        [  1, 187, 239],
        ...,
        [ 35,  97,  73],
        [ 50, 113,  87],
        [ 47, 111,  85]],

       [[  0, 188, 239],
        [  0, 188, 239],
        [  1, 188, 239],
        ...,
        [ 74, 153, 117],
        [112, 176, 143],
        [106, 173, 139]],

       [[  0, 188, 239],
        [  0, 188, 239],
        [  1, 188, 239],
        ...,
        [ 68, 144, 110],
        [102, 167, 134],
        [ 97, 163, 131]]], dtype=uint8)]"
Image_389.jpg,283,171,255,237,1000,541,538,408,255,daskShared_local/images/Image_389.jpg,389,"[array([[[  8, 136, 166],
        [ 23, 131, 162],
        [ 34, 127, 160],
        ...,
        [  4, 150, 173],
        [  4, 154, 178],
        [ 16, 158, 185]],

       [[  8, 130, 159],
        [ 18, 127, 156],
        [ 28, 124, 155],
        ...,
        [ 31, 160, 188],
        [ 27, 163, 188],
        [ 35, 166, 189]],

       [[ 13, 124, 152],
        [ 15, 121, 149],
        [ 23, 116, 146],
        ...,
        [ 40, 161, 186],
        [ 40, 159, 184],
        [ 48, 157, 181]],

       ...,

       [[  0,  44,  63],
        [  3,  49,  67],
        [  1,  50,  67],
        ...,
        [119, 160, 188],
        [102, 145, 170],
        [ 68, 107, 131]],

       [[  2,  47,  64],
        [  3,  49,  68],
        [  1,  54,  72],
        ...,
        [ 81, 121, 153],
        [ 55,  99, 119],
        [ 78, 119, 131]],

       [[  2,  49,  65],
        [  3,  56,  77],
        [  1,  61,  85],
        ...,
        [ 43,  82, 114],
        [ 52,  99, 126],
        [ 95, 141, 165]]], dtype=uint8)]"
Image_39.jpg,415,1022,824,564,4601,3200,1239,1586,824,daskShared_local/images/Image_39.jpg,39,"[array([[[ 30, 161, 237],
        [ 30, 167, 241],
        [ 26, 160, 234],
        ...,
        [ 49, 163, 243],
        [ 45, 160, 234],
        [ 40, 156, 231]],

       [[ 26, 157, 232],
        [ 25, 155, 233],
        [ 25, 160, 238],
        ...,
        [ 46, 155, 237],
        [ 41, 156, 237],
        [ 34, 154, 233]],

       [[ 29, 162, 238],
        [ 31, 162, 239],
        [ 32, 163, 241],
        ...,
        [ 43, 157, 233],
        [ 40, 158, 238],
        [ 37, 160, 236]],

       ...,

       [[ 26, 153, 221],
        [ 26, 154, 219],
        [ 29, 155, 217],
        ...,
        [ 38, 149, 205],
        [ 39, 153, 207],
        [ 40, 161, 216]],

       [[ 21, 154, 218],
        [ 28, 162, 229],
        [ 24, 155, 220],
        ...,
        [ 37, 144, 202],
        [ 39, 149, 205],
        [ 43, 157, 217]],

       [[ 29, 158, 224],
        [ 31, 157, 225],
        [ 28, 153, 221],
        ...,
        [ 44, 154, 211],
        [ 45, 152, 209],
        [ 48, 146, 208]]], dtype=uint8)]"
Image_390.jpg,77,87,114,125,637,450,191,212,125,daskShared_local/images/Image_390.jpg,390,"[array([[[  1, 172, 254],
        [  1, 172, 254],
        [  1, 172, 254],
        ...,
        [  2, 175, 254],
        [  1, 174, 253],
        [  1, 174, 253]],

       [[  1, 171, 254],
        [  1, 171, 254],
        [  1, 171, 254],
        ...,
        [  2, 175, 254],
        [  1, 174, 253],
        [  1, 173, 253]],

       [[  1, 170, 253],
        [  1, 170, 253],
        [  1, 170, 253],
        ...,
        [  1, 174, 253],
        [  1, 173, 254],
        [  1, 172, 254]],

       ...,

       [[  0, 133, 237],
        [  0, 136, 239],
        [  0, 142, 242],
        ...,
        [107, 143, 112],
        [110, 145, 115],
        [111, 146, 115]],

       [[  0, 136, 239],
        [  1, 139, 241],
        [  2, 146, 245],
        ...,
        [103, 140, 113],
        [107, 144, 117],
        [108, 145, 118]],

       [[  1, 137, 241],
        [  1, 140, 242],
        [  3, 147, 246],
        ...,
        [101, 139, 113],
        [105, 144, 117],
        [106, 145, 118]]], dtype=uint8)]"
Image_391.jpg,449,149,141,121,1024,512,590,270,141,daskShared_local/images/Image_391.jpg,391,"[array([[[  0, 133, 190],
        [  1, 134, 191],
        [  2, 135, 192],
        ...,
        [  0, 166, 210],
        [  0, 167, 211],
        [  1, 168, 212]],

       [[  1, 134, 191],
        [  1, 134, 191],
        [  2, 135, 192],
        ...,
        [  0, 166, 210],
        [  0, 167, 211],
        [  1, 168, 212]],

       [[  2, 135, 192],
        [  2, 135, 192],
        [  3, 136, 193],
        ...,
        [  0, 165, 209],
        [  0, 166, 210],
        [  1, 167, 211]],

       ...,

       [[135, 129, 107],
        [150, 143, 121],
        [157, 150, 126],
        ...,
        [  0, 144, 197],
        [  0, 144, 197],
        [  0, 143, 196]],

       [[103, 100,  81],
        [111, 107,  87],
        [112, 107,  86],
        ...,
        [  0, 144, 197],
        [  0, 144, 197],
        [  0, 143, 196]],

       [[ 83,  81,  65],
        [ 84,  81,  63],
        [ 82,  79,  58],
        ...,
        [  0, 144, 197],
        [  0, 144, 197],
        [  0, 143, 196]]], dtype=uint8)]"
Image_392.jpg,231,18,250,255,980,500,481,273,255,daskShared_local/images/Image_392.jpg,392,"[array([[[130, 188, 255],
        [124, 182, 253],
        [123, 178, 253],
        ...,
        [130, 184, 240],
        [135, 188, 247],
        [127, 180, 255]],

       [[130, 188, 254],
        [126, 184, 255],
        [126, 185, 253],
        ...,
        [117, 161, 209],
        [115, 161, 210],
        [131, 180, 238]],

       [[123, 182, 251],
        [126, 185, 255],
        [127, 187, 251],
        ...,
        [ 70, 138, 184],
        [ 61, 132, 174],
        [ 63, 136, 177]],

       ...,

       [[137, 198, 235],
        [ 87, 153, 189],
        [ 90, 158, 203],
        ...,
        [ 76,  99, 101],
        [ 76, 100, 102],
        [ 68,  92,  94]],

       [[ 89, 160, 184],
        [ 83, 160, 191],
        [ 93, 170, 213],
        ...,
        [ 74,  95,  98],
        [ 78,  99, 102],
        [ 74,  95,  98]],

       [[109, 180, 207],
        [120, 187, 219],
        [ 76, 163, 197],
        ...,
        [ 70,  89,  86],
        [ 71,  91,  90],
        [ 71,  94,  94]]], dtype=uint8)]"
Image_393.jpg,317,156,168,183,1200,735,485,339,183,daskShared_local/images/Image_393.jpg,393,"[array([[[112, 185, 202],
        [104, 177, 194],
        [105, 179, 195],
        ...,
        [ 15,  50,  79],
        [ 12,  47,  75],
        [  7,  43,  69]],

       [[112, 187, 202],
        [106, 182, 196],
        [105, 181, 195],
        ...,
        [ 18,  57,  83],
        [ 16,  56,  82],
        [  8,  49,  74]],

       [[114, 190, 204],
        [111, 187, 201],
        [111, 187, 201],
        ...,
        [ 17,  59,  83],
        [ 19,  63,  85],
        [ 11,  58,  78]],

       ...,

       [[138, 184, 177],
        [139, 183, 179],
        [141, 185, 182],
        ...,
        [ 11,   1,   4],
        [ 12,   3,   5],
        [  7,   1,   1]],

       [[142, 186, 180],
        [143, 185, 183],
        [142, 181, 181],
        ...,
        [ 12,   2,   3],
        [ 10,   1,   2],
        [  4,   0,   0]],

       [[145, 185, 184],
        [146, 184, 185],
        [143, 178, 180],
        ...,
        [ 11,   2,   1],
        [ 12,   4,   3],
        [  6,   0,   0]]], dtype=uint8)]"
Image_394.jpg,119,340,187,179,735,1102,306,519,187,daskShared_local/images/Image_394.jpg,394,"[array([[[  0, 124, 208],
        [  0, 125, 209],
        [  0, 123, 209],
        ...,
        [  0, 143, 223],
        [  0, 146, 223],
        [  0, 146, 223]],

       [[  0, 125, 209],
        [  0, 125, 209],
        [  1, 126, 210],
        ...,
        [  2, 147, 228],
        [  0, 145, 222],
        [  1, 147, 224]],

       [[  0, 124, 210],
        [  0, 126, 210],
        [  2, 127, 211],
        ...,
        [  0, 146, 223],
        [  0, 141, 218],
        [  0, 139, 218]],

       ...,

       [[  0, 122, 207],
        [  0, 122, 207],
        [  0, 122, 207],
        ...,
        [ 44,  65,  88],
        [ 47,  86,  95],
        [ 62, 102, 104]],

       [[  0, 121, 204],
        [  0, 121, 206],
        [  0, 121, 206],
        ...,
        [ 46,  76,  94],
        [ 48,  88,  91],
        [ 38,  78,  78]],

       [[  0, 120, 201],
        [  0, 119, 205],
        [  0, 117, 204],
        ...,
        [ 55,  94, 105],
        [ 48,  83,  89],
        [ 32,  69,  77]]], dtype=uint8)]"
Image_395.jpg,112,92,82,72,500,461,194,164,82,daskShared_local/images/Image_395.jpg,395,"[array([[[ 38, 101, 108],
        [ 38, 102, 108],
        [ 37, 101, 107],
        ...,
        [ 38,  99, 110],
        [ 37,  99, 110],
        [ 37,  99, 110]],

       [[ 38, 102, 108],
        [ 38, 102, 109],
        [ 37, 101, 108],
        ...,
        [ 37,  99, 110],
        [ 37,  99, 110],
        [ 37,  99, 110]],

       [[ 38, 100, 107],
        [ 39, 101, 108],
        [ 37,  99, 107],
        ...,
        [ 38, 100, 111],
        [ 37,  99, 110],
        [ 38,  99, 110]],

       ...,

       [[ 36,  89,  95],
        [ 36,  89,  95],
        [ 36,  89,  95],
        ...,
        [129,  48,  49],
        [131,  48,  49],
        [130,  48,  49]],

       [[ 35,  88,  94],
        [ 36,  89,  95],
        [ 35,  88,  94],
        ...,
        [131,  47,  47],
        [127,  45,  43],
        [129,  46,  44]],

       [[ 36,  89,  95],
        [ 36,  89,  95],
        [ 35,  88,  94],
        ...,
        [131,  47,  47],
        [129,  46,  45],
        [129,  47,  46]]], dtype=uint8)]"
Image_396.jpg,441,370,210,210,1024,683,651,580,210,daskShared_local/images/Image_396.jpg,396,"[array([[[167, 159, 152],
        [201, 196, 192],
        [ 77,  63,  63],
        ...,
        [ 55,  38,  37],
        [ 51,  36,  36],
        [ 58,  44,  43]],

       [[223, 218, 212],
        [187, 181, 177],
        [ 67,  54,  47],
        ...,
        [ 58,  44,  42],
        [ 59,  45,  44],
        [ 61,  47,  46]],

       [[179, 175, 168],
        [118, 112, 105],
        [ 58,  43,  27],
        ...,
        [ 63,  51,  49],
        [ 69,  58,  56],
        [ 71,  58,  57]],

       ...,

       [[179, 149, 101],
        [163, 147,  86],
        [132, 132,  43],
        ...,
        [251, 234, 204],
        [226, 205, 170],
        [233, 202, 158]],

       [[130, 125,  74],
        [151, 158,  98],
        [120, 136,  53],
        ...,
        [255, 232, 183],
        [252, 232, 177],
        [253, 223, 170]],

       [[123, 139, 111],
        [101, 123,  81],
        [139, 160,  88],
        ...,
        [206, 172, 118],
        [197, 166, 112],
        [212, 185, 137]]], dtype=uint8)]"
Image_397.jpg,517,87,296,442,1600,900,813,529,442,daskShared_local/images/Image_397.jpg,397,"[array([[[  0, 154, 208],
        [  0, 154, 208],
        [  0, 154, 208],
        ...,
        [153, 198, 240],
        [154, 199, 241],
        [156, 201, 243]],

       [[  0, 153, 207],
        [  0, 153, 207],
        [  0, 154, 208],
        ...,
        [153, 198, 241],
        [154, 199, 241],
        [156, 201, 243]],

       [[  0, 153, 206],
        [  0, 153, 207],
        [  0, 154, 208],
        ...,
        [154, 198, 243],
        [155, 199, 243],
        [155, 200, 242]],

       ...,

       [[  1, 139, 202],
        [  1, 139, 202],
        [  0, 140, 201],
        ...,
        [103,  93,  80],
        [130, 112,  94],
        [143, 114,  91]],

       [[  1, 139, 202],
        [  1, 139, 202],
        [  0, 140, 201],
        ...,
        [121, 108,  87],
        [124, 107,  85],
        [143, 120,  99]],

       [[  1, 139, 202],
        [  1, 139, 202],
        [  1, 140, 201],
        ...,
        [123, 109,  89],
        [126, 110,  89],
        [141, 123, 102]]], dtype=uint8)]"
Image_398.jpg,443,305,174,163,940,625,617,468,174,daskShared_local/images/Image_398.jpg,398,"[array([[[124, 105,  75],
        [119,  99,  71],
        [113,  91,  67],
        ...,
        [164, 229, 237],
        [141, 194, 204],
        [114, 157, 166]],

       [[132, 111,  83],
        [133, 110,  85],
        [131, 106,  84],
        ...,
        [174, 218, 232],
        [172, 204, 218],
        [155, 179, 193]],

       [[147, 124,  96],
        [147, 124,  99],
        [142, 116,  94],
        ...,
        [175, 197, 218],
        [189, 199, 221],
        [178, 182, 202]],

       ...,

       [[180, 221, 184],
        [183, 223, 188],
        [185, 225, 192],
        ...,
        [ 51, 110,  98],
        [ 44, 104,  93],
        [ 35,  95,  84]],

       [[179, 220, 185],
        [180, 221, 187],
        [181, 220, 189],
        ...,
        [ 41,  99,  87],
        [ 30,  90,  78],
        [ 21,  81,  69]],

       [[181, 222, 188],
        [179, 220, 189],
        [177, 217, 189],
        ...,
        [ 30,  90,  78],
        [ 22,  82,  70],
        [ 18,  78,  66]]], dtype=uint8)]"
Image_399.jpg,881,517,215,215,1920,1200,1096,732,215,daskShared_local/images/Image_399.jpg,399,"[array([[[  0, 108, 111],
        [  2, 110, 113],
        [  6, 114, 117],
        ...,
        [  3, 119, 122],
        [  2, 118, 119],
        [  0, 116, 116]],

       [[  3, 108, 112],
        [  2, 107, 111],
        [  3, 110, 114],
        ...,
        [  2, 117, 120],
        [  3, 116, 120],
        [  3, 117, 118]],

       [[  3, 108, 114],
        [  1, 106, 112],
        [  2, 107, 113],
        ...,
        [  1, 115, 118],
        [  2, 115, 119],
        [  3, 115, 119]],

       ...,

       [[108,  97,  78],
        [ 99,  86,  66],
        [106,  90,  68],
        ...,
        [ 85,  56,  21],
        [ 71,  41,  11],
        [ 62,  32,   7]],

       [[ 91,  83,  64],
        [110,  99,  79],
        [112,  99,  77],
        ...,
        [ 68,  42,  14],
        [ 57,  31,   4],
        [ 52,  26,   1]],

       [[ 71,  63,  43],
        [ 93,  82,  62],
        [120, 108,  85],
        ...,
        [ 86,  64,  41],
        [ 72,  50,  27],
        [ 51,  29,   6]]], dtype=uint8)]"
Image_4.jpg,1368,431,519,377,2500,1667,1887,808,519,daskShared_local/images/Image_4.jpg,4,"[array([[[161, 196, 200],
        [163, 198, 203],
        [156, 193, 199],
        ...,
        [177, 195, 207],
        [184, 208, 216],
        [180, 208, 213]],

       [[144, 182, 189],
        [137, 177, 184],
        [133, 174, 183],
        ...,
        [176, 191, 206],
        [176, 199, 209],
        [179, 208, 213]],

       [[123, 165, 173],
        [119, 163, 172],
        [115, 160, 170],
        ...,
        [183, 196, 213],
        [180, 202, 214],
        [181, 212, 216]],

       ...,

       [[149, 123,  95],
        [155, 128, 102],
        [163, 136, 111],
        ...,
        [  1, 128, 164],
        [  2, 127, 170],
        [  0, 126, 162]],

       [[146, 118,  88],
        [154, 126,  96],
        [161, 133, 104],
        ...,
        [  0, 132, 173],
        [  1, 131, 171],
        [  2, 131, 168]],

       [[122,  94,  59],
        [132, 103,  69],
        [147, 118,  84],
        ...,
        [  0, 128, 168],
        [  0, 132, 165],
        [  0, 131, 169]]], dtype=uint8)]"
Image_40.jpg,915,459,667,525,3008,2000,1582,984,667,daskShared_local/images/Image_40.jpg,40,"[array([[[148, 187, 194],
        [148, 187, 194],
        [148, 187, 194],
        ...,
        [137, 179, 191],
        [137, 179, 191],
        [137, 179, 191]],

       [[148, 187, 194],
        [148, 187, 194],
        [148, 187, 194],
        ...,
        [137, 179, 191],
        [137, 179, 191],
        [137, 179, 191]],

       [[148, 187, 194],
        [148, 187, 194],
        [148, 187, 194],
        ...,
        [137, 179, 191],
        [137, 179, 191],
        [137, 179, 191]],

       ...,

       [[115, 168, 176],
        [115, 168, 176],
        [115, 168, 176],
        ...,
        [ 72,  91,  95],
        [ 68,  87,  91],
        [ 60,  79,  83]],

       [[115, 168, 176],
        [115, 168, 176],
        [118, 171, 179],
        ...,
        [ 85, 104, 108],
        [ 84, 103, 107],
        [ 77,  96, 100]],

       [[115, 168, 176],
        [116, 169, 177],
        [118, 171, 179],
        ...,
        [ 68,  87,  91],
        [ 73,  92,  96],
        [ 68,  87,  91]]], dtype=uint8)]"
Image_400.jpg,318,202,235,208,900,720,553,410,235,daskShared_local/images/Image_400.jpg,400,"[array([[[ 92, 203, 248],
        [ 90, 201, 246],
        [ 93, 200, 246],
        ...,
        [ 89, 193, 246],
        [ 88, 192, 245],
        [ 90, 194, 249]],

       [[ 90, 206, 250],
        [ 90, 205, 250],
        [ 95, 201, 252],
        ...,
        [ 90, 194, 247],
        [ 90, 194, 247],
        [ 91, 195, 250]],

       [[ 93, 206, 248],
        [ 96, 210, 251],
        [ 95, 208, 252],
        ...,
        [ 90, 194, 246],
        [ 91, 195, 247],
        [ 90, 194, 248]],

       ...,

       [[ 67, 144, 200],
        [ 68, 145, 201],
        [ 68, 145, 201],
        ...,
        [219, 214, 202],
        [214, 209, 191],
        [176, 188, 141]],

       [[ 66, 143, 199],
        [ 67, 144, 200],
        [ 68, 145, 201],
        ...,
        [173, 174, 151],
        [187, 190, 168],
        [110, 111,  62]],

       [[ 66, 143, 199],
        [ 67, 144, 200],
        [ 68, 145, 201],
        ...,
        [171, 175, 145],
        [155, 163, 139],
        [124, 113,  84]]], dtype=uint8)]"
Image_401.jpg,633,450,208,171,1024,672,841,621,208,daskShared_local/images/Image_401.jpg,401,"[array([[[115, 113, 116],
        [114, 110, 113],
        [121, 119, 120],
        ...,
        [ 85,  93,  95],
        [ 85,  90,  93],
        [122, 126, 127]],

       [[117, 115, 120],
        [117, 113, 116],
        [116, 114, 115],
        ...,
        [ 79,  87,  89],
        [ 69,  76,  76],
        [101, 105, 104]],

       [[118, 116, 121],
        [123, 121, 124],
        [119, 117, 120],
        ...,
        [ 67,  77,  79],
        [ 51,  60,  60],
        [ 58,  65,  63]],

       ...,

       [[ 35,  85, 138],
        [ 36,  85, 141],
        [ 37,  86, 142],
        ...,
        [ 16, 111, 224],
        [ 14, 111, 226],
        [ 11, 110, 227]],

       [[ 33,  83, 136],
        [ 34,  83, 139],
        [ 35,  84, 140],
        ...,
        [ 15, 112, 227],
        [ 13, 113, 227],
        [ 12, 113, 229]],

       [[ 31,  80, 136],
        [ 31,  80, 136],
        [ 32,  81, 137],
        ...,
        [ 16, 113, 228],
        [ 15, 114, 231],
        [ 13, 114, 230]]], dtype=uint8)]"
Image_402.jpg,557,95,277,274,1024,770,834,369,277,daskShared_local/images/Image_402.jpg,402,"[array([[[  2, 110, 183],
        [  2, 110, 183],
        [  1, 112, 184],
        ...,
        [ 55,  59,  70],
        [ 56,  66,  75],
        [ 52,  66,  75]],

       [[  2, 112, 186],
        [  2, 111, 185],
        [  3, 114, 188],
        ...,
        [ 41,  46,  54],
        [ 62,  71,  79],
        [ 51,  66,  74]],

       [[  3, 113, 188],
        [  1, 111, 186],
        [  4, 114, 189],
        ...,
        [ 57,  62,  66],
        [ 46,  55,  61],
        [ 31,  46,  53]],

       ...,

       [[ 45,  91,  70],
        [ 45,  96,  72],
        [ 55,  88,  71],
        ...,
        [ 32,  32,  32],
        [ 34,  33,  33],
        [ 33,  31,  32]],

       [[ 71, 119,  92],
        [ 51, 100,  71],
        [ 65, 110,  90],
        ...,
        [ 37,  33,  37],
        [ 33,  31,  33],
        [ 32,  32,  32]],

       [[114, 157, 132],
        [ 65, 110,  82],
        [ 82, 125, 105],
        ...,
        [ 33,  31,  34],
        [ 33,  31,  33],
        [ 33,  33,  33]]], dtype=uint8)]"
Image_403.jpg,473,123,104,82,685,360,577,205,104,daskShared_local/images/Image_403.jpg,403,"[array([[[  0, 105, 150],
        [  0, 105, 150],
        [  0, 105, 150],
        ...,
        [  2, 100, 145],
        [  1,  99, 144],
        [  1,  99, 144]],

       [[  1, 105, 150],
        [  0, 105, 150],
        [  0, 105, 150],
        ...,
        [  2, 100, 145],
        [  1,  99, 144],
        [  1,  99, 144]],

       [[  1, 105, 150],
        [  1, 105, 150],
        [  1, 104, 149],
        ...,
        [  2, 100, 145],
        [  1,  99, 144],
        [  1,  99, 144]],

       ...,

       [[  7,  97, 133],
        [  7,  97, 132],
        [ 10,  89, 128],
        ...,
        [  0,  82, 117],
        [  0,  83, 118],
        [  0,  83, 118]],

       [[  6,  94, 132],
        [  7,  93, 132],
        [ 11,  90, 132],
        ...,
        [  0,  82, 117],
        [  0,  83, 118],
        [  0,  83, 118]],

       [[  6,  93, 132],
        [  7,  93, 132],
        [ 11,  90, 133],
        ...,
        [  0,  82, 117],
        [  0,  83, 118],
        [  0,  83, 118]]], dtype=uint8)]"
Image_404.jpg,114,205,104,88,789,562,218,293,104,daskShared_local/images/Image_404.jpg,404,"[array([[[  1,  89, 163],
        [  1,  89, 162],
        [  1,  89, 162],
        ...,
        [  2,  95, 165],
        [  2,  95, 165],
        [  2,  95, 165]],

       [[  1,  89, 163],
        [  1,  89, 163],
        [  1,  88, 162],
        ...,
        [  2,  95, 165],
        [  2,  95, 165],
        [  2,  95, 165]],

       [[  2,  88, 163],
        [  2,  88, 163],
        [  1,  88, 162],
        ...,
        [  1,  94, 164],
        [  1,  94, 164],
        [  1,  94, 164]],

       ...,

       [[  1,  65, 111],
        [  1,  65, 111],
        [  1,  65, 111],
        ...,
        [  2,  64, 111],
        [  1,  63, 110],
        [  1,  63, 110]],

       [[  1,  65, 111],
        [  1,  65, 111],
        [  1,  65, 111],
        ...,
        [  1,  63, 110],
        [  1,  63, 110],
        [  1,  63, 110]],

       [[  1,  65, 111],
        [  1,  65, 111],
        [  1,  65, 111],
        ...,
        [  1,  63, 110],
        [  1,  63, 110],
        [  1,  63, 110]]], dtype=uint8)]"
Image_405.jpg,1787,646,323,266,2560,1440,2110,912,323,daskShared_local/images/Image_405.jpg,405,"[array([[[ 38,  70, 104],
        [ 44,  70, 101],
        [ 47,  69,  97],
        ...,
        [  0, 121, 168],
        [  0, 121, 168],
        [  0, 121, 168]],

       [[ 47,  79, 112],
        [ 45,  72, 101],
        [ 47,  70,  97],
        ...,
        [  0, 121, 168],
        [  0, 121, 168],
        [  0, 121, 168]],

       [[ 59,  91, 124],
        [ 59,  86, 116],
        [ 62,  86, 113],
        ...,
        [  0, 121, 168],
        [  0, 121, 168],
        [  0, 121, 168]],

       ...,

       [[  1, 123, 170],
        [  1, 123, 170],
        [  1, 123, 170],
        ...,
        [  0, 114, 164],
        [  0, 114, 166],
        [  0, 114, 166]],

       [[  1, 123, 170],
        [  1, 123, 170],
        [  1, 123, 170],
        ...,
        [  0, 114, 164],
        [  0, 114, 164],
        [  0, 114, 166]],

       [[  1, 123, 170],
        [  1, 123, 170],
        [  1, 123, 170],
        ...,
        [  0, 114, 164],
        [  0, 114, 164],
        [  0, 114, 164]]], dtype=uint8)]"
Image_406.jpg,119,371,249,201,1200,800,368,572,249,daskShared_local/images/Image_406.jpg,406,"[array([[[  1,  93,  98],
        [  3,  96, 101],
        [  2,  99, 102],
        ...,
        [  5,  82,  97],
        [  3,  94, 111],
        [  7, 108, 126]],

       [[  1,  90,  96],
        [  0,  91,  96],
        [  0,  93,  96],
        ...,
        [ 14, 107, 123],
        [ 19, 119, 137],
        [ 14, 118, 138]],

       [[  0,  87,  94],
        [  0,  89,  94],
        [  0,  90,  94],
        ...,
        [ 10, 113, 131],
        [ 15, 117, 136],
        [ 36, 134, 156]],

       ...,

       [[177, 210, 111],
        [160, 185,  93],
        [149, 167,  91],
        ...,
        [  5,  64,  62],
        [  2,  61,  59],
        [  3,  62,  60]],

       [[163, 197, 104],
        [154, 181,  95],
        [152, 174, 101],
        ...,
        [  4,  61,  60],
        [  4,  61,  60],
        [  6,  63,  62]],

       [[155, 189, 107],
        [159, 190, 112],
        [173, 202, 132],
        ...,
        [  1,  56,  56],
        [  1,  56,  56],
        [  2,  57,  57]]], dtype=uint8)]"
Image_407.jpg,491,123,138,122,800,600,629,245,138,daskShared_local/images/Image_407.jpg,407,"[array([[[  7, 152, 171],
        [  7, 152, 171],
        [  9, 154, 173],
        ...,
        [ 52, 167, 174],
        [ 51, 166, 173],
        [ 50, 165, 172]],

       [[  8, 153, 172],
        [  8, 153, 172],
        [  8, 153, 172],
        ...,
        [ 50, 164, 173],
        [ 49, 163, 172],
        [ 48, 162, 171]],

       [[  9, 154, 173],
        [  8, 153, 172],
        [  7, 152, 171],
        ...,
        [ 48, 163, 173],
        [ 47, 162, 172],
        [ 46, 160, 170]],

       ...,

       [[ 80,  74,  48],
        [ 64,  58,  33],
        [ 62,  56,  32],
        ...,
        [  0, 140, 160],
        [  0, 140, 160],
        [  0, 140, 160]],

       [[ 66,  60,  35],
        [ 56,  50,  26],
        [ 66,  60,  36],
        ...,
        [  0, 140, 160],
        [  0, 140, 160],
        [  0, 140, 160]],

       [[ 54,  48,  24],
        [ 48,  42,  18],
        [ 62,  56,  32],
        ...,
        [  0, 140, 160],
        [  0, 140, 160],
        [  0, 140, 160]]], dtype=uint8)]"
Image_408.jpg,429,153,719,607,1152,763,1148,760,719,daskShared_local/images/Image_408.jpg,408,"[array([[[  0, 179, 235],
        [  0, 179, 235],
        [  1, 180, 236],
        ...,
        [  0, 184, 238],
        [  0, 183, 237],
        [  0, 183, 237]],

       [[  0, 179, 235],
        [  0, 179, 235],
        [  1, 180, 236],
        ...,
        [  0, 184, 238],
        [  0, 183, 237],
        [  0, 183, 237]],

       [[  0, 179, 235],
        [  0, 179, 235],
        [  1, 180, 236],
        ...,
        [  0, 183, 236],
        [  0, 183, 237],
        [  0, 184, 238]],

       ...,

       [[145, 171, 136],
        [147, 172, 140],
        [148, 174, 146],
        ...,
        [186, 200, 187],
        [170, 192, 182],
        [154, 182, 158]],

       [[150, 173, 144],
        [151, 174, 147],
        [151, 176, 152],
        ...,
        [164, 187, 182],
        [151, 181, 172],
        [137, 173, 152]],

       [[155, 178, 151],
        [156, 179, 153],
        [156, 179, 156],
        ...,
        [133, 168, 153],
        [125, 160, 139],
        [132, 159, 131]]], dtype=uint8)]"
Image_409.jpg,582,52,163,154,930,500,745,206,163,daskShared_local/images/Image_409.jpg,409,"[array([[[  9, 148, 207],
        [ 10, 149, 208],
        [ 12, 151, 212],
        ...,
        [ 11, 150, 207],
        [ 10, 149, 206],
        [ 10, 146, 204]],

       [[  8, 147, 206],
        [ 10, 149, 208],
        [ 11, 150, 211],
        ...,
        [  8, 147, 204],
        [  8, 146, 204],
        [ 10, 146, 204]],

       [[  8, 147, 207],
        [  9, 148, 209],
        [ 10, 148, 210],
        ...,
        [  8, 147, 204],
        [  8, 146, 203],
        [ 10, 147, 204]],

       ...,

       [[231, 231, 231],
        [243, 243, 243],
        [248, 248, 248],
        ...,
        [  9, 139, 199],
        [  9, 139, 200],
        [ 10, 139, 203]],

       [[224, 224, 224],
        [236, 236, 236],
        [243, 243, 243],
        ...,
        [  8, 138, 198],
        [  8, 137, 199],
        [  7, 136, 201]],

       [[221, 221, 221],
        [232, 232, 232],
        [240, 240, 240],
        ...,
        [  7, 137, 197],
        [  7, 136, 198],
        [  5, 135, 199]]], dtype=uint8)]"
Image_41.jpg,608,314,200,158,1400,933,808,472,200,daskShared_local/images/Image_41.jpg,41,"[array([[[  1, 171, 230],
        [  1, 171, 230],
        [  1, 171, 230],
        ...,
        [  3, 221, 255],
        [  3, 221, 255],
        [  2, 222, 255]],

       [[  1, 171, 230],
        [  1, 171, 230],
        [  1, 171, 230],
        ...,
        [  3, 221, 255],
        [  2, 222, 255],
        [  0, 223, 255]],

       [[  1, 171, 230],
        [  1, 171, 230],
        [  1, 171, 230],
        ...,
        [  0, 219, 253],
        [  0, 219, 252],
        [  0, 220, 252]],

       ...,

       [[182, 170, 122],
        [ 98,  88,  53],
        [ 67,  59,  38],
        ...,
        [  1, 182, 235],
        [  1, 182, 235],
        [  1, 182, 235]],

       [[140, 128,  80],
        [ 78,  65,  33],
        [ 73,  61,  47],
        ...,
        [  1, 182, 235],
        [  1, 182, 235],
        [  1, 181, 234]],

       [[130, 116,  71],
        [ 88,  74,  45],
        [ 74,  62,  50],
        ...,
        [  1, 181, 234],
        [  1, 181, 234],
        [  1, 181, 234]]], dtype=uint8)]"
Image_410.jpg,407,325,132,128,800,600,539,453,132,daskShared_local/images/Image_410.jpg,410,"[array([[[205, 187, 159],
        [213, 193, 160],
        [227, 205, 163],
        ...,
        [  5,  89, 100],
        [  5,  89, 100],
        [  6,  90, 101]],

       [[213, 199, 169],
        [218, 199, 166],
        [229, 202, 163],
        ...,
        [  4,  88, 100],
        [  5,  89, 100],
        [  5,  89, 100]],

       [[222, 216, 184],
        [225, 209, 176],
        [230, 201, 166],
        ...,
        [  4,  88, 100],
        [  4,  88,  99],
        [  4,  88,  99]],

       ...,

       [[ 31,  50,  49],
        [ 31,  51,  50],
        [ 32,  52,  51],
        ...,
        [ 41, 119,  75],
        [ 42, 113,  73],
        [ 44, 112,  72]],

       [[ 28,  49,  48],
        [ 28,  49,  48],
        [ 29,  50,  49],
        ...,
        [ 56, 138,  96],
        [ 48, 123,  82],
        [ 46, 118,  77]],

       [[ 27,  48,  49],
        [ 27,  49,  48],
        [ 28,  50,  48],
        ...,
        [ 65, 149, 109],
        [ 51, 128,  87],
        [ 46, 121,  79]]], dtype=uint8)]"
Image_411.jpg,558,133,122,102,759,500,680,235,122,daskShared_local/images/Image_411.jpg,411,"[array([[[ 32, 142, 230],
        [ 31, 142, 228],
        [ 29, 141, 222],
        ...,
        [ 28, 129, 219],
        [ 28, 129, 219],
        [ 28, 129, 219]],

       [[ 32, 142, 229],
        [ 31, 142, 227],
        [ 28, 140, 221],
        ...,
        [ 28, 129, 219],
        [ 28, 129, 219],
        [ 28, 129, 219]],

       [[ 31, 141, 227],
        [ 29, 141, 225],
        [ 26, 139, 219],
        ...,
        [ 27, 128, 218],
        [ 27, 128, 218],
        [ 27, 128, 218]],

       ...,

       [[ 27,  92, 102],
        [ 27,  93, 104],
        [ 28,  96, 108],
        ...,
        [ 31, 161, 213],
        [ 31, 161, 212],
        [ 31, 161, 211]],

       [[ 27,  92, 102],
        [ 28,  94, 103],
        [ 29,  98, 107],
        ...,
        [ 31, 161, 213],
        [ 31, 161, 212],
        [ 31, 161, 212]],

       [[ 28,  92, 101],
        [ 28,  94, 103],
        [ 30,  99, 106],
        ...,
        [ 31, 161, 213],
        [ 31, 161, 212],
        [ 30, 160, 212]]], dtype=uint8)]"
Image_412.jpg,772,545,1247,1471,3072,2304,2019,2016,1471,daskShared_local/images/Image_412.jpg,412,"[array([[[ 92,  88,  76],
        [ 84,  78,  67],
        [ 78,  69,  61],
        ...,
        [ 72,  49,  58],
        [ 86,  62,  77],
        [114,  92, 107]],

       [[ 88,  83,  72],
        [ 81,  75,  65],
        [ 78,  69,  65],
        ...,
        [ 63,  42,  48],
        [ 70,  47,  58],
        [ 83,  62,  75]],

       [[ 89,  80,  74],
        [ 81,  72,  67],
        [ 77,  67,  65],
        ...,
        [ 70,  46,  51],
        [ 69,  47,  54],
        [ 73,  52,  63]],

       ...,

       [[  6, 112, 119],
        [  6, 113, 120],
        [  6, 113, 120],
        ...,
        [ 10,  96, 109],
        [  6,  94, 108],
        [ 13,  97, 116]],

       [[  8, 111, 122],
        [  6, 112, 122],
        [  4, 111, 121],
        ...,
        [ 10,  94, 109],
        [  9,  97, 114],
        [ 18, 107, 124]],

       [[  7, 109, 121],
        [  6, 112, 122],
        [  4, 111, 121],
        ...,
        [  8,  94, 110],
        [ 12, 104, 116],
        [ 19, 114, 127]]], dtype=uint8)]"
Image_413.jpg,426,155,248,244,1200,822,674,399,248,daskShared_local/images/Image_413.jpg,413,"[array([[[  0, 150, 175],
        [  0, 150, 175],
        [  0, 150, 175],
        ...,
        [  0, 158, 188],
        [  0, 158, 187],
        [  0, 158, 187]],

       [[  0, 150, 175],
        [  0, 150, 175],
        [  0, 150, 175],
        ...,
        [  0, 157, 187],
        [  1, 158, 188],
        [  1, 159, 188]],

       [[  0, 151, 175],
        [  0, 151, 175],
        [  0, 151, 175],
        ...,
        [  0, 157, 188],
        [  1, 159, 189],
        [  2, 160, 189]],

       ...,

       [[107, 119,  59],
        [110, 129,  62],
        [106, 128,  61],
        ...,
        [122, 102,  68],
        [120,  95,  61],
        [124,  96,  60]],

       [[118, 131,  65],
        [109, 129,  51],
        [105, 128,  51],
        ...,
        [ 98,  82,  47],
        [109,  85,  64],
        [111,  81,  60]],

       [[119, 131,  59],
        [115, 127,  50],
        [107, 121,  42],
        ...,
        [ 74,  44,  28],
        [102,  72,  55],
        [106,  79,  58]]], dtype=uint8)]"
Image_414.jpg,574,183,83,81,1000,700,657,264,83,daskShared_local/images/Image_414.jpg,414,"[array([[[  0, 157, 228],
        [  0, 157, 229],
        [  0, 157, 228],
        ...,
        [  0, 157, 227],
        [  0, 157, 228],
        [  0, 157, 228]],

       [[  0, 156, 229],
        [  0, 156, 229],
        [  0, 157, 228],
        ...,
        [  0, 157, 227],
        [  0, 157, 228],
        [  0, 157, 227]],

       [[  0, 157, 228],
        [  0, 157, 228],
        [  0, 157, 227],
        ...,
        [  0, 157, 227],
        [  0, 157, 228],
        [  0, 157, 228]],

       ...,

       [[  8,  91, 110],
        [ 10,  93, 110],
        [  5,  88, 110],
        ...,
        [  1, 152, 223],
        [  0, 151, 224],
        [  0, 151, 224]],

       [[  5,  84, 108],
        [  6,  85, 107],
        [  4,  82, 109],
        ...,
        [  1, 151, 223],
        [  0, 150, 223],
        [  0, 151, 223]],

       [[  7,  87, 109],
        [  8,  88, 108],
        [  4,  84, 109],
        ...,
        [  1, 152, 223],
        [  0, 151, 224],
        [  0, 151, 224]]], dtype=uint8)]"
Image_415.jpg,297,92,169,157,732,420,466,249,169,daskShared_local/images/Image_415.jpg,415,"[array([[[  1, 167, 217],
        [  1, 167, 217],
        [  1, 167, 217],
        ...,
        [ 45, 194, 224],
        [ 56, 196, 225],
        [ 62, 194, 227]],

       [[  1, 167, 217],
        [  1, 167, 217],
        [  1, 167, 217],
        ...,
        [ 52, 196, 229],
        [ 44, 190, 216],
        [ 52, 187, 217]],

       [[  2, 164, 216],
        [  2, 164, 216],
        [  1, 164, 215],
        ...,
        [ 94, 208, 235],
        [ 85, 201, 229],
        [ 78, 192, 222]],

       ...,

       [[162, 124,  93],
        [166, 130,  98],
        [163, 128,  97],
        ...,
        [  4,  44,  40],
        [  2,  64,  55],
        [  8,  74,  67]],

       [[198, 176, 150],
        [190, 168, 143],
        [162, 141, 116],
        ...,
        [  9,  55,  54],
        [  1,  63,  57],
        [  0,  56,  52]],

       [[204, 197, 177],
        [209, 202, 182],
        [201, 195, 174],
        ...,
        [  2,  25,  30],
        [  2,  37,  40],
        [  0,  30,  31]]], dtype=uint8)]"
Image_416.jpg,1002,388,167,200,2000,1000,1169,588,200,daskShared_local/images/Image_416.jpg,416,"[array([[[190, 167, 133],
        [196, 173, 139],
        [199, 176, 142],
        ...,
        [211, 188, 156],
        [210, 191, 159],
        [217, 198, 165]],

       [[193, 170, 136],
        [196, 173, 139],
        [199, 179, 144],
        ...,
        [208, 186, 149],
        [210, 187, 153],
        [214, 194, 159]],

       [[194, 171, 137],
        [195, 172, 138],
        [199, 176, 142],
        ...,
        [203, 180, 139],
        [206, 180, 145],
        [210, 188, 151]],

       ...,

       [[135, 128,  99],
        [143, 135, 107],
        [138, 131, 103],
        ...,
        [209, 187, 148],
        [218, 194, 158],
        [208, 186, 146]],

       [[145, 142, 111],
        [134, 131, 100],
        [139, 134, 105],
        ...,
        [197, 177, 144],
        [206, 186, 151],
        [215, 195, 160]],

       [[144, 139, 110],
        [128, 123,  94],
        [135, 129, 103],
        ...,
        [192, 173, 141],
        [200, 180, 145],
        [210, 190, 155]]], dtype=uint8)]"
Image_417.jpg,389,84,110,73,580,435,499,157,110,daskShared_local/images/Image_417.jpg,417,"[array([[[ 70, 118, 118],
        [ 70, 118, 118],
        [ 73, 121, 121],
        ...,
        [ 85, 145, 139],
        [ 87, 146, 140],
        [ 87, 146, 140]],

       [[ 71, 119, 119],
        [ 71, 119, 119],
        [ 74, 122, 122],
        ...,
        [ 84, 144, 138],
        [ 86, 146, 139],
        [ 87, 146, 139]],

       [[ 75, 123, 123],
        [ 76, 124, 124],
        [ 78, 126, 126],
        ...,
        [ 80, 140, 132],
        [ 83, 143, 134],
        [ 83, 143, 134]],

       ...,

       [[136, 175, 156],
        [136, 175, 156],
        [137, 176, 157],
        ...,
        [ 63,  97,  63],
        [ 72, 106,  75],
        [ 74, 107,  77]],

       [[147, 186, 167],
        [150, 189, 171],
        [167, 206, 188],
        ...,
        [ 61,  94,  61],
        [ 70, 104,  73],
        [ 72, 105,  75]],

       [[149, 188, 169],
        [153, 192, 174],
        [173, 212, 194],
        ...,
        [ 60,  94,  61],
        [ 70, 103,  73],
        [ 72, 105,  75]]], dtype=uint8)]"
Image_418.jpg,313,308,146,126,966,642,459,434,146,daskShared_local/images/Image_418.jpg,418,"[array([[[ 36, 205, 211],
        [ 35, 204, 211],
        [ 32, 203, 209],
        ...,
        [ 45,  17,  10],
        [ 28,   9,   2],
        [ 24,   5,   1]],

       [[ 37, 206, 211],
        [ 37, 206, 210],
        [ 35, 205, 208],
        ...,
        [ 60,  34,  22],
        [ 35,  16,   7],
        [ 26,   8,   1]],

       [[ 37, 206, 212],
        [ 38, 205, 210],
        [ 38, 204, 208],
        ...,
        [ 90,  58,  39],
        [ 53,  29,  14],
        [ 35,  14,   3]],

       ...,

       [[ 17, 198, 209],
        [ 22, 202, 214],
        [ 27, 206, 219],
        ...,
        [ 54, 222, 230],
        [ 61, 227, 236],
        [ 65, 230, 239]],

       [[ 20, 199, 211],
        [ 23, 202, 213],
        [ 26, 205, 217],
        ...,
        [ 54, 225, 231],
        [ 58, 230, 236],
        [ 61, 232, 238]],

       [[ 22, 201, 213],
        [ 24, 202, 214],
        [ 25, 204, 215],
        ...,
        [ 54, 228, 233],
        [ 55, 231, 235],
        [ 56, 232, 236]]], dtype=uint8)]"
Image_419.jpg,86,18,99,74,531,336,185,92,99,daskShared_local/images/Image_419.jpg,419,"[array([[[  7, 120, 124],
        [  7, 120, 124],
        [  7, 120, 124],
        ...,
        [  8, 134, 133],
        [  9, 135, 134],
        [  9, 135, 134]],

       [[  7, 120, 124],
        [  7, 120, 124],
        [  7, 120, 124],
        ...,
        [  8, 134, 133],
        [  9, 135, 134],
        [  9, 135, 134]],

       [[  8, 121, 125],
        [  8, 121, 125],
        [  8, 121, 125],
        ...,
        [  7, 133, 132],
        [  9, 135, 134],
        [  9, 135, 134]],

       ...,

       [[  7, 125, 125],
        [  7, 125, 125],
        [  8, 126, 127],
        ...,
        [152,  95,  37],
        [153,  97,  39],
        [153,  97,  39]],

       [[  6, 124, 124],
        [  6, 124, 124],
        [  6, 124, 125],
        ...,
        [150,  90,  32],
        [153,  93,  36],
        [153,  93,  36]],

       [[  6, 124, 124],
        [  6, 124, 124],
        [  6, 124, 125],
        ...,
        [150,  90,  32],
        [153,  93,  36],
        [153,  93,  36]]], dtype=uint8)]"
Image_42.jpg,1801,1132,214,208,2015,1510,2015,1340,214,daskShared_local/images/Image_42.jpg,42,"[array([[[ 30,  29,  34],
        [ 24,  24,  26],
        [ 17,  17,  17],
        ...,
        [139, 138, 133],
        [139, 138, 133],
        [142, 141, 136]],

       [[ 30,  29,  34],
        [ 24,  24,  25],
        [ 16,  16,  16],
        ...,
        [139, 138, 133],
        [138, 137, 133],
        [141, 140, 136]],

       [[ 26,  25,  30],
        [ 20,  20,  22],
        [ 15,  15,  15],
        ...,
        [138, 137, 133],
        [138, 137, 133],
        [139, 138, 134]],

       ...,

       [[100,  91,  82],
        [104,  95,  86],
        [109, 100,  91],
        ...,
        [164, 155, 148],
        [163, 154, 147],
        [166, 157, 150]],

       [[ 96,  87,  78],
        [ 99,  90,  81],
        [106,  97,  88],
        ...,
        [165, 157, 151],
        [163, 154, 149],
        [163, 154, 149]],

       [[102,  93,  84],
        [101,  92,  83],
        [100,  91,  82],
        ...,
        [171, 163, 157],
        [167, 158, 153],
        [164, 154, 152]]], dtype=uint8)]"
Image_420.jpg,130,91,155,121,500,333,285,212,155,daskShared_local/images/Image_420.jpg,420,"[array([[[ 27,  42,  61],
        [ 27,  42,  61],
        [ 27,  42,  61],
        ...,
        [ 26,  44,  66],
        [ 26,  44,  66],
        [ 26,  44,  66]],

       [[ 27,  42,  61],
        [ 27,  42,  61],
        [ 27,  42,  61],
        ...,
        [ 26,  44,  66],
        [ 26,  44,  66],
        [ 26,  44,  66]],

       [[ 27,  42,  61],
        [ 27,  42,  61],
        [ 27,  42,  61],
        ...,
        [ 26,  44,  66],
        [ 26,  44,  66],
        [ 26,  44,  66]],

       ...,

       [[ 24,  42,  56],
        [ 24,  42,  56],
        [ 25,  43,  57],
        ...,
        [114, 130, 123],
        [115, 131, 123],
        [115, 132, 124]],

       [[ 24,  42,  56],
        [ 25,  43,  57],
        [ 25,  43,  57],
        ...,
        [116, 133, 125],
        [116, 133, 125],
        [116, 133, 125]],

       [[ 25,  43,  57],
        [ 25,  43,  57],
        [ 25,  43,  57],
        ...,
        [117, 134, 126],
        [117, 134, 126],
        [116, 133, 125]]], dtype=uint8)]"
Image_421.jpg,697,302,500,485,1920,1080,1197,787,500,daskShared_local/images/Image_421.jpg,421,"[array([[[ 43,  59,  49],
        [ 46,  64,  51],
        [ 44,  66,  53],
        ...,
        [ 47,  72,  74],
        [ 35,  62,  63],
        [ 33,  69,  67]],

       [[ 47,  63,  53],
        [ 47,  67,  54],
        [ 45,  69,  57],
        ...,
        [ 51,  77,  78],
        [ 34,  72,  69],
        [ 30,  76,  71]],

       [[ 45,  62,  52],
        [ 44,  67,  54],
        [ 43,  69,  59],
        ...,
        [ 38,  77,  73],
        [ 40,  91,  84],
        [ 45, 104,  96]],

       ...,

       [[ 30,  97, 147],
        [ 29,  96, 148],
        [ 28,  94, 146],
        ...,
        [ 21,  37,  36],
        [ 18,  33,  30],
        [ 22,  37,  34]],

       [[ 29,  96, 146],
        [ 30,  97, 149],
        [ 29,  95, 146],
        ...,
        [ 22,  38,  37],
        [ 22,  38,  35],
        [ 21,  37,  34]],

       [[ 28,  96, 145],
        [ 30,  97, 148],
        [ 29,  95, 147],
        ...,
        [ 24,  40,  39],
        [ 25,  40,  37],
        [ 23,  38,  35]]], dtype=uint8)]"
Image_422.jpg,387,107,180,169,800,600,567,276,180,daskShared_local/images/Image_422.jpg,422,"[array([[[239, 235, 238],
        [250, 249, 247],
        [247, 249, 243],
        ...,
        [ 72, 148, 115],
        [ 78, 152, 122],
        [ 83, 158, 127]],

       [[253, 249, 240],
        [251, 249, 237],
        [246, 248, 232],
        ...,
        [ 72, 146, 116],
        [ 72, 145, 115],
        [ 74, 148, 118]],

       [[254, 253, 232],
        [251, 251, 228],
        [246, 250, 223],
        ...,
        [ 61, 136, 106],
        [ 58, 131, 102],
        [ 64, 137, 108]],

       ...,

       [[238, 138,  30],
        [236, 138,  31],
        [236, 136,  33],
        ...,
        [113, 141, 109],
        [ 92, 110,  84],
        [ 57,  70,  49]],

       [[233, 134,  28],
        [230, 131,  27],
        [228, 129,  27],
        ...,
        [102, 126,  99],
        [ 81,  94,  75],
        [ 44,  52,  38]],

       [[232, 131,  25],
        [229, 130,  26],
        [227, 128,  27],
        ...,
        [ 86, 103,  82],
        [ 58,  65,  52],
        [ 46,  47,  40]]], dtype=uint8)]"
Image_423.jpg,176,353,215,164,1200,900,391,517,215,daskShared_local/images/Image_423.jpg,423,"[array([[[101, 123, 111],
        [ 88, 129, 126],
        [ 72, 127, 126],
        ...,
        [ 14, 170, 182],
        [ 18, 176, 185],
        [ 32, 189, 191]],

       [[108, 121, 103],
        [ 86, 117, 109],
        [ 71, 120, 116],
        ...,
        [ 21, 193, 192],
        [ 32, 194, 196],
        [ 45, 188, 194]],

       [[145, 147, 122],
        [100, 120, 104],
        [ 67, 109, 102],
        ...,
        [ 34, 186, 183],
        [ 30, 177, 177],
        [ 25, 164, 171]],

       ...,

       [[ 58,  65,  65],
        [ 46,  61,  57],
        [ 35,  61,  53],
        ...,
        [  2,   3,   8],
        [  1,   4,   4],
        [  4,   7,   1]],

       [[ 61,  71,  61],
        [ 52,  65,  53],
        [ 42,  60,  47],
        ...,
        [ 12,  11,   7],
        [ 18,  18,  11],
        [ 28,  27,  15]],

       [[ 73,  87,  65],
        [ 73,  84,  63],
        [ 71,  78,  61],
        ...,
        [ 39,  35,  21],
        [ 53,  50,  34],
        [ 61,  57,  37]]], dtype=uint8)]"
Image_424.jpg,64,138,121,104,525,340,185,242,121,daskShared_local/images/Image_424.jpg,424,"[array([[[ 35,  86,  97],
        [ 34,  85,  96],
        [ 32,  82,  93],
        ...,
        [173, 202, 173],
        [148, 173, 141],
        [137, 160, 127]],

       [[ 41,  92, 104],
        [ 39,  90, 102],
        [ 34,  85,  97],
        ...,
        [168, 197, 167],
        [145, 169, 137],
        [135, 157, 124]],

       [[ 56, 108, 121],
        [ 52, 104, 117],
        [ 42,  94, 107],
        ...,
        [154, 183, 153],
        [135, 160, 127],
        [128, 151, 116]],

       ...,

       [[ 33,  45,  39],
        [ 31,  43,  37],
        [ 25,  37,  31],
        ...,
        [  6,  19,   6],
        [ 21,  38,  22],
        [ 26,  46,  28]],

       [[ 49,  54,  49],
        [ 39,  44,  39],
        [ 13,  19,  13],
        ...,
        [ 18,  36,  19],
        [ 27,  46,  28],
        [ 30,  49,  31]],

       [[ 55,  58,  52],
        [ 42,  45,  40],
        [  9,  12,   7],
        ...,
        [ 25,  44,  27],
        [ 30,  50,  31],
        [ 32,  52,  33]]], dtype=uint8)]"
Image_425.jpg,358,104,302,282,1024,670,660,386,302,daskShared_local/images/Image_425.jpg,425,"[array([[[  3,  66, 112],
        [  5,  67, 111],
        [  2,  63, 107],
        ...,
        [  6,  18,  31],
        [  8,  20,  34],
        [  4,  16,  30]],

       [[  1,  64, 104],
        [  0,  64, 106],
        [  1,  63, 108],
        ...,
        [  8,  19,  44],
        [  6,  17,  41],
        [  3,  14,  33]],

       [[  1,  64, 106],
        [  4,  67, 111],
        [  2,  65, 111],
        ...,
        [  6,  18,  45],
        [  7,  17,  44],
        [  5,  16,  37]],

       ...,

       [[ 55, 122,  82],
        [  7,  54,  27],
        [ 23,  58,  22],
        ...,
        [  9,  28,  33],
        [ 10,  29,  33],
        [  8,  28,  31]],

       [[ 52, 119,  77],
        [ 11,  61,  30],
        [ 25,  61,  24],
        ...,
        [ 11,  29,  34],
        [ 10,  28,  32],
        [  5,  23,  27]],

       [[ 30,  84,  40],
        [ 15,  61,  21],
        [ 15,  55,  13],
        ...,
        [  9,  23,  28],
        [  8,  23,  28],
        [  6,  23,  27]]], dtype=uint8)]"
Image_426.jpg,405,306,229,218,1500,1000,634,524,229,daskShared_local/images/Image_426.jpg,426,"[array([[[  1, 143, 163],
        [  0, 140, 160],
        [  0, 137, 157],
        ...,
        [  0, 121, 140],
        [  0, 119, 137],
        [  0, 114, 133]],

       [[  4, 150, 168],
        [  1, 145, 164],
        [  0, 142, 161],
        ...,
        [  0, 124, 142],
        [  1, 125, 143],
        [  1, 122, 140]],

       [[  4, 153, 172],
        [  1, 148, 168],
        [  0, 146, 167],
        ...,
        [  1, 129, 148],
        [  6, 133, 152],
        [  6, 133, 151]],

       ...,

       [[167, 193, 159],
        [184, 205, 170],
        [199, 218, 181],
        ...,
        [208, 191, 142],
        [203, 187, 140],
        [193, 179, 132]],

       [[127, 158, 129],
        [149, 176, 147],
        [167, 192, 161],
        ...,
        [174, 160, 104],
        [165, 153,  99],
        [158, 148,  95]],

       [[129, 162, 135],
        [135, 168, 141],
        [142, 170, 144],
        ...,
        [ 99,  86,  27],
        [102,  91,  35],
        [111, 102,  47]]], dtype=uint8)]"
Image_427.jpg,675,292,291,321,1600,900,966,613,321,daskShared_local/images/Image_427.jpg,427,"[array([[[  0, 116, 199],
        [  0, 116, 199],
        [  0, 116, 199],
        ...,
        [  1, 117, 202],
        [  1, 117, 202],
        [  0, 118, 202]],

       [[  0, 116, 199],
        [  0, 116, 199],
        [  0, 116, 199],
        ...,
        [  0, 116, 201],
        [  0, 116, 201],
        [  1, 117, 202]],

       [[  0, 116, 199],
        [  0, 116, 199],
        [  0, 116, 199],
        ...,
        [  1, 117, 202],
        [  1, 117, 202],
        [  1, 117, 202]],

       ...,

       [[201, 197, 158],
        [210, 207, 168],
        [179, 175, 139],
        ...,
        [116, 133,  94],
        [ 84,  98,  62],
        [ 80,  90,  59]],

       [[163, 160, 127],
        [155, 152, 121],
        [168, 165, 135],
        ...,
        [115, 130, 100],
        [107, 119,  92],
        [ 75,  81,  57]],

       [[212, 210, 184],
        [212, 212, 187],
        [220, 219, 196],
        ...,
        [ 55,  66,  44],
        [ 63,  72,  52],
        [ 62,  67,  49]]], dtype=uint8)]"
Image_428.jpg,127,176,161,127,900,695,288,303,161,daskShared_local/images/Image_428.jpg,428,"[array([[[  7, 135, 160],
        [  7, 136, 162],
        [  7, 137, 163],
        ...,
        [  8, 144, 168],
        [  8, 144, 168],
        [  8, 144, 168]],

       [[  7, 135, 160],
        [  6, 136, 161],
        [  6, 136, 161],
        ...,
        [  8, 144, 169],
        [  8, 144, 169],
        [  8, 144, 169]],

       [[  7, 135, 160],
        [  6, 136, 160],
        [  6, 136, 160],
        ...,
        [  8, 144, 170],
        [  8, 144, 170],
        [  8, 144, 170]],

       ...,

       [[  5, 133, 160],
        [  7, 132, 160],
        [  8, 132, 160],
        ...,
        [ 13, 151, 179],
        [ 13, 151, 179],
        [ 13, 151, 179]],

       [[  5, 133, 160],
        [  7, 132, 160],
        [  8, 132, 160],
        ...,
        [ 13, 151, 180],
        [ 13, 151, 180],
        [ 12, 150, 179]],

       [[  5, 133, 160],
        [  7, 132, 160],
        [  8, 132, 160],
        ...,
        [ 13, 151, 180],
        [ 13, 151, 180],
        [ 12, 150, 179]]], dtype=uint8)]"
Image_429.jpg,403,42,1064,967,1920,1080,1467,1009,1064,daskShared_local/images/Image_429.jpg,429,"[array([[[  1, 124, 156],
        [  1, 124, 157],
        [  0, 124, 157],
        ...,
        [ 43, 118,  99],
        [ 35, 125, 110],
        [  7,  98, 100]],

       [[  0, 123, 155],
        [  0, 124, 156],
        [  0, 124, 157],
        ...,
        [ 29, 114, 103],
        [ 24, 122, 115],
        [  4,  98, 102]],

       [[  0, 123, 155],
        [  0, 123, 156],
        [  0, 123, 156],
        ...,
        [ 52, 112,  90],
        [ 48, 117, 100],
        [ 15,  89,  88]],

       ...,

       [[116, 108,  70],
        [106,  99,  62],
        [112, 107,  65],
        ...,
        [ 13,  23,  25],
        [ 14,  24,  25],
        [ 14,  22,  25]],

       [[102,  93,  56],
        [110, 100,  61],
        [131, 122,  79],
        ...,
        [ 14,  23,  21],
        [ 15,  23,  23],
        [ 15,  21,  23]],

       [[112, 102,  60],
        [135, 120,  75],
        [128, 115,  71],
        ...,
        [ 14,  20,  22],
        [ 15,  20,  21],
        [ 16,  20,  21]]], dtype=uint8)]"
Image_43.jpg,212,36,217,181,900,521,429,217,217,daskShared_local/images/Image_43.jpg,43,"[array([[[ 16,  58, 170],
        [ 17,  59, 171],
        [ 17,  59, 171],
        ...,
        [ 33,  68, 184],
        [ 33,  68, 184],
        [ 33,  68, 184]],

       [[ 16,  58, 170],
        [ 17,  59, 171],
        [ 17,  59, 171],
        ...,
        [ 33,  68, 184],
        [ 33,  68, 184],
        [ 33,  68, 184]],

       [[ 16,  58, 170],
        [ 17,  59, 171],
        [ 17,  59, 171],
        ...,
        [ 33,  68, 184],
        [ 33,  68, 184],
        [ 33,  68, 184]],

       ...,

       [[  0,  55, 138],
        [  0,  55, 140],
        [  0,  54, 144],
        ...,
        [187, 207, 206],
        [205, 224, 223],
        [218, 238, 236]],

       [[  0,  56, 137],
        [  0,  55, 141],
        [  0,  55, 145],
        ...,
        [187, 207, 206],
        [208, 228, 227],
        [224, 244, 243]],

       [[  0,  57, 136],
        [  0,  56, 140],
        [  0,  56, 144],
        ...,
        [180, 199, 197],
        [204, 223, 221],
        [227, 246, 244]]], dtype=uint8)]"
Image_430.jpg,136,38,135,138,425,282,271,176,138,daskShared_local/images/Image_430.jpg,430,"[array([[[  0,  84, 131],
        [  1,  83, 131],
        [  1,  82, 130],
        ...,
        [  0, 121, 168],
        [  0, 122, 169],
        [  1, 122, 169]],

       [[  1,  83, 131],
        [  0,  82, 130],
        [  0,  81, 130],
        ...,
        [  0, 120, 167],
        [  0, 121, 168],
        [  0, 122, 169]],

       [[  1,  82, 130],
        [  0,  81, 130],
        [  0,  80, 129],
        ...,
        [  0, 118, 166],
        [  0, 119, 166],
        [  0, 119, 167]],

       ...,

       [[  5,   6,   4],
        [  6,   8,   6],
        [  6,  12,  11],
        ...,
        [ 11,  81,  91],
        [ 19,  81,  90],
        [ 26,  83,  91]],

       [[  4,   5,   2],
        [  5,   8,   5],
        [  6,  12,  10],
        ...,
        [  0,  70,  81],
        [  2,  67,  77],
        [  4,  66,  76]],

       [[  4,   6,   1],
        [  5,   8,   4],
        [  6,  12,   9],
        ...,
        [  0,  66,  77],
        [  1,  63,  74],
        [  2,  63,  73]]], dtype=uint8)]"
Image_431.png,58,8,88,87,400,267,146,95,88,daskShared_local/images/Image_431.png,431,"[array([[[255, 255, 255],
        [255, 255, 255],
        [255, 255, 255],
        ...,
        [255, 255, 255],
        [255, 255, 255],
        [255, 255, 255]],

       [[255, 255, 255],
        [255, 255, 255],
        [255, 255, 255],
        ...,
        [255, 255, 255],
        [255, 255, 255],
        [255, 255, 255]],

       [[255, 255, 255],
        [255, 255, 255],
        [255, 255, 255],
        ...,
        [255, 255, 255],
        [255, 255, 255],
        [255, 255, 255]],

       ...,

       [[255, 255, 255],
        [255, 255, 255],
        [255, 255, 255],
        ...,
        [197, 193, 145],
        [201, 195, 136],
        [200, 194, 138]],

       [[255, 255, 255],
        [255, 255, 255],
        [255, 255, 255],
        ...,
        [205, 199, 149],
        [213, 206, 140],
        [211, 205, 142]],

       [[255, 255, 255],
        [255, 255, 255],
        [255, 255, 255],
        ...,
        [203, 198, 148],
        [210, 203, 139],
        [209, 202, 141]]], dtype=uint8)]"
Image_432.jpg,332,36,124,79,623,200,456,115,124,daskShared_local/images/Image_432.jpg,432,"[array([[[  0, 163, 252],
        [  0, 163, 252],
        [  0, 163, 252],
        ...,
        [  2, 130, 255],
        [  2, 130, 255],
        [  2, 130, 255]],

       [[  0, 163, 252],
        [  0, 163, 252],
        [  0, 163, 252],
        ...,
        [  2, 130, 255],
        [  2, 130, 255],
        [  2, 130, 255]],

       [[  0, 163, 252],
        [  0, 163, 252],
        [  0, 163, 252],
        ...,
        [  2, 130, 255],
        [  2, 130, 255],
        [  2, 130, 255]],

       ...,

       [[ 36,  52,  49],
        [ 27,  42,  39],
        [  7,  21,  17],
        ...,
        [  6, 101, 252],
        [  8, 101, 250],
        [  9, 101, 250]],

       [[ 39,  56,  50],
        [ 32,  47,  41],
        [ 14,  29,  23],
        ...,
        [  4, 100, 254],
        [  5, 100, 253],
        [  6, 100, 253]],

       [[ 40,  56,  49],
        [ 33,  49,  42],
        [ 17,  32,  25],
        ...,
        [  3,  99, 255],
        [  4,  99, 254],
        [  5,  99, 254]]], dtype=uint8)]"
Image_433.jpg,505,370,193,166,1024,678,698,536,193,daskShared_local/images/Image_433.jpg,433,"[array([[[147, 116, 113],
        [134, 113, 112],
        [188, 176, 174],
        ...,
        [168, 161, 136],
        [132, 127, 109],
        [ 61,  62,  59]],

       [[151, 124, 113],
        [130, 111, 105],
        [136, 122, 118],
        ...,
        [186, 174, 152],
        [172, 160, 149],
        [ 36,  32,  33]],

       [[144, 122, 108],
        [141, 119, 101],
        [143, 119, 100],
        ...,
        [111,  89,  74],
        [110,  93,  73],
        [127, 111,  93]],

       ...,

       [[240, 235, 205],
        [237, 231, 204],
        [243, 236, 208],
        ...,
        [224, 195, 151],
        [232, 205, 160],
        [229, 204, 154]],

       [[240, 230, 197],
        [236, 226, 191],
        [238, 228, 193],
        ...,
        [230, 202, 158],
        [245, 228, 185],
        [235, 220, 177]],

       [[231, 219, 181],
        [227, 213, 176],
        [230, 218, 180],
        ...,
        [254, 237, 191],
        [245, 233, 189],
        [233, 221, 179]]], dtype=uint8)]"
Image_434.jpg,186,100,352,293,1024,670,538,393,352,daskShared_local/images/Image_434.jpg,434,"[array([[[ 29,  46,  54],
        [ 28,  43,  54],
        [ 26,  40,  52],
        ...,
        [ 52, 135, 139],
        [ 49, 134, 139],
        [ 42, 124, 129]],

       [[ 28,  45,  49],
        [ 14,  29,  36],
        [ 24,  36,  44],
        ...,
        [ 49, 126, 123],
        [ 35, 113, 110],
        [ 54, 133, 130]],

       [[ 31,  45,  50],
        [ 14,  24,  32],
        [ 21,  28,  38],
        ...,
        [ 49, 106, 105],
        [ 42, 102, 100],
        [ 43, 109, 103]],

       ...,

       [[ 78, 223, 241],
        [ 67, 205, 219],
        [ 49, 151, 169],
        ...,
        [ 49, 166, 173],
        [ 23, 147, 157],
        [ 45, 152, 168]],

       [[ 54, 193, 214],
        [ 48, 175, 196],
        [ 64, 156, 179],
        ...,
        [ 80, 190, 197],
        [ 35, 159, 170],
        [ 43, 155, 176]],

       [[ 58, 196, 211],
        [ 45, 166, 180],
        [ 56, 146, 163],
        ...,
        [ 66, 183, 191],
        [ 44, 167, 181],
        [ 47, 154, 179]]], dtype=uint8)]"
Image_435.jpg,164,9,102,97,498,272,266,106,102,daskShared_local/images/Image_435.jpg,435,"[array([[[  1,  32,  66],
        [  1,  32,  66],
        [  1,  33,  67],
        ...,
        [  0,  26,  50],
        [  0,  26,  51],
        [  0,  26,  51]],

       [[  1,  32,  66],
        [  1,  32,  66],
        [  1,  33,  67],
        ...,
        [  0,  26,  50],
        [  0,  26,  51],
        [  0,  26,  51]],

       [[  2,  35,  71],
        [  2,  35,  71],
        [  2,  36,  72],
        ...,
        [  0,  26,  50],
        [  1,  27,  52],
        [  1,  27,  52]],

       ...,

       [[198, 196, 119],
        [197, 195, 119],
        [177, 179, 116],
        ...,
        [179, 188, 177],
        [172, 182, 171],
        [171, 181, 171]],

       [[169, 169, 108],
        [168, 168, 107],
        [140, 144,  97],
        ...,
        [172, 182, 169],
        [159, 170, 158],
        [158, 169, 158]],

       [[168, 168, 107],
        [166, 166, 107],
        [138, 141,  96],
        ...,
        [171, 182, 169],
        [158, 169, 158],
        [157, 169, 157]]], dtype=uint8)]"
Image_436.jpg,386,22,570,523,1190,595,956,545,570,daskShared_local/images/Image_436.jpg,436,"[array([[[191, 217, 228],
        [194, 217, 229],
        [199, 222, 231],
        ...,
        [202, 215, 207],
        [201, 214, 207],
        [201, 213, 207]],

       [[193, 220, 231],
        [194, 220, 231],
        [195, 218, 230],
        ...,
        [201, 215, 206],
        [201, 214, 207],
        [200, 212, 204]],

       [[191, 219, 231],
        [191, 217, 229],
        [192, 215, 227],
        ...,
        [201, 214, 206],
        [200, 214, 206],
        [201, 213, 203]],

       ...,

       [[ 10,   6,  10],
        [  9,   4,   4],
        [  6,   3,   4],
        ...,
        [153, 127, 125],
        [150, 113, 112],
        [151, 116, 114]],

       [[ 23,  10,  15],
        [ 16,   5,   6],
        [  6,   3,   3],
        ...,
        [145, 111, 109],
        [142, 108, 106],
        [144, 114, 112]],

       [[ 33,   7,  10],
        [ 27,   7,   7],
        [ 16,   5,   4],
        ...,
        [140, 104, 102],
        [135, 105, 101],
        [135, 105, 104]]], dtype=uint8)]"
Image_437.jpg,27,161,134,104,575,383,161,265,134,daskShared_local/images/Image_437.jpg,437,"[array([[[ 51,  87, 209],
        [ 52,  88, 210],
        [ 52,  88, 210],
        ...,
        [  2,  36,  97],
        [  2,  32,  96],
        [  2,  28,  93]],

       [[ 51,  87, 209],
        [ 52,  88, 210],
        [ 52,  88, 210],
        ...,
        [  5,  42, 102],
        [  6,  39, 101],
        [  6,  37,  99]],

       [[ 51,  87, 209],
        [ 52,  88, 210],
        [ 52,  88, 210],
        ...,
        [  8,  46, 105],
        [  9,  46, 104],
        [ 10,  46, 103]],

       ...,

       [[ 20,  68, 176],
        [ 19,  67, 175],
        [ 19,  67, 175],
        ...,
        [ 35,  82, 190],
        [ 35,  82, 191],
        [ 36,  82, 192]],

       [[ 20,  68, 176],
        [ 20,  68, 176],
        [ 21,  69, 177],
        ...,
        [ 32,  79, 187],
        [ 33,  80, 189],
        [ 35,  81, 192]],

       [[ 21,  69, 177],
        [ 21,  69, 177],
        [ 22,  70, 178],
        ...,
        [ 30,  77, 185],
        [ 32,  79, 188],
        [ 34,  80, 191]]], dtype=uint8)]"
Image_438.jpg,198,120,418,305,800,533,616,425,418,daskShared_local/images/Image_438.jpg,438,"[array([[[  9,  23,  23],
        [ 15,  25,  31],
        [ 24,  31,  47],
        ...,
        [  4, 114, 191],
        [  5, 115, 194],
        [  9, 109, 194]],

       [[  3,   9,  16],
        [  8,  17,  26],
        [ 16,  29,  47],
        ...,
        [  2, 110, 189],
        [  4, 111, 191],
        [  9, 111, 193]],

       [[  2,   2,  17],
        [  1,   8,  19],
        [  5,  29,  42],
        ...,
        [  5, 109, 191],
        [  6, 109, 191],
        [  5, 110, 188]],

       ...,

       [[ 14, 149, 155],
        [ 21, 159, 164],
        [ 20, 169, 172],
        ...,
        [ 63,  99, 104],
        [ 52,  87,  94],
        [ 49,  84,  89]],

       [[ 24, 153, 157],
        [ 18, 157, 161],
        [ 31, 189, 192],
        ...,
        [ 59, 104, 114],
        [ 50,  87,  98],
        [ 47,  83,  87]],

       [[ 30, 166, 162],
        [ 24, 168, 170],
        [ 33, 190, 201],
        ...,
        [ 49,  99, 108],
        [ 49,  87, 101],
        [ 50,  88,  95]]], dtype=uint8)]"
Image_439.jpg,1622,532,887,704,4100,2660,2509,1236,887,daskShared_local/images/Image_439.jpg,439,"[array([[[186, 172, 160],
        [190, 177, 162],
        [193, 180, 169],
        ...,
        [144, 135, 117],
        [139, 131, 112],
        [137, 129, 109]],

       [[188, 176, 164],
        [193, 180, 168],
        [193, 180, 168],
        ...,
        [146, 137, 123],
        [146, 136, 122],
        [141, 132, 114]],

       [[190, 178, 167],
        [196, 184, 172],
        [191, 178, 163],
        ...,
        [150, 138, 125],
        [148, 137, 123],
        [146, 137, 120]],

       ...,

       [[185, 169, 160],
        [175, 161, 146],
        [179, 167, 150],
        ...,
        [141, 124,  96],
        [142, 125,  98],
        [139, 122,  94]],

       [[171, 155, 137],
        [176, 160, 144],
        [178, 165, 151],
        ...,
        [119, 103,  68],
        [123, 105,  77],
        [126, 107,  76]],

       [[171, 153, 138],
        [169, 152, 135],
        [175, 163, 145],
        ...,
        [125, 108,  79],
        [130, 113,  83],
        [133, 113,  87]]], dtype=uint8)]"
Image_44.jpg,101,261,171,115,900,600,272,376,171,daskShared_local/images/Image_44.jpg,44,"[array([[[  1,  75,  84],
        [  1,  75,  85],
        [  2,  75,  88],
        ...,
        [  1,  89, 105],
        [  0,  89, 104],
        [  1,  90, 104]],

       [[  3,  73,  83],
        [  2,  73,  84],
        [  3,  73,  87],
        ...,
        [  1,  90, 106],
        [  0,  90, 104],
        [  0,  90, 103]],

       [[  2,  74,  83],
        [  1,  73,  84],
        [  3,  72,  86],
        ...,
        [  2,  92, 107],
        [  1,  92, 106],
        [  0,  92, 104]],

       ...,

       [[  0,  71,  80],
        [  0,  69,  78],
        [  0,  67,  78],
        ...,
        [ 17,  49,  44],
        [ 15,  47,  42],
        [ 15,  47,  42]],

       [[  0,  75,  82],
        [  0,  72,  80],
        [  0,  71,  80],
        ...,
        [ 18,  50,  46],
        [ 16,  48,  44],
        [ 15,  48,  43]],

       [[  0,  76,  84],
        [  0,  74,  82],
        [  0,  74,  82],
        ...,
        [ 17,  52,  48],
        [ 16,  51,  47],
        [ 16,  51,  47]]], dtype=uint8)]"
Image_440.jpg,240,71,332,347,800,600,572,418,347,daskShared_local/images/Image_440.jpg,440,"[array([[[ 35, 113, 145],
        [ 18,  95, 129],
        [  7,  90, 130],
        ...,
        [  1,  96, 168],
        [  2,  95, 169],
        [  3,  96, 170]],

       [[ 31, 144, 188],
        [ 41, 151, 166],
        [ 57, 136, 142],
        ...,
        [  2,  95, 169],
        [  3,  97, 171],
        [  2,  96, 170]],

       [[ 82, 196, 210],
        [ 82, 180, 198],
        [ 67, 152, 167],
        ...,
        [  3,  97, 171],
        [  2,  96, 170],
        [  1,  95, 169]],

       ...,

       [[145, 157,  99],
        [129, 141,  78],
        [121, 133,  94],
        ...,
        [  4,  28,   2],
        [ 11,  39,  10],
        [ 17,  54,  17]],

       [[134, 161,  97],
        [135, 152, 103],
        [139, 149, 106],
        ...,
        [  9,  39,   8],
        [ 11,  29,   3],
        [ 16,  46,  11]],

       [[133, 160,  89],
        [137, 164, 114],
        [142, 170, 115],
        ...,
        [ 16,  59,  20],
        [  3,  26,   3],
        [ 15,  36,  11]]], dtype=uint8)]"
Image_441.jpg,372,120,162,115,624,468,534,235,162,daskShared_local/images/Image_441.jpg,441,"[array([[[ 10,  69, 123],
        [  9,  56, 106],
        [  4,  38,  81],
        ...,
        [  4,  26,  32],
        [  4,  21,  27],
        [  4,  14,  20]],

       [[ 12,  67, 122],
        [ 13,  59, 110],
        [  7,  43,  88],
        ...,
        [  3,  25,  33],
        [  1,  18,  24],
        [  1,  12,  16]],

       [[  6,  63, 112],
        [ 10,  58, 106],
        [  8,  46,  90],
        ...,
        [  6,  22,  29],
        [  3,  16,  20],
        [  4,  12,  13]],

       ...,

       [[158, 125,  86],
        [169, 135,  94],
        [171, 135,  90],
        ...,
        [ 23,  11,  10],
        [ 24,  11,  11],
        [ 28,  17,  16]],

       [[155, 124,  84],
        [166, 132,  91],
        [175, 139,  96],
        ...,
        [ 22,  12,  12],
        [ 23,  12,  12],
        [ 28,  18,  18]],

       [[165, 135,  95],
        [168, 136,  95],
        [175, 140,  97],
        ...,
        [ 20,  11,  14],
        [ 21,  12,  14],
        [ 26,  17,  18]]], dtype=uint8)]"
Image_442.jpg,2250,278,590,497,3033,1757,2840,775,590,daskShared_local/images/Image_442.jpg,442,"[array([[[  0,  53, 217],
        [  0,  53, 217],
        [  0,  53, 217],
        ...,
        [  0,  53, 217],
        [  0,  53, 217],
        [  0,  53, 217]],

       [[  0,  53, 217],
        [  0,  53, 217],
        [  0,  53, 217],
        ...,
        [  0,  53, 217],
        [  0,  53, 217],
        [  0,  53, 217]],

       [[  0,  53, 217],
        [  0,  53, 217],
        [  0,  53, 217],
        ...,
        [  0,  53, 217],
        [  0,  53, 217],
        [  0,  53, 217]],

       ...,

       [[ 83,  94,  52],
        [ 82,  93,  51],
        [ 83,  95,  53],
        ...,
        [  0,  53, 217],
        [  0,  53, 217],
        [  0,  53, 217]],

       [[ 72,  84,  45],
        [ 78,  90,  50],
        [ 80,  94,  54],
        ...,
        [  0,  53, 217],
        [  0,  53, 217],
        [  0,  53, 217]],

       [[ 71,  83,  46],
        [ 78,  90,  53],
        [ 78,  91,  53],
        ...,
        [  0,  53, 217],
        [  0,  53, 217],
        [  0,  53, 217]]], dtype=uint8)]"
Image_443.jpg,1418,1117,412,379,2522,3332,1830,1496,412,daskShared_local/images/Image_443.jpg,443,"[array([[[125,  96,  93],
        [123,  92,  94],
        [127,  97, 100],
        ...,
        [  3, 152, 180],
        [  2, 151, 179],
        [  1, 151, 179]],

       [[192, 169, 165],
        [192, 170, 167],
        [200, 180, 177],
        ...,
        [  3, 159, 178],
        [  8, 162, 181],
        [  8, 157, 178]],

       [[232, 210, 196],
        [233, 213, 197],
        [243, 225, 207],
        ...,
        [  1, 160, 173],
        [  3, 154, 169],
        [  6, 150, 167]],

       ...,

       [[ 45,  66,  64],
        [ 36,  60,  57],
        [ 38,  63,  59],
        ...,
        [  0, 124, 198],
        [  1, 125, 199],
        [  2, 126, 200]],

       [[ 52,  73,  72],
        [ 39,  64,  61],
        [ 32,  58,  55],
        ...,
        [  1, 124, 198],
        [  1, 125, 199],
        [  1, 125, 199]],

       [[ 49,  71,  72],
        [ 43,  68,  67],
        [ 32,  58,  55],
        ...,
        [  2, 126, 200],
        [  1, 125, 199],
        [  0, 124, 198]]], dtype=uint8)]"
Image_444.jpg,1026,1484,1071,797,4613,2968,2097,2281,1071,daskShared_local/images/Image_444.jpg,444,"[array([[[125, 143, 147],
        [127, 141, 145],
        [127, 140, 144],
        ...,
        [ 81,  68,  59],
        [ 89,  75,  66],
        [ 93,  78,  69]],

       [[125, 140, 143],
        [122, 138, 141],
        [119, 138, 139],
        ...,
        [ 78,  65,  56],
        [ 85,  71,  62],
        [ 90,  76,  67]],

       [[125, 141, 144],
        [125, 141, 142],
        [123, 139, 140],
        ...,
        [ 73,  61,  52],
        [ 78,  66,  58],
        [ 85,  73,  65]],

       ...,

       [[ 57,  58,  62],
        [ 56,  58,  62],
        [ 52,  56,  59],
        ...,
        [ 86,  81,  79],
        [ 72,  71,  69],
        [ 70,  69,  63]],

       [[ 58,  61,  64],
        [ 60,  64,  66],
        [ 64,  70,  70],
        ...,
        [139, 125, 109],
        [ 98,  93,  83],
        [100,  97,  85]],

       [[ 57,  60,  63],
        [ 60,  66,  66],
        [ 69,  78,  74],
        ...,
        [188, 171, 149],
        [166, 162, 146],
        [137, 146, 134]]], dtype=uint8)]"
Image_445.jpg,1404,431,487,402,2500,1667,1891,833,487,daskShared_local/images/Image_445.jpg,445,"[array([[[ 92, 157, 172],
        [ 87, 156, 172],
        [ 77, 153, 167],
        ...,
        [160, 184, 204],
        [161, 186, 204],
        [158, 183, 192]],

       [[ 90, 158, 173],
        [ 87, 156, 173],
        [ 82, 153, 170],
        ...,
        [182, 198, 214],
        [172, 189, 205],
        [166, 186, 201]],

       [[ 84, 158, 173],
        [ 84, 156, 172],
        [ 85, 154, 170],
        ...,
        [214, 220, 232],
        [207, 214, 228],
        [198, 208, 225]],

       ...,

       [[157, 142,  91],
        [152, 139,  85],
        [142, 130,  75],
        ...,
        [  1, 122, 161],
        [  0, 124, 159],
        [  0, 121, 158]],

       [[143, 134,  74],
        [140, 132,  69],
        [135, 125,  61],
        ...,
        [  1, 125, 164],
        [  0, 128, 160],
        [  2, 125, 163]],

       [[145, 136,  74],
        [139, 132,  68],
        [142, 133,  68],
        ...,
        [  2, 130, 168],
        [  1, 131, 165],
        [  2, 129, 166]]], dtype=uint8)]"
Image_446.jpg,3232,773,874,861,5616,2633,4106,1634,874,daskShared_local/images/Image_446.jpg,446,"[array([[[  0, 196, 244],
        [  0, 196, 244],
        [  0, 197, 245],
        ...,
        [  0, 208, 255],
        [  0, 208, 255],
        [  0, 208, 255]],

       [[  0, 195, 243],
        [  0, 195, 243],
        [  0, 197, 244],
        ...,
        [  0, 208, 255],
        [  0, 208, 255],
        [  0, 208, 255]],

       [[  0, 195, 243],
        [  0, 195, 243],
        [  0, 196, 244],
        ...,
        [  0, 208, 255],
        [  0, 208, 254],
        [  1, 209, 255]],

       ...,

       [[  0, 135, 179],
        [  1, 133, 181],
        [  1, 134, 181],
        ...,
        [156, 114,  95],
        [187, 124, 102],
        [211, 147, 126]],

       [[  0, 136, 179],
        [  0, 134, 180],
        [  1, 134, 180],
        ...,
        [143,  95,  72],
        [171, 107,  85],
        [189, 124, 104]],

       [[  0, 134, 168],
        [  1, 133, 167],
        [  0, 132, 168],
        ...,
        [172, 116,  93],
        [173, 109,  87],
        [198, 138, 119]]], dtype=uint8)]"
Image_447.jpg,415,347,305,245,1536,1024,720,592,305,daskShared_local/images/Image_447.jpg,447,"[array([[[ 11, 136, 243],
        [  9, 131, 242],
        [  9, 131, 242],
        ...,
        [ 11, 170, 243],
        [ 13, 171, 245],
        [ 17, 173, 248]],

       [[ 14, 140, 245],
        [ 15, 136, 249],
        [ 16, 138, 249],
        ...,
        [ 12, 173, 245],
        [ 15, 173, 247],
        [ 21, 177, 252]],

       [[  6, 139, 240],
        [  7, 138, 244],
        [  8, 137, 243],
        ...,
        [  9, 171, 241],
        [  9, 170, 242],
        [ 13, 174, 246]],

       ...,

       [[ 14,  65, 215],
        [ 11,  61, 216],
        [  9,  60, 211],
        ...,
        [ 34, 127, 160],
        [ 28, 112, 126],
        [ 25,  95,  92]],

       [[ 11,  63, 213],
        [ 10,  61, 219],
        [  9,  60, 215],
        ...,
        [  5, 113, 129],
        [ 10,  93,  95],
        [ 25,  97,  99]],

       [[ 11,  64, 212],
        [  7,  63, 212],
        [  7,  62, 211],
        ...,
        [ 14,  95, 105],
        [ 34,  94,  88],
        [ 14, 100, 105]]], dtype=uint8)]"
Image_448.jpg,371,138,239,194,869,574,610,332,239,daskShared_local/images/Image_448.jpg,448,"[array([[[ 42, 169, 228],
        [ 63, 171, 232],
        [ 83, 176, 238],
        ...,
        [ 86, 168, 244],
        [ 85, 169, 242],
        [ 86, 168, 241]],

       [[  9, 153, 216],
        [ 32, 161, 224],
        [ 64, 174, 236],
        ...,
        [ 87, 169, 245],
        [ 86, 168, 241],
        [ 86, 168, 241]],

       [[  0, 144, 215],
        [  9, 147, 214],
        [ 38, 161, 225],
        ...,
        [ 85, 167, 243],
        [ 86, 166, 240],
        [ 85, 168, 240]],

       ...,

       [[  0,  10,   6],
        [  3,   9,   9],
        [  7,  41,  33],
        ...,
        [  1, 105, 179],
        [  2, 104, 179],
        [  2, 104, 179]],

       [[  0,  11,   8],
        [  4,   6,   8],
        [  8,  27,  23],
        ...,
        [  2, 104, 179],
        [  2, 104, 179],
        [  2, 104, 179]],

       [[  0,   6,   3],
        [  2,   2,   4],
        [  6,   3,   6],
        ...,
        [  2, 104, 179],
        [  2, 104, 179],
        [  2, 104, 179]]], dtype=uint8)]"
Image_449.jpg,297,169,230,199,1000,664,527,368,230,daskShared_local/images/Image_449.jpg,449,"[array([[[  0,  80, 149],
        [  1,  81, 149],
        [  1,  81, 148],
        ...,
        [  0, 101, 171],
        [  1, 101, 170],
        [  0, 101, 171]],

       [[  1,  80, 147],
        [  1,  80, 147],
        [  1,  80, 147],
        ...,
        [  0, 100, 170],
        [  0, 100, 170],
        [  0, 101, 172]],

       [[  0,  79, 146],
        [  0,  79, 146],
        [  1,  80, 146],
        ...,
        [  0,  99, 171],
        [  0,  99, 170],
        [  0, 100, 170]],

       ...,

       [[ 39,  61,  51],
        [ 33,  55,  54],
        [ 40,  61,  54],
        ...,
        [232, 223, 185],
        [209, 200, 182],
        [191, 180, 165]],

       [[ 34,  58,  51],
        [ 33,  60,  57],
        [ 42,  64,  54],
        ...,
        [235, 229, 188],
        [206, 197, 171],
        [143, 125, 107]],

       [[ 32,  52,  47],
        [ 36,  52,  46],
        [ 37,  48,  39],
        ...,
        [233, 223, 177],
        [193, 180, 150],
        [120, 101,  71]]], dtype=uint8)]"
Image_45.jpg,698,186,189,147,1000,600,887,333,189,daskShared_local/images/Image_45.jpg,45,"[array([[[  2, 160, 207],
        [  3, 159, 207],
        [  4, 159, 207],
        ...,
        [  5, 149, 209],
        [  6, 150, 210],
        [  6, 150, 210]],

       [[  2, 160, 207],
        [  3, 159, 207],
        [  4, 159, 207],
        ...,
        [  6, 151, 208],
        [  6, 151, 208],
        [  6, 151, 208]],

       [[  1, 157, 205],
        [  1, 157, 205],
        [  2, 157, 205],
        ...,
        [  7, 152, 209],
        [  6, 151, 208],
        [  6, 151, 208]],

       ...,

       [[250, 250, 195],
        [220, 206, 135],
        [202, 189, 100],
        ...,
        [146, 152,  95],
        [139, 138, 127],
        [135, 131, 152]],

       [[217, 215, 147],
        [187, 186,  98],
        [168, 171,  57],
        ...,
        [165, 164, 135],
        [153, 151, 129],
        [138, 136, 113]],

       [[192, 192, 120],
        [177, 177,  89],
        [163, 167,  52],
        ...,
        [187, 185, 164],
        [174, 171, 154],
        [172, 169, 150]]], dtype=uint8)]"
Image_450.jpg,613,216,388,420,1600,1070,1001,636,420,daskShared_local/images/Image_450.jpg,450,"[array([[[ 24,  74, 145],
        [ 24,  74, 145],
        [ 24,  74, 145],
        ...,
        [ 28,  69, 133],
        [ 28,  69, 133],
        [ 28,  69, 133]],

       [[ 24,  74, 145],
        [ 24,  74, 145],
        [ 24,  74, 145],
        ...,
        [ 28,  69, 133],
        [ 28,  69, 133],
        [ 28,  69, 133]],

       [[ 24,  74, 145],
        [ 24,  74, 145],
        [ 24,  74, 145],
        ...,
        [ 28,  69, 133],
        [ 28,  69, 133],
        [ 28,  69, 133]],

       ...,

       [[143, 131, 119],
        [127, 113,  95],
        [111, 103,  79],
        ...,
        [114,  97,  73],
        [125, 106,  67],
        [127, 106,  58]],

       [[192, 169, 140],
        [183, 160, 125],
        [133, 118,  83],
        ...,
        [118,  95,  58],
        [151, 126,  80],
        [171, 147,  97]],

       [[195, 173, 138],
        [203, 185, 145],
        [150, 139, 100],
        ...,
        [162, 137,  86],
        [210, 184, 131],
        [223, 198, 148]]], dtype=uint8)]"
Image_451.jpg,727,435,471,338,2119,1414,1198,773,471,daskShared_local/images/Image_451.jpg,451,"[array([[[115, 180, 207],
        [109, 174, 201],
        [107, 172, 199],
        ...,
        [ 72, 136, 164],
        [ 88, 152, 179],
        [ 90, 154, 181]],

       [[107, 171, 198],
        [107, 171, 198],
        [107, 171, 198],
        ...,
        [ 72, 135, 165],
        [ 78, 142, 170],
        [102, 166, 193]],

       [[100, 161, 189],
        [106, 167, 195],
        [105, 166, 194],
        ...,
        [ 73, 138, 168],
        [ 74, 139, 169],
        [ 70, 134, 164]],

       ...,

       [[ 81, 175, 200],
        [ 82, 176, 201],
        [ 82, 176, 201],
        ...,
        [ 90, 128, 131],
        [ 45, 116, 143],
        [ 17, 117, 150]],

       [[ 82, 176, 201],
        [ 81, 175, 200],
        [ 82, 176, 201],
        ...,
        [ 42, 110, 123],
        [ 19, 109, 139],
        [  5, 108, 142]],

       [[ 80, 174, 199],
        [ 80, 174, 199],
        [ 81, 175, 200],
        ...,
        [ 10, 104, 127],
        [  2, 101, 132],
        [  5, 102, 132]]], dtype=uint8)]"
Image_452.jpg,451,223,164,183,1200,630,615,406,183,daskShared_local/images/Image_452.jpg,452,"[array([[[ 34, 110, 178],
        [ 33, 108, 176],
        [ 27, 105, 171],
        ...,
        [ 66,  98,  95],
        [109, 144, 138],
        [160, 200, 190]],

       [[ 24, 100, 172],
        [ 24,  98, 171],
        [ 27, 101, 174],
        ...,
        [ 84, 103, 105],
        [ 89, 108, 106],
        [154, 172, 143]],

       [[ 25, 100, 171],
        [ 28, 102, 174],
        [ 32, 105, 175],
        ...,
        [ 68,  86,  88],
        [ 67,  84,  83],
        [ 93, 108,  81]],

       ...,

       [[ 36,  81, 104],
        [ 33,  79,  98],
        [ 28,  76,  91],
        ...,
        [ 21,  30,  29],
        [ 14,  23,  23],
        [ 18,  16,  21]],

       [[ 33,  78, 101],
        [ 32,  79,  99],
        [ 28,  75,  92],
        ...,
        [ 31,  40,  39],
        [ 13,  20,  20],
        [ 24,  23,  27]],

       [[ 26,  71,  94],
        [ 30,  76,  97],
        [ 32,  77,  97],
        ...,
        [ 34,  40,  40],
        [ 21,  26,  26],
        [ 25,  20,  24]]], dtype=uint8)]"
Image_453.jpg,422,139,230,213,1024,686,652,352,230,daskShared_local/images/Image_453.jpg,453,"[array([[[ 39, 191, 241],
        [ 38, 190, 240],
        [ 34, 189, 237],
        ...,
        [  0, 160, 220],
        [  0, 160, 220],
        [  0, 160, 220]],

       [[ 37, 189, 239],
        [ 36, 189, 239],
        [ 35, 189, 239],
        ...,
        [  1, 159, 220],
        [  1, 159, 220],
        [  1, 159, 220]],

       [[ 36, 188, 238],
        [ 35, 188, 239],
        [ 33, 189, 240],
        ...,
        [  2, 158, 219],
        [  2, 158, 219],
        [  2, 158, 219]],

       ...,

       [[228, 217, 210],
        [211, 201, 198],
        [207, 192, 190],
        ...,
        [  3, 114, 183],
        [  1, 112, 181],
        [  1, 112, 181]],

       [[216, 207, 202],
        [202, 194, 194],
        [216, 204, 205],
        ...,
        [  3, 114, 183],
        [  0, 111, 180],
        [  1, 112, 181]],

       [[190, 176, 168],
        [227, 217, 213],
        [227, 225, 230],
        ...,
        [  2, 113, 182],
        [  0, 111, 180],
        [  0, 111, 180]]], dtype=uint8)]"
Image_454.jpeg,649,149,246,240,1200,800,895,389,246,daskShared_local/images/Image_454.jpeg,454,"[array([[[185, 219, 228],
        [182, 215, 224],
        [183, 216, 225],
        ...,
        [175, 213, 231],
        [171, 212, 228],
        [170, 213, 229]],

       [[184, 218, 227],
        [183, 216, 225],
        [184, 217, 226],
        ...,
        [174, 212, 230],
        [170, 211, 227],
        [170, 212, 228]],

       [[181, 215, 224],
        [182, 215, 224],
        [182, 215, 224],
        ...,
        [175, 212, 230],
        [169, 210, 227],
        [168, 211, 227]],

       ...,

       [[209, 166, 103],
        [231, 189, 131],
        [190, 150,  91],
        ...,
        [149, 119, 113],
        [187, 150, 141],
        [232, 188, 173]],

       [[201, 159,  87],
        [216, 175, 105],
        [191, 153,  79],
        ...,
        [173, 148, 132],
        [199, 167, 152],
        [228, 190, 173]],

       [[189, 147,  68],
        [183, 144,  61],
        [208, 171,  83],
        ...,
        [194, 173, 144],
        [193, 166, 141],
        [209, 175, 153]]], dtype=uint8)]"
Image_455.jpg,1898,609,1193,1174,4752,3168,3091,1783,1193,daskShared_local/images/Image_455.jpg,455,"[array([[[ 74,  70,  40],
        [ 69,  64,  37],
        [ 70,  66,  41],
        ...,
        [ 52, 124, 149],
        [ 53, 123, 148],
        [ 54, 124, 149]],

       [[ 73,  64,  37],
        [ 67,  60,  33],
        [ 69,  64,  36],
        ...,
        [ 47, 120, 148],
        [ 49, 120, 149],
        [ 50, 121, 149]],

       [[ 75,  66,  38],
        [ 70,  62,  36],
        [ 70,  64,  38],
        ...,
        [ 43, 117, 148],
        [ 44, 118, 149],
        [ 45, 118, 149]],

       ...,

       [[  1,  95, 140],
        [  1,  95, 139],
        [  2,  95, 139],
        ...,
        [121, 101,  84],
        [106,  89,  81],
        [ 86,  72,  69]],

       [[  2,  96, 140],
        [  2,  96, 140],
        [  3,  96, 140],
        ...,
        [109,  88,  72],
        [ 90,  73,  68],
        [ 73,  59,  61]],

       [[  3,  96, 140],
        [  4,  97, 140],
        [  6,  97, 141],
        ...,
        [115,  94,  73],
        [ 87,  72,  65],
        [ 66,  55,  53]]], dtype=uint8)]"
Image_456.jpg,450,233,165,157,900,586,615,390,165,daskShared_local/images/Image_456.jpg,456,"[array([[[  1, 174, 208],
        [  1, 174, 208],
        [  1, 174, 208],
        ...,
        [103, 205, 227],
        [103, 205, 227],
        [103, 205, 227]],

       [[  1, 174, 208],
        [  1, 174, 208],
        [  1, 174, 208],
        ...,
        [103, 205, 227],
        [103, 205, 227],
        [103, 205, 227]],

       [[  1, 174, 208],
        [  1, 174, 208],
        [  1, 174, 208],
        ...,
        [103, 205, 227],
        [103, 205, 227],
        [103, 205, 227]],

       ...,

       [[  3,  53,  46],
        [  1,  56,  48],
        [  3,  60,  51],
        ...,
        [  1, 163, 209],
        [  1, 163, 209],
        [  1, 163, 209]],

       [[  5,  54,  50],
        [  1,  68,  56],
        [  7,  80,  67],
        ...,
        [  1, 163, 209],
        [  1, 163, 209],
        [  1, 163, 209]],

       [[  1,  43,  37],
        [  0,  54,  45],
        [ 11,  73,  63],
        ...,
        [  1, 163, 209],
        [  1, 163, 209],
        [  1, 163, 209]]], dtype=uint8)]"
Image_457.jpg,230,191,152,162,500,559,382,353,162,daskShared_local/images/Image_457.jpg,457,"[array([[[ 72, 165, 168],
        [ 72, 165, 168],
        [ 71, 165, 168],
        ...,
        [116, 204, 192],
        [122, 205, 192],
        [130, 207, 195]],

       [[116, 173, 173],
        [105, 168, 170],
        [ 93, 164, 168],
        ...,
        [132, 210, 198],
        [136, 215, 202],
        [138, 219, 205]],

       [[171, 192, 182],
        [159, 188, 178],
        [144, 183, 177],
        ...,
        [134, 214, 204],
        [135, 218, 207],
        [135, 221, 209]],

       ...,

       [[ 89,  90,  37],
        [ 83,  81,  29],
        [ 75,  70,  18],
        ...,
        [111, 132,  24],
        [120, 139,  43],
        [115, 131,  44]],

       [[ 71,  72,  32],
        [ 72,  70,  28],
        [ 67,  64,  17],
        ...,
        [ 95, 130,  33],
        [105, 137,  48],
        [104, 133,  49]],

       [[ 31,  29,  18],
        [ 44,  42,  20],
        [ 57,  56,  19],
        ...,
        [ 73, 128,  51],
        [ 81, 133,  53],
        [ 87, 136,  52]]], dtype=uint8)]"
Image_458.png,244,33,79,80,589,295,323,113,80,daskShared_local/images/Image_458.png,458,"[array([[[  0, 167, 184],
        [  0, 167, 182],
        [  0, 167, 187],
        ...,
        [  0, 173, 191],
        [  0, 171, 187],
        [  0, 172, 189]],

       [[  0, 168, 185],
        [  0, 167, 182],
        [  0, 168, 188],
        ...,
        [  0, 172, 191],
        [  0, 170, 187],
        [  0, 171, 189]],

       [[  0, 166, 183],
        [  0, 166, 181],
        [  0, 166, 185],
        ...,
        [  0, 173, 191],
        [  0, 172, 187],
        [  0, 173, 188]],

       ...,

       [[ 52,  25,  23],
        [ 51,  23,  22],
        [ 54,  27,  25],
        ...,
        [101,  52,  41],
        [111,  56,  42],
        [107,  54,  42]],

       [[ 46,  19,  18],
        [ 47,  19,  17],
        [ 46,  20,  19],
        ...,
        [138,  74,  55],
        [135,  72,  50],
        [137,  73,  52]],

       [[ 49,  22,  21],
        [ 49,  21,  19],
        [ 49,  23,  22],
        ...,
        [121,  64,  48],
        [124,  64,  46],
        [122,  64,  47]]], dtype=uint8)]"
Image_459.jpg,426,155,249,236,1200,822,675,391,249,daskShared_local/images/Image_459.jpg,459,"[array([[[  0, 145, 172],
        [  0, 145, 172],
        [  1, 146, 173],
        ...,
        [  1, 160, 189],
        [  2, 160, 189],
        [  4, 163, 192]],

       [[  0, 147, 173],
        [  0, 147, 173],
        [  0, 148, 174],
        ...,
        [  0, 158, 187],
        [  1, 158, 187],
        [  2, 161, 190]],

       [[  1, 148, 174],
        [  1, 148, 174],
        [  1, 149, 175],
        ...,
        [  0, 158, 187],
        [  0, 158, 187],
        [  0, 158, 187]],

       ...,

       [[ 82,  91,  45],
        [ 70,  84,  45],
        [ 68,  86,  45],
        ...,
        [130,  91,  34],
        [163, 122,  48],
        [205, 172, 116]],

       [[ 75,  85,  34],
        [ 85, 100,  52],
        [ 91, 111,  61],
        ...,
        [131,  99,  50],
        [163, 131,  69],
        [179, 146,  91]],

       [[ 98, 109,  52],
        [107, 125,  63],
        [105, 127,  65],
        ...,
        [126,  99,  59],
        [140, 112,  70],
        [128,  94,  46]]], dtype=uint8)]"
Image_46.jpg,386,338,330,216,1904,803,716,554,330,daskShared_local/images/Image_46.jpg,46,"[array([[[  7,  52, 116],
        [  8,  54, 115],
        [  7,  56, 111],
        ...,
        [122, 183, 188],
        [132, 184, 188],
        [165, 213, 216]],

       [[  3,  51, 115],
        [  5,  53, 115],
        [  6,  55, 113],
        ...,
        [146, 198, 200],
        [178, 223, 226],
        [204, 250, 251]],

       [[  1,  52, 111],
        [  2,  53, 111],
        [  4,  54, 113],
        ...,
        [200, 242, 242],
        [207, 251, 251],
        [173, 223, 226]],

       ...,

       [[ 24, 110,  71],
        [  5,  71,  46],
        [  0,  37,  46],
        ...,
        [  5,  57, 103],
        [  3,  51,  94],
        [ 11,  59,  98]],

       [[ 21, 145, 143],
        [  3, 101, 102],
        [  0,  61,  64],
        ...,
        [  5,  55, 105],
        [  8,  62, 108],
        [  4,  61,  96]],

       [[ 34, 159, 164],
        [ 34, 138, 143],
        [ 19, 101, 106],
        ...,
        [  8,  57, 105],
        [  8,  60, 102],
        [ 15,  70, 101]]], dtype=uint8)]"
Image_460.jpg,1737,547,1393,1567,4631,3087,3130,2114,1567,daskShared_local/images/Image_460.jpg,460,"[array([[[ 21,  92, 239],
        [ 21,  92, 240],
        [ 22,  92, 240],
        ...,
        [  0,  59, 196],
        [  0,  59, 195],
        [  0,  59, 195]],

       [[ 21,  92, 240],
        [ 22,  92, 240],
        [ 21,  91, 239],
        ...,
        [  0,  59, 195],
        [  0,  58, 194],
        [  0,  58, 194]],

       [[ 21,  91, 239],
        [ 21,  91, 239],
        [ 21,  91, 239],
        ...,
        [  0,  58, 194],
        [  0,  58, 194],
        [  0,  58, 193]],

       ...,

       [[109,  93,  69],
        [ 97,  82,  72],
        [116, 118, 114],
        ...,
        [ 35,  40,  23],
        [ 32,  38,  20],
        [ 30,  37,  19]],

       [[132, 127,  88],
        [118, 110,  89],
        [116, 119, 107],
        ...,
        [ 37,  44,  25],
        [ 32,  40,  22],
        [ 28,  36,  18]],

       [[133, 134, 104],
        [131, 130, 100],
        [118, 121, 100],
        ...,
        [ 37,  44,  25],
        [ 34,  42,  24],
        [ 28,  35,  18]]], dtype=uint8)]"
Image_461.jpg,327,138,271,229,845,563,598,367,271,daskShared_local/images/Image_461.jpg,461,"[array([[[ 86, 201, 202],
        [ 95, 203, 205],
        [104, 205, 207],
        ...,
        [ 73, 199, 197],
        [ 74, 198, 196],
        [ 76, 197, 196]],

       [[ 77, 197, 198],
        [ 82, 196, 197],
        [ 91, 200, 202],
        ...,
        [ 76, 199, 199],
        [ 75, 197, 196],
        [ 77, 195, 195]],

       [[ 70, 193, 193],
        [ 74, 194, 194],
        [ 80, 196, 195],
        ...,
        [ 78, 198, 199],
        [ 76, 193, 196],
        [ 79, 193, 194]],

       ...,

       [[ 51,  84,   8],
        [ 52,  77,   5],
        [ 51,  73,   1],
        ...,
        [ 57, 198, 186],
        [ 64, 202, 192],
        [ 69, 205, 195]],

       [[ 56,  93,  19],
        [ 53,  85,  12],
        [ 54,  80,   9],
        ...,
        [ 58, 199, 187],
        [ 65, 203, 193],
        [ 71, 206, 196]],

       [[ 59, 101,  28],
        [ 59,  96,  24],
        [ 59,  92,  21],
        ...,
        [ 62, 199, 189],
        [ 69, 204, 195],
        [ 76, 208, 200]]], dtype=uint8)]"
Image_462.jpg,524,243,314,225,1200,900,838,468,314,daskShared_local/images/Image_462.jpg,462,"[array([[[ 70, 184, 203],
        [ 58, 178, 198],
        [ 60, 179, 195],
        ...,
        [ 59, 179, 189],
        [ 74, 180, 195],
        [ 66, 183, 193]],

       [[ 75, 186, 205],
        [ 70, 180, 200],
        [ 55, 173, 187],
        ...,
        [ 51, 178, 185],
        [ 59, 178, 190],
        [ 63, 180, 193]],

       [[ 75, 186, 206],
        [ 74, 185, 202],
        [ 67, 180, 198],
        ...,
        [ 66, 176, 178],
        [ 60, 181, 185],
        [ 67, 181, 192]],

       ...,

       [[216, 237, 241],
        [219, 237, 243],
        [224, 240, 244],
        ...,
        [140, 200, 209],
        [152, 208, 211],
        [173, 217, 224]],

       [[218, 236, 242],
        [209, 233, 238],
        [220, 238, 243],
        ...,
        [122, 197, 211],
        [140, 204, 213],
        [171, 217, 228]],

       [[214, 236, 240],
        [206, 232, 238],
        [185, 222, 226],
        ...,
        [147, 206, 218],
        [163, 213, 225],
        [156, 211, 222]]], dtype=uint8)]"
Image_463.jpg,308,212,199,203,1000,600,507,415,203,daskShared_local/images/Image_463.jpg,463,"[array([[[  1, 146, 193],
        [  1, 146, 193],
        [  1, 146, 193],
        ...,
        [  1, 158, 201],
        [  1, 158, 201],
        [  1, 158, 201]],

       [[  1, 146, 193],
        [  1, 146, 193],
        [  1, 146, 193],
        ...,
        [  1, 158, 201],
        [  1, 158, 201],
        [  1, 158, 201]],

       [[  1, 146, 193],
        [  1, 146, 193],
        [  1, 146, 193],
        ...,
        [  1, 158, 201],
        [  1, 158, 201],
        [  1, 158, 201]],

       ...,

       [[184, 155,  56],
        [113,  88,  31],
        [ 55,  33,  20],
        ...,
        [244, 223, 158],
        [245, 222, 155],
        [245, 221, 151]],

       [[132, 106,  29],
        [ 64,  43,  29],
        [ 31,  14,  30],
        ...,
        [243, 224, 165],
        [244, 222, 162],
        [245, 221, 157]],

       [[ 80,  56,  18],
        [ 40,  24,  24],
        [ 27,  23,  28],
        ...,
        [242, 222, 169],
        [242, 221, 166],
        [242, 220, 162]]], dtype=uint8)]"
Image_464.jpg,281,164,175,168,800,533,456,332,175,daskShared_local/images/Image_464.jpg,464,"[array([[[222, 195, 166],
        [216, 189, 160],
        [210, 183, 154],
        ...,
        [ 57,  55,  78],
        [ 76,  74,  96],
        [105, 103, 125]],

       [[215, 191, 158],
        [214, 189, 156],
        [211, 186, 153],
        ...,
        [ 55,  53,  75],
        [ 65,  63,  84],
        [ 81,  79, 100]],

       [[228, 205, 169],
        [230, 208, 171],
        [231, 208, 172],
        ...,
        [ 57,  55,  75],
        [ 51,  50,  69],
        [ 50,  49,  67]],

       ...,

       [[161, 133, 121],
        [158, 130, 118],
        [153, 125, 113],
        ...,
        [101,  83,  69],
        [107,  89,  75],
        [112,  94,  80]],

       [[146, 118, 106],
        [152, 124, 112],
        [164, 136, 124],
        ...,
        [103,  85,  71],
        [105,  87,  73],
        [107,  89,  74]],

       [[160, 132, 120],
        [162, 134, 122],
        [166, 138, 126],
        ...,
        [ 88,  71,  55],
        [ 85,  68,  52],
        [ 84,  67,  51]]], dtype=uint8)]"
Image_465.png,385,189,315,274,900,600,700,463,315,daskShared_local/images/Image_465.png,465,"[array([[[130, 123, 113],
        [115, 108, 111],
        [103, 110, 124],
        ...,
        [ 22, 150, 178],
        [ 20, 149, 179],
        [ 24, 149, 181]],

       [[119, 102,  98],
        [116, 113, 115],
        [127, 125, 137],
        ...,
        [ 16, 152, 188],
        [ 21, 147, 182],
        [ 22, 152, 178]],

       [[102,  84,  83],
        [114, 101,  98],
        [123, 115, 108],
        ...,
        [ 23, 154, 179],
        [ 22, 151, 184],
        [ 19, 152, 184]],

       ...,

       [[ 30,  95,  90],
        [ 27,  78,  78],
        [ 23,  68,  71],
        ...,
        [ 85, 147, 140],
        [ 79, 150, 139],
        [ 90, 154, 146]],

       [[ 22,  63,  60],
        [ 25,  63,  61],
        [ 22,  63,  57],
        ...,
        [ 81, 149, 146],
        [ 78, 153, 142],
        [ 87, 159, 146]],

       [[ 20,  63,  60],
        [ 24,  65,  62],
        [ 21,  61,  56],
        ...,
        [ 85, 147, 147],
        [ 83, 149, 144],
        [ 92, 152, 146]]], dtype=uint8)]"
Image_466.jpg,704,667,394,243,2793,2090,1098,910,394,daskShared_local/images/Image_466.jpg,466,"[array([[[  5,  69, 192],
        [  5,  69, 192],
        [  5,  69, 192],
        ...,
        [  3,  68, 186],
        [  3,  68, 186],
        [  3,  68, 186]],

       [[  5,  69, 192],
        [  5,  69, 192],
        [  5,  69, 192],
        ...,
        [  3,  68, 186],
        [  3,  68, 186],
        [  3,  68, 186]],

       [[  5,  69, 192],
        [  5,  69, 192],
        [  5,  69, 192],
        ...,
        [  3,  68, 186],
        [  3,  68, 186],
        [  3,  68, 186]],

       ...,

       [[  5,  52, 156],
        [  5,  52, 156],
        [  5,  52, 156],
        ...,
        [176, 173, 121],
        [163, 165, 126],
        [191, 200, 169]],

       [[  5,  52, 156],
        [  5,  52, 156],
        [  5,  52, 156],
        ...,
        [196, 193, 142],
        [181, 184, 144],
        [186, 195, 164]],

       [[  1,  48, 152],
        [  3,  50, 154],
        [  4,  51, 155],
        ...,
        [203, 199, 151],
        [192, 194, 156],
        [172, 181, 149]]], dtype=uint8)]"
Image_467.jpg,697,278,455,498,1920,1080,1152,776,498,daskShared_local/images/Image_467.jpg,467,"[array([[[  0, 119, 203],
        [  0, 119, 203],
        [  0, 119, 203],
        ...,
        [  1, 116, 199],
        [  1, 116, 199],
        [  1, 116, 199]],

       [[  1, 120, 204],
        [  1, 120, 204],
        [  0, 119, 203],
        ...,
        [  1, 116, 199],
        [  1, 116, 199],
        [  1, 116, 199]],

       [[  0, 119, 203],
        [  0, 119, 203],
        [  0, 119, 203],
        ...,
        [  1, 116, 199],
        [  1, 116, 199],
        [  1, 116, 199]],

       ...,

       [[109, 115,  82],
        [174, 177, 148],
        [157, 156, 124],
        ...,
        [153, 146, 106],
        [180, 178, 137],
        [196, 193, 149]],

       [[100, 109,  84],
        [128, 135, 105],
        [140, 144, 107],
        ...,
        [149, 138, 100],
        [152, 146, 104],
        [156, 149, 105]],

       [[ 95, 105,  89],
        [ 84,  94,  69],
        [130, 134, 103],
        ...,
        [153, 140, 105],
        [155, 144, 105],
        [159, 147, 107]]], dtype=uint8)]"
Image_468.jpg,989,139,249,341,1686,1216,1238,480,341,daskShared_local/images/Image_468.jpg,468,"[array([[[125, 183, 215],
        [127, 184, 214],
        [127, 184, 214],
        ...,
        [161, 201, 226],
        [162, 202, 227],
        [162, 202, 227]],

       [[124, 182, 213],
        [127, 184, 214],
        [126, 183, 213],
        ...,
        [160, 200, 225],
        [161, 201, 226],
        [161, 201, 226]],

       [[126, 184, 215],
        [125, 182, 212],
        [125, 182, 212],
        ...,
        [160, 200, 225],
        [161, 201, 226],
        [161, 201, 226]],

       ...,

       [[168, 179, 152],
        [188, 196, 177],
        [168, 180, 159],
        ...,
        [ 83, 164, 201],
        [ 84, 166, 203],
        [ 83, 165, 202]],

       [[145, 154, 131],
        [170, 170, 148],
        [188, 193, 170],
        ...,
        [ 82, 163, 200],
        [ 80, 162, 199],
        [ 80, 162, 199]],

       [[178, 188, 166],
        [160, 157, 132],
        [173, 175, 151],
        ...,
        [ 83, 163, 200],
        [ 81, 163, 200],
        [ 80, 162, 199]]], dtype=uint8)]"
Image_469.jpg,663,118,189,183,1156,650,852,301,189,daskShared_local/images/Image_469.jpg,469,"[array([[[  4, 145, 172],
        [  9, 149, 178],
        [ 11, 150, 179],
        ...,
        [ 18, 135, 147],
        [  1, 127, 137],
        [  3, 141, 151]],

       [[  5, 149, 175],
        [  5, 146, 174],
        [  5, 146, 174],
        ...,
        [ 24, 134, 146],
        [ 15, 138, 149],
        [ 19, 147, 158]],

       [[  1, 144, 171],
        [  1, 140, 168],
        [  1, 140, 168],
        ...,
        [ 54, 153, 168],
        [ 39, 147, 163],
        [ 40, 154, 168]],

       ...,

       [[ 75,  68,  40],
        [ 55,  51,  22],
        [ 72,  67,  38],
        ...,
        [  3, 130, 175],
        [  4, 132, 177],
        [  5, 133, 180]],

       [[ 58,  51,  23],
        [ 50,  46,  17],
        [ 52,  48,  19],
        ...,
        [  3, 129, 177],
        [  2, 130, 177],
        [  3, 131, 180]],

       [[ 87,  80,  52],
        [ 71,  67,  38],
        [ 72,  68,  39],
        ...,
        [  5, 131, 179],
        [  4, 132, 179],
        [  7, 135, 184]]], dtype=uint8)]"
Image_47.jpg,1200,1011,453,439,2592,1944,1653,1450,453,daskShared_local/images/Image_47.jpg,47,"[array([[[ 80,  58,  43],
        [ 60,  41,  28],
        [ 66,  48,  38],
        ...,
        [ 45, 112, 172],
        [ 45, 117, 173],
        [ 44, 117, 172]],

       [[111,  81,  58],
        [121,  93,  72],
        [102,  77,  59],
        ...,
        [ 43, 113, 171],
        [ 41, 115, 172],
        [ 42, 116, 172]],

       [[131,  98,  65],
        [133, 100,  70],
        [132, 102,  74],
        ...,
        [ 38, 118, 173],
        [ 41, 117, 169],
        [ 42, 118, 170]],

       ...,

       [[ 41, 124, 168],
        [ 41, 123, 170],
        [ 39, 121, 168],
        ...,
        [ 39, 118, 167],
        [ 37, 119, 166],
        [ 39, 121, 168]],

       [[ 40, 123, 168],
        [ 41, 123, 169],
        [ 39, 121, 168],
        ...,
        [ 36, 116, 164],
        [ 36, 119, 164],
        [ 39, 122, 166]],

       [[ 39, 121, 168],
        [ 39, 121, 169],
        [ 39, 121, 169],
        ...,
        [ 38, 120, 167],
        [ 40, 123, 167],
        [ 40, 123, 167]]], dtype=uint8)]"
Image_470.jpg,36,85,224,169,800,600,260,254,224,daskShared_local/images/Image_470.jpg,470,"[array([[[  0, 154, 204],
        [  1, 154, 206],
        [  6, 154, 207],
        ...,
        [ 17, 177, 218],
        [ 23, 180, 223],
        [ 23, 180, 225]],

       [[  3, 154, 205],
        [  4, 152, 204],
        [  5, 151, 203],
        ...,
        [ 24, 183, 223],
        [ 23, 180, 222],
        [ 29, 185, 228]],

       [[  7, 156, 206],
        [  5, 152, 203],
        [  6, 151, 202],
        ...,
        [ 28, 185, 226],
        [ 28, 184, 226],
        [ 28, 183, 227]],

       ...,

       [[ 84, 150, 131],
        [ 87, 151, 132],
        [ 86, 150, 131],
        ...,
        [ 82,  43,  24],
        [ 74,  31,  15],
        [ 78,  31,  17]],

       [[ 87, 156, 133],
        [ 89, 158, 135],
        [ 86, 155, 132],
        ...,
        [100,  66,  45],
        [ 97,  59,  40],
        [ 89,  47,  29]],

       [[ 85, 155, 129],
        [ 83, 156, 129],
        [ 81, 155, 127],
        ...,
        [102,  71,  50],
        [104,  68,  48],
        [103,  65,  44]]], dtype=uint8)]"
Image_471.jpg,360,98,146,191,728,486,506,289,191,daskShared_local/images/Image_471.jpg,471,"[array([[[  1,  66, 254],
        [  0,  67, 254],
        [  1,  70, 253],
        ...,
        [  1, 107, 255],
        [  0, 106, 254],
        [  0, 106, 254]],

       [[  0,  63, 252],
        [  1,  64, 253],
        [  1,  66, 254],
        ...,
        [  0, 106, 254],
        [  0, 107, 255],
        [  0, 106, 254]],

       [[  1,  64, 253],
        [  3,  64, 253],
        [  1,  64, 255],
        ...,
        [  2, 106, 255],
        [  0, 106, 251],
        [  0, 104, 255]],

       ...,

       [[198, 149, 116],
        [187, 137, 105],
        [176, 131, 107],
        ...,
        [ 71,  70,  57],
        [ 61,  64,  56],
        [ 67,  64,  57]],

       [[202, 162, 131],
        [209, 164, 133],
        [200, 157, 132],
        ...,
        [ 81,  88,  65],
        [ 65,  74,  55],
        [ 73,  81,  64]],

       [[195, 150, 117],
        [183, 134, 102],
        [161, 108,  79],
        ...,
        [116, 141, 115],
        [ 94, 109,  73],
        [ 82,  93,  61]]], dtype=uint8)]"
Image_472.jpg,468,131,274,308,1600,1019,742,439,308,daskShared_local/images/Image_472.jpg,472,"[array([[[ 26, 109, 213],
        [ 26, 109, 213],
        [ 26, 109, 213],
        ...,
        [ 28, 116, 213],
        [ 28, 116, 213],
        [ 28, 116, 213]],

       [[ 26, 109, 213],
        [ 26, 109, 213],
        [ 26, 109, 213],
        ...,
        [ 28, 116, 213],
        [ 28, 116, 213],
        [ 28, 116, 213]],

       [[ 26, 109, 213],
        [ 26, 109, 213],
        [ 26, 109, 213],
        ...,
        [ 28, 116, 213],
        [ 28, 116, 213],
        [ 28, 116, 213]],

       ...,

       [[199, 202, 183],
        [218, 221, 203],
        [234, 236, 222],
        ...,
        [ 50,  20,   5],
        [ 40,  18,   4],
        [ 57,  42,  28]],

       [[210, 213, 195],
        [234, 236, 222],
        [233, 235, 222],
        ...,
        [ 43,  15,   3],
        [ 51,  29,  15],
        [ 71,  54,  41]],

       [[237, 239, 225],
        [246, 248, 235],
        [238, 240, 228],
        ...,
        [ 37,   9,   2],
        [ 52,  28,  17],
        [ 68,  48,  38]]], dtype=uint8)]"
Image_473.jpg,241,389,864,580,1512,1231,1105,969,864,daskShared_local/images/Image_473.jpg,473,"[array([[[ 83, 106, 110],
        [ 83, 107, 111],
        [ 83, 106, 112],
        ...,
        [ 80, 109,  80],
        [ 84, 113,  83],
        [110, 138, 107]],

       [[ 86, 110, 114],
        [ 87, 109, 114],
        [ 86, 108, 112],
        ...,
        [ 80, 109,  81],
        [ 84, 111,  82],
        [ 99, 125,  96]],

       [[ 88, 113, 117],
        [ 89, 111, 116],
        [ 90, 109, 114],
        ...,
        [ 80, 107,  79],
        [ 82, 109,  79],
        [ 82, 111,  80]],

       ...,

       [[255, 241, 215],
        [255, 241, 215],
        [255, 241, 215],
        ...,
        [246, 227, 201],
        [245, 228, 200],
        [241, 224, 194]],

       [[255, 241, 215],
        [255, 241, 215],
        [255, 241, 215],
        ...,
        [241, 224, 198],
        [241, 224, 200],
        [244, 226, 199]],

       [[255, 241, 215],
        [255, 241, 215],
        [255, 241, 215],
        ...,
        [243, 222, 195],
        [246, 229, 207],
        [246, 229, 206]]], dtype=uint8)]"
Image_474.jpg,651,288,304,323,1600,1000,955,611,323,daskShared_local/images/Image_474.jpg,474,"[array([[[  0,  71, 163],
        [  0,  71, 163],
        [  0,  71, 163],
        ...,
        [  2,  69, 160],
        [  2,  69, 160],
        [  2,  69, 160]],

       [[  0,  71, 163],
        [  0,  71, 163],
        [  0,  71, 163],
        ...,
        [  2,  69, 160],
        [  2,  69, 160],
        [  2,  69, 160]],

       [[  1,  70, 163],
        [  1,  70, 163],
        [  0,  70, 162],
        ...,
        [  1,  68, 159],
        [  1,  68, 159],
        [  1,  68, 159]],

       ...,

       [[130, 143,  90],
        [ 93, 102,  69],
        [ 65,  69,  48],
        ...,
        [104,  96,  51],
        [143, 137,  88],
        [189, 186, 128]],

       [[ 89,  93,  73],
        [ 42,  56,  28],
        [ 93, 109,  75],
        ...,
        [ 91,  74,  45],
        [100,  90,  54],
        [138, 133,  90]],

       [[ 44,  49,  31],
        [ 28,  42,  18],
        [ 71,  87,  57],
        ...,
        [ 97,  83,  50],
        [ 96,  84,  49],
        [100,  93,  52]]], dtype=uint8)]"
Image_475.jpg,449,275,167,173,850,567,616,448,173,daskShared_local/images/Image_475.jpg,475,"[array([[[150, 107,  86],
        [211, 152, 121],
        [194, 135, 105],
        ...,
        [ 62,  72, 116],
        [ 61,  77, 112],
        [ 50,  67,  87]],

       [[217, 162, 121],
        [243, 190, 149],
        [243, 192, 155],
        ...,
        [ 53,  66, 103],
        [ 43,  59,  90],
        [ 42,  60,  79]],

       [[248, 181, 138],
        [249, 187, 144],
        [220, 159, 125],
        ...,
        [ 41,  56,  85],
        [ 36,  49,  77],
        [ 38,  57,  74]],

       ...,

       [[  9, 123, 235],
        [ 10, 125, 236],
        [ 10, 125, 236],
        ...,
        [ 10, 128, 234],
        [  9, 127, 233],
        [ 10, 128, 234]],

       [[ 10, 124, 236],
        [  9, 125, 236],
        [ 10, 125, 237],
        ...,
        [ 10, 128, 234],
        [ 10, 128, 234],
        [ 11, 129, 235]],

       [[ 11, 125, 237],
        [  9, 124, 235],
        [ 10, 125, 236],
        ...,
        [  8, 126, 232],
        [ 10, 128, 234],
        [ 11, 129, 235]]], dtype=uint8)]"
Image_476.jpg,222,442,157,183,2015,1510,379,625,183,daskShared_local/images/Image_476.jpg,476,"[array([[[ 52,  54,  49],
        [ 60,  61,  56],
        [ 48,  49,  44],
        ...,
        [ 27,  23,  22],
        [ 22,  18,  17],
        [ 24,  20,  19]],

       [[ 36,  37,  32],
        [ 39,  40,  35],
        [ 31,  32,  27],
        ...,
        [ 27,  23,  22],
        [ 21,  17,  16],
        [ 21,  17,  16]],

       [[ 20,  21,  16],
        [ 18,  18,  14],
        [ 16,  16,  11],
        ...,
        [ 22,  18,  17],
        [ 18,  14,  13],
        [ 19,  15,  14]],

       ...,

       [[187, 177, 167],
        [144, 134, 122],
        [124, 115, 100],
        ...,
        [142, 150, 153],
        [122, 133, 135],
        [103, 114, 118]],

       [[151, 142, 131],
        [153, 143, 131],
        [134, 125, 110],
        ...,
        [138, 146, 149],
        [118, 127, 130],
        [100, 111, 115]],

       [[109, 103,  87],
        [127, 121, 105],
        [149, 143, 127],
        ...,
        [124, 131, 137],
        [113, 120, 126],
        [120, 127, 133]]], dtype=uint8)]"
Image_477.jpg,2382,878,657,598,3840,2160,3039,1476,657,daskShared_local/images/Image_477.jpg,477,"[array([[[129, 103,  86],
        [111,  87,  69],
        [118,  95,  79],
        ...,
        [  0, 135, 177],
        [  0, 133, 174],
        [  1, 132, 174]],

       [[168, 142, 125],
        [176, 151, 134],
        [140, 116, 100],
        ...,
        [  0, 134, 176],
        [  1, 132, 174],
        [  1, 132, 174]],

       [[113,  87,  69],
        [183, 157, 140],
        [160, 134, 119],
        ...,
        [  2, 132, 174],
        [  2, 131, 175],
        [  2, 130, 175]],

       ...,

       [[  2, 151, 173],
        [  1, 148, 171],
        [  1, 146, 170],
        ...,
        [  0, 121, 166],
        [  0, 121, 166],
        [  0, 121, 166]],

       [[  1, 151, 173],
        [  0, 151, 172],
        [  1, 149, 171],
        ...,
        [  0, 121, 166],
        [  0, 121, 166],
        [  0, 121, 166]],

       [[  3, 151, 174],
        [  4, 153, 175],
        [  2, 152, 173],
        ...,
        [  0, 120, 164],
        [  0, 121, 165],
        [  0, 122, 165]]], dtype=uint8)]"
Image_478.jpg,359,121,201,193,1280,720,560,314,201,daskShared_local/images/Image_478.jpg,478,"[array([[[  9, 105, 192],
        [ 14, 110, 197],
        [  9, 105, 192],
        ...,
        [ 20, 131, 213],
        [ 20, 131, 213],
        [ 20, 131, 213]],

       [[ 12, 106, 194],
        [ 14, 110, 197],
        [ 19, 115, 202],
        ...,
        [ 16, 127, 209],
        [ 19, 130, 212],
        [ 22, 133, 215]],

       [[  5,  99, 187],
        [ 12, 106, 194],
        [ 27, 123, 210],
        ...,
        [ 11, 122, 204],
        [ 17, 128, 210],
        [ 22, 133, 215]],

       ...,

       [[ 11,  81, 169],
        [  8,  78, 166],
        [ 11,  81, 169],
        ...,
        [ 89,  84,  54],
        [ 90,  84,  50],
        [ 46,  40,   4]],

       [[ 11,  81, 169],
        [ 13,  83, 171],
        [ 11,  81, 169],
        ...,
        [152, 148, 121],
        [106, 102,  73],
        [ 26,  22,   1]],

       [[ 12,  82, 170],
        [ 13,  83, 171],
        [ 11,  81, 169],
        ...,
        [ 98,  96,  75],
        [ 52,  50,  27],
        [ 49,  47,  24]]], dtype=uint8)]"
Image_479.jpg,417,2,405,515,1280,720,822,517,515,daskShared_local/images/Image_479.jpg,479,"[array([[[161, 229, 240],
        [163, 230, 239],
        [160, 227, 238],
        ...,
        [ 54, 182, 206],
        [ 62, 184, 211],
        [ 44, 183, 207]],

       [[160, 228, 239],
        [162, 228, 237],
        [159, 226, 236],
        ...,
        [ 49, 179, 206],
        [ 34, 176, 204],
        [ 32, 177, 203]],

       [[159, 228, 239],
        [159, 228, 238],
        [161, 226, 239],
        ...,
        [ 35, 177, 204],
        [ 46, 179, 208],
        [ 72, 187, 215]],

       ...,

       [[ 18,  25,  21],
        [ 29,  37,  33],
        [ 68,  59,  40],
        ...,
        [  3,  73,  98],
        [  3,  73,  98],
        [  3,  73,  98]],

       [[ 38,  36,  17],
        [ 45,  42,  27],
        [ 84,  69,  40],
        ...,
        [  2,  73,  95],
        [  2,  72,  97],
        [  2,  72,  97]],

       [[ 95,  79,  38],
        [ 97,  78,  40],
        [116,  92,  53],
        ...,
        [  2,  73,  95],
        [  2,  72,  97],
        [  1,  71,  96]]], dtype=uint8)]"
Image_48.jpg,513,79,298,460,1600,900,811,539,460,daskShared_local/images/Image_48.jpg,48,"[array([[[  1, 152, 207],
        [  1, 152, 206],
        [  0, 152, 206],
        ...,
        [155, 202, 242],
        [156, 202, 242],
        [158, 202, 244]],

       [[  0, 152, 207],
        [  0, 151, 206],
        [  1, 152, 207],
        ...,
        [155, 201, 242],
        [156, 202, 242],
        [158, 202, 243]],

       [[  1, 151, 205],
        [  0, 151, 206],
        [  1, 152, 206],
        ...,
        [156, 201, 242],
        [158, 202, 244],
        [157, 202, 243]],

       ...,

       [[  0, 138, 201],
        [  0, 138, 201],
        [  0, 138, 201],
        ...,
        [131, 114,  89],
        [117, 101,  74],
        [123, 106,  76]],

       [[  0, 138, 201],
        [  0, 138, 201],
        [  0, 138, 201],
        ...,
        [127, 112,  86],
        [113,  99,  70],
        [119, 103,  71]],

       [[  0, 138, 201],
        [  0, 138, 201],
        [  0, 138, 201],
        ...,
        [111, 104,  77],
        [121, 110,  79],
        [124, 109,  75]]], dtype=uint8)]"
Image_480.jpg,903,455,663,520,3008,2000,1566,975,663,daskShared_local/images/Image_480.jpg,480,"[array([[[148, 187, 194],
        [148, 187, 194],
        [148, 187, 194],
        ...,
        [137, 179, 191],
        [137, 179, 191],
        [137, 179, 191]],

       [[148, 187, 194],
        [148, 187, 194],
        [148, 187, 194],
        ...,
        [137, 179, 191],
        [137, 179, 191],
        [137, 179, 191]],

       [[148, 187, 194],
        [148, 187, 194],
        [148, 187, 194],
        ...,
        [137, 179, 191],
        [137, 179, 191],
        [137, 179, 191]],

       ...,

       [[127, 181, 188],
        [124, 178, 186],
        [121, 175, 182],
        ...,
        [ 75,  93,  97],
        [ 70,  89,  93],
        [ 68,  87,  91]],

       [[121, 180, 186],
        [119, 177, 183],
        [117, 174, 180],
        ...,
        [ 74,  85,  92],
        [ 70,  86,  91],
        [ 60,  80,  84]],

       [[118, 177, 183],
        [115, 174, 180],
        [113, 170, 177],
        ...,
        [ 81,  91,  98],
        [ 76,  92,  97],
        [ 74,  93,  97]]], dtype=uint8)]"
Image_481.jpg,624,318,182,155,1400,933,806,473,182,daskShared_local/images/Image_481.jpg,481,"[array([[[  1, 174, 230],
        [  1, 174, 230],
        [  1, 174, 230],
        ...,
        [  1, 203, 243],
        [  0, 202, 242],
        [  0, 202, 242]],

       [[  0, 173, 229],
        [  0, 173, 229],
        [  0, 173, 229],
        ...,
        [  0, 202, 242],
        [  0, 202, 242],
        [  0, 202, 242]],

       [[  0, 173, 229],
        [  0, 173, 229],
        [  0, 173, 229],
        ...,
        [  1, 201, 242],
        [  1, 200, 241],
        [  1, 200, 241]],

       ...,

       [[ 86,  87,  57],
        [108, 109,  79],
        [111, 113,  83],
        ...,
        [  0, 184, 236],
        [  0, 184, 236],
        [  0, 184, 236]],

       [[ 86,  89,  63],
        [ 91,  94,  68],
        [ 83,  86,  59],
        ...,
        [  0, 184, 236],
        [  0, 184, 236],
        [  0, 184, 236]],

       [[ 73,  76,  54],
        [ 72,  75,  54],
        [ 70,  72,  51],
        ...,
        [  0, 184, 236],
        [  0, 184, 236],
        [  0, 184, 236]]], dtype=uint8)]"
Image_482.jpg,420,1011,820,580,4601,3200,1240,1591,820,daskShared_local/images/Image_482.jpg,482,"[array([[[ 31, 169, 243],
        [ 28, 161, 239],
        [ 29, 162, 243],
        ...,
        [ 49, 164, 238],
        [ 45, 162, 231],
        [ 44, 160, 232]],

       [[ 25, 158, 235],
        [ 25, 159, 237],
        [ 25, 161, 241],
        ...,
        [ 46, 157, 240],
        [ 39, 154, 234],
        [ 34, 152, 230]],

       [[ 29, 161, 238],
        [ 30, 164, 242],
        [ 25, 156, 236],
        ...,
        [ 42, 155, 233],
        [ 40, 158, 238],
        [ 35, 157, 234]],

       ...,

       [[ 26, 154, 208],
        [ 25, 149, 203],
        [ 30, 160, 214],
        ...,
        [ 39, 153, 208],
        [ 36, 150, 205],
        [ 36, 152, 205]],

       [[ 25, 154, 215],
        [ 29, 154, 215],
        [ 30, 161, 219],
        ...,
        [ 38, 151, 207],
        [ 39, 154, 208],
        [ 39, 159, 215]],

       [[ 27, 162, 230],
        [ 24, 156, 218],
        [ 24, 156, 218],
        ...,
        [ 34, 140, 197],
        [ 41, 154, 210],
        [ 39, 157, 214]]], dtype=uint8)]"
Image_483.jpg,103,258,150,119,900,600,253,377,150,daskShared_local/images/Image_483.jpg,483,"[array([[[  4,  85,  89],
        [  2,  82,  90],
        [  1,  79,  91],
        ...,
        [  0,  88, 100],
        [  1,  89, 101],
        [  2,  90, 102]],

       [[  5,  86,  91],
        [  4,  86,  94],
        [  3,  84,  95],
        ...,
        [  0,  87, 100],
        [  0,  88, 100],
        [  1,  89, 101]],

       [[  7,  86,  92],
        [  6,  88,  97],
        [  4,  88,  98],
        ...,
        [  0,  87, 100],
        [  1,  88, 100],
        [  1,  89, 101]],

       ...,

       [[  0,  65,  77],
        [  0,  66,  79],
        [  0,  66,  80],
        ...,
        [ 19,  39,  35],
        [ 20,  39,  35],
        [ 19,  39,  35]],

       [[  0,  65,  76],
        [  0,  65,  78],
        [  0,  66,  79],
        ...,
        [ 19,  40,  34],
        [ 19,  39,  34],
        [ 18,  38,  33]],

       [[  0,  64,  74],
        [  1,  65,  76],
        [  1,  65,  78],
        ...,
        [ 16,  40,  32],
        [ 16,  39,  32],
        [ 16,  38,  32]]], dtype=uint8)]"
Image_484.jpg,710,183,176,150,1000,600,886,333,176,daskShared_local/images/Image_484.jpg,484,"[array([[[ 12, 160, 208],
        [ 13, 161, 209],
        [ 10, 158, 206],
        ...,
        [  5, 152, 206],
        [  5, 152, 206],
        [  5, 152, 206]],

       [[ 14, 160, 207],
        [ 16, 162, 209],
        [ 15, 161, 208],
        ...,
        [  3, 153, 206],
        [  3, 153, 206],
        [  3, 153, 206]],

       [[ 18, 163, 209],
        [ 22, 167, 213],
        [ 20, 165, 211],
        ...,
        [  3, 153, 206],
        [  3, 153, 206],
        [  4, 154, 207]],

       ...,

       [[210, 197,  30],
        [202, 186,  35],
        [182, 162,  40],
        ...,
        [183, 195, 111],
        [231, 238, 189],
        [248, 250, 228]],

       [[200, 185,  30],
        [206, 188,  57],
        [189, 165,  71],
        ...,
        [221, 226, 188],
        [239, 239, 230],
        [239, 237, 239]],

       [[205, 191,  43],
        [210, 189,  73],
        [206, 177, 104],
        ...,
        [218, 216, 219],
        [226, 222, 238],
        [222, 219, 229]]], dtype=uint8)]"
Image_485.jpg,386,338,305,220,1904,803,691,558,305,daskShared_local/images/Image_485.jpg,485,"[array([[[  2,  51, 107],
        [  2,  51, 107],
        [  2,  51, 107],
        ...,
        [ 99, 168, 161],
        [ 56, 171, 148],
        [ 64, 174, 152]],

       [[  2,  51, 107],
        [  2,  51, 107],
        [  2,  51, 107],
        ...,
        [101, 168, 162],
        [ 75, 187, 162],
        [ 93, 198, 176]],

       [[  2,  51, 107],
        [  2,  51, 107],
        [  2,  51, 107],
        ...,
        [104, 174, 167],
        [ 84, 189, 165],
        [ 91, 190, 169]],

       ...,

       [[  2,   6,  26],
        [  0,   5,  36],
        [  0,  14,  64],
        ...,
        [  1,  49,  91],
        [  0,  53,  92],
        [  0,  59,  97]],

       [[ 10,   7,  36],
        [  2,   2,  39],
        [  1,   9,  67],
        ...,
        [  0,  66, 103],
        [  0,  63,  93],
        [  0,  72,  99]],

       [[ 11,   2,  31],
        [  7,   0,  39],
        [  9,   4,  67],
        ...,
        [  5,  83, 111],
        [  4,  83, 101],
        [  3,  86, 103]]], dtype=uint8)]"
Image_486.jpg,213,36,211,187,900,521,424,223,211,daskShared_local/images/Image_486.jpg,486,"[array([[[ 16,  58, 170],
        [ 16,  58, 170],
        [ 16,  58, 170],
        ...,
        [ 32,  69, 184],
        [ 33,  70, 185],
        [ 33,  70, 185]],

       [[ 16,  58, 170],
        [ 16,  58, 170],
        [ 16,  58, 170],
        ...,
        [ 32,  69, 184],
        [ 33,  70, 185],
        [ 33,  70, 185]],

       [[ 16,  58, 170],
        [ 16,  58, 170],
        [ 16,  58, 170],
        ...,
        [ 32,  69, 184],
        [ 33,  70, 185],
        [ 33,  70, 185]],

       ...,

       [[  0,  55, 140],
        [  0,  54, 144],
        [  0,  55, 146],
        ...,
        [184, 201, 196],
        [186, 203, 197],
        [197, 214, 208]],

       [[  0,  55, 140],
        [  0,  55, 145],
        [  0,  55, 146],
        ...,
        [197, 214, 208],
        [201, 218, 212],
        [212, 229, 223]],

       [[  0,  56, 139],
        [  0,  56, 143],
        [  0,  55, 146],
        ...,
        [202, 219, 213],
        [205, 222, 216],
        [216, 233, 227]]], dtype=uint8)]"
Image_487.jpg,515,78,144,195,1200,630,659,273,195,daskShared_local/images/Image_487.jpg,487,"[array([[[  1, 154, 222],
        [  2, 155, 223],
        [  5, 156, 225],
        ...,
        [  5, 157, 224],
        [  4, 156, 223],
        [  4, 156, 223]],

       [[  1, 154, 222],
        [  2, 155, 223],
        [  4, 157, 225],
        ...,
        [  5, 157, 224],
        [  4, 156, 223],
        [  4, 156, 223]],

       [[  3, 156, 223],
        [  3, 156, 223],
        [  3, 156, 223],
        ...,
        [  3, 155, 222],
        [  3, 155, 222],
        [  3, 155, 222]],

       ...,

       [[ 19,   7,  17],
        [ 23,  13,  21],
        [ 27,  18,  23],
        ...,
        [  0,  78, 117],
        [  1,  80, 119],
        [  5,  84, 123]],

       [[ 12,   0,  14],
        [ 21,  11,  19],
        [ 26,  16,  24],
        ...,
        [  0,  77, 116],
        [  0,  75, 114],
        [  0,  76, 115]],

       [[ 16,   1,   8],
        [  8,   0,   2],
        [ 22,  10,  18],
        ...,
        [  2,  84, 121],
        [  3,  87, 123],
        [  3,  87, 123]]], dtype=uint8)]"
Image_488.jpg,1221,1038,431,423,2592,1944,1652,1461,431,daskShared_local/images/Image_488.jpg,488,"[array([[[249, 238, 212],
        [224, 216, 184],
        [191, 181, 147],
        ...,
        [ 48, 117, 172],
        [ 41, 117, 171],
        [ 41, 116, 171]],

       [[192, 176, 147],
        [176, 161, 127],
        [231, 215, 179],
        ...,
        [ 49, 117, 172],
        [ 39, 117, 170],
        [ 40, 116, 170]],

       [[162, 144, 111],
        [241, 226, 189],
        [251, 234, 196],
        ...,
        [ 48, 117, 171],
        [ 39, 117, 170],
        [ 42, 118, 172]],

       ...,

       [[ 38, 121, 169],
        [ 35, 120, 167],
        [ 39, 121, 169],
        ...,
        [ 40, 122, 169],
        [ 39, 122, 167],
        [ 41, 124, 168]],

       [[ 38, 121, 168],
        [ 38, 121, 169],
        [ 40, 122, 170],
        ...,
        [ 40, 122, 169],
        [ 38, 122, 164],
        [ 39, 124, 166]],

       [[ 39, 121, 168],
        [ 38, 120, 168],
        [ 40, 121, 169],
        ...,
        [ 40, 124, 168],
        [ 41, 126, 167],
        [ 40, 125, 166]]], dtype=uint8)]"
Image_489.jpg,517,85,294,440,1600,900,811,525,440,daskShared_local/images/Image_489.jpg,489,"[array([[[  0, 153, 209],
        [  0, 153, 210],
        [  0, 154, 208],
        ...,
        [152, 199, 241],
        [154, 199, 241],
        [155, 200, 242]],

       [[  0, 154, 208],
        [  0, 154, 208],
        [  0, 154, 208],
        ...,
        [152, 199, 241],
        [153, 198, 240],
        [155, 200, 242]],

       [[  0, 153, 207],
        [  0, 153, 207],
        [  0, 154, 208],
        ...,
        [152, 199, 241],
        [153, 198, 241],
        [155, 199, 242]],

       ...,

       [[  1, 139, 202],
        [  1, 139, 202],
        [  0, 140, 201],
        ...,
        [ 95,  93,  75],
        [ 67,  70,  69],
        [ 84,  78,  75]],

       [[  1, 139, 202],
        [  1, 139, 202],
        [  0, 140, 201],
        ...,
        [ 76,  71,  68],
        [ 84,  79,  72],
        [119, 104,  93]],

       [[  1, 139, 202],
        [  1, 139, 202],
        [  0, 140, 201],
        ...,
        [ 90,  81,  79],
        [109,  99,  83],
        [130, 112,  93]]], dtype=uint8)]"
Image_49.jpg,982,135,253,369,1686,1216,1235,504,369,daskShared_local/images/Image_49.jpg,49,"[array([[[121, 182, 213],
        [121, 182, 213],
        [122, 181, 213],
        ...,
        [162, 202, 227],
        [162, 202, 227],
        [162, 202, 227]],

       [[120, 181, 212],
        [120, 181, 212],
        [120, 179, 211],
        ...,
        [163, 203, 228],
        [163, 203, 228],
        [163, 203, 228]],

       [[119, 180, 211],
        [119, 180, 211],
        [122, 181, 213],
        ...,
        [162, 202, 227],
        [162, 202, 227],
        [162, 202, 227]],

       ...,

       [[212, 212, 199],
        [188, 184, 173],
        [191, 195, 172],
        ...,
        [ 81, 163, 201],
        [ 75, 157, 195],
        [ 82, 165, 203]],

       [[222, 226, 216],
        [199, 200, 192],
        [186, 190, 168],
        ...,
        [ 80, 164, 201],
        [ 77, 161, 198],
        [ 84, 168, 205]],

       [[218, 227, 218],
        [212, 218, 211],
        [189, 192, 171],
        ...,
        [ 75, 159, 196],
        [ 78, 162, 199],
        [ 75, 159, 196]]], dtype=uint8)]"
Image_490.jpg,419,166,865,649,1500,1000,1284,815,865,daskShared_local/images/Image_490.jpg,490,"[array([[[  2,  59,  65],
        [  1,  60,  66],
        [  1,  60,  66],
        ...,
        [139, 132, 170],
        [138, 132, 170],
        [116, 113, 149]],

       [[  3,  58,  65],
        [  2,  59,  65],
        [  2,  59,  65],
        ...,
        [110, 107, 150],
        [105, 102, 143],
        [ 77,  81, 123]],

       [[  3,  58,  65],
        [  3,  58,  65],
        [  3,  58,  65],
        ...,
        [ 77,  81, 129],
        [ 73,  76, 115],
        [ 61,  69, 101]],

       ...,

       [[124, 141, 183],
        [154, 168, 197],
        [169, 179, 204],
        ...,
        [ 63, 105,  60],
        [ 63, 103,  59],
        [ 66, 104,  60]],

       [[134, 148, 186],
        [155, 168, 197],
        [167, 177, 204],
        ...,
        [ 61, 106,  60],
        [ 63, 104,  60],
        [ 66, 104,  61]],

       [[143, 156, 192],
        [160, 171, 200],
        [168, 178, 205],
        ...,
        [ 61, 107,  61],
        [ 64, 106,  61],
        [ 66, 105,  60]]], dtype=uint8)]"
Image_491.jpg,979,383,193,208,2000,1000,1172,591,208,daskShared_local/images/Image_491.jpg,491,"[array([[[195, 172, 140],
        [193, 168, 137],
        [196, 172, 138],
        ...,
        [214, 191, 159],
        [213, 189, 155],
        [214, 190, 152]],

       [[198, 178, 143],
        [196, 176, 141],
        [200, 180, 145],
        ...,
        [208, 192, 159],
        [207, 191, 157],
        [207, 191, 157]],

       [[203, 183, 148],
        [203, 183, 148],
        [206, 186, 151],
        ...,
        [205, 188, 154],
        [204, 188, 154],
        [204, 188, 152]],

       ...,

       [[ 38,  38,  37],
        [ 34,  34,  32],
        [ 42,  43,  37],
        ...,
        [198, 176, 139],
        [191, 166, 126],
        [194, 167, 124]],

       [[ 42,  42,  42],
        [ 38,  38,  36],
        [ 34,  35,  30],
        ...,
        [199, 178, 141],
        [199, 173, 136],
        [195, 170, 130]],

       [[ 38,  38,  38],
        [ 35,  35,  33],
        [ 36,  37,  31],
        ...,
        [199, 173, 138],
        [204, 175, 142],
        [198, 175, 141]]], dtype=uint8)]"
Image_492.jpg,362,21,153,139,550,380,515,160,153,daskShared_local/images/Image_492.jpg,492,"[array([[[ 75,  94, 150],
        [ 75,  94, 150],
        [ 75,  94, 150],
        ...,
        [ 69,  84, 143],
        [ 69,  84, 143],
        [ 70,  85, 144]],

       [[ 75,  94, 150],
        [ 75,  94, 150],
        [ 75,  94, 150],
        ...,
        [ 69,  84, 143],
        [ 69,  84, 143],
        [ 70,  85, 144]],

       [[ 75,  94, 150],
        [ 75,  94, 150],
        [ 75,  94, 150],
        ...,
        [ 70,  85, 144],
        [ 70,  85, 144],
        [ 70,  85, 144]],

       ...,

       [[191, 176, 140],
        [200, 185, 154],
        [206, 191, 167],
        ...,
        [ 65,  76, 138],
        [ 65,  76, 138],
        [ 66,  77, 139]],

       [[170, 153, 119],
        [201, 185, 156],
        [220, 204, 183],
        ...,
        [ 65,  76, 138],
        [ 65,  76, 138],
        [ 66,  77, 139]],

       [[160, 142, 109],
        [197, 180, 152],
        [220, 202, 182],
        ...,
        [ 65,  76, 138],
        [ 65,  76, 138],
        [ 65,  76, 138]]], dtype=uint8)]"
Image_493.jpg,117,154,367,277,1152,768,484,431,367,daskShared_local/images/Image_493.jpg,493,"[array([[[180, 233, 225],
        [181, 234, 226],
        [183, 234, 225],
        ...,
        [179, 238, 230],
        [178, 236, 229],
        [177, 237, 229]],

       [[181, 234, 225],
        [181, 234, 225],
        [182, 234, 225],
        ...,
        [171, 235, 227],
        [170, 233, 225],
        [168, 233, 225]],

       [[181, 234, 224],
        [181, 234, 224],
        [181, 233, 225],
        ...,
        [162, 229, 225],
        [160, 230, 222],
        [158, 228, 222]],

       ...,

       [[ 98, 181, 190],
        [100, 182, 190],
        [ 99, 184, 191],
        ...,
        [101, 137, 149],
        [ 90, 123, 130],
        [ 71, 104, 110]],

       [[ 95, 181, 189],
        [ 99, 182, 190],
        [100, 183, 191],
        ...,
        [ 91, 123, 134],
        [102, 130, 141],
        [ 87, 114, 119]],

       [[ 95, 178, 191],
        [ 99, 180, 192],
        [101, 182, 191],
        ...,
        [ 89, 117, 129],
        [ 88, 122, 131],
        [ 91, 123, 126]]], dtype=uint8)]"
Image_494.jpg,1031,148,2527,2569,4608,3072,3558,2717,2569,daskShared_local/images/Image_494.jpg,494,"[array([[[ 33,  33,  32],
        [ 32,  32,  30],
        [ 30,  31,  28],
        ...,
        [124, 129, 120],
        [131, 136, 126],
        [140, 144, 126]],

       [[ 30,  30,  29],
        [ 31,  32,  31],
        [ 32,  33,  29],
        ...,
        [120, 125, 116],
        [120, 125, 118],
        [128, 133, 124]],

       [[ 28,  28,  27],
        [ 31,  31,  31],
        [ 33,  34,  31],
        ...,
        [123, 127, 120],
        [116, 120, 113],
        [115, 121, 115]],

       ...,

       [[105,  89,  65],
        [104,  89,  66],
        [105,  91,  66],
        ...,
        [170, 157, 128],
        [157, 144, 111],
        [143, 129,  94]],

       [[104,  87,  63],
        [104,  87,  64],
        [103,  87,  62],
        ...,
        [168, 153, 114],
        [160, 137,  89],
        [137, 116,  77]],

       [[101,  83,  57],
        [101,  84,  58],
        [100,  84,  58],
        ...,
        [170, 156, 113],
        [174, 149,  83],
        [168, 126,  56]]], dtype=uint8)]"
Image_495.jpg,618,224,144,104,1000,667,762,328,144,daskShared_local/images/Image_495.jpg,495,"[array([[[ 58, 115, 112],
        [ 60, 116, 113],
        [ 61, 117, 113],
        ...,
        [ 13,  97, 110],
        [ 22, 102, 115],
        [ 29, 106, 119]],

       [[ 58, 117, 115],
        [ 60, 119, 117],
        [ 63, 121, 118],
        ...,
        [  7,  92, 104],
        [ 15,  96, 108],
        [ 21,  99, 111]],

       [[ 58, 122, 121],
        [ 62, 125, 123],
        [ 66, 128, 126],
        ...,
        [  1,  85,  96],
        [  7,  88,  99],
        [ 12,  90, 102]],

       ...,

       [[ 93,  95,  71],
        [101, 102,  77],
        [112, 112,  86],
        ...,
        [ 17,  53,  65],
        [ 10,  47,  59],
        [  7,  45,  57]],

       [[103, 104,  80],
        [104, 105,  80],
        [110, 110,  84],
        ...,
        [ 14,  45,  56],
        [  7,  37,  50],
        [  4,  35,  47]],

       [[115, 116,  92],
        [108, 109,  84],
        [107, 107,  81],
        ...,
        [ 12,  40,  51],
        [  4,  32,  44],
        [  2,  29,  41]]], dtype=uint8)]"
Image_496.jpg,218,212,131,148,800,600,349,360,148,daskShared_local/images/Image_496.jpg,496,"[array([[[ 71, 188, 211],
        [ 71, 188, 211],
        [ 71, 188, 210],
        ...,
        [ 26, 166, 195],
        [ 27, 166, 195],
        [ 27, 166, 195]],

       [[ 70, 187, 210],
        [ 70, 187, 210],
        [ 69, 187, 209],
        ...,
        [ 24, 166, 194],
        [ 25, 166, 194],
        [ 26, 166, 194]],

       [[ 67, 187, 209],
        [ 67, 187, 209],
        [ 67, 187, 208],
        ...,
        [ 22, 165, 193],
        [ 22, 166, 193],
        [ 23, 166, 193]],

       ...,

       [[ 27, 143, 137],
        [ 26, 141, 135],
        [ 26, 138, 131],
        ...,
        [224, 197, 137],
        [226, 202, 145],
        [225, 201, 156]],

       [[ 27, 139, 132],
        [ 27, 138, 130],
        [ 29, 137, 128],
        ...,
        [222, 193, 136],
        [231, 204, 156],
        [226, 201, 151]],

       [[ 26, 136, 128],
        [ 27, 136, 127],
        [ 30, 137, 127],
        ...,
        [225, 193, 146],
        [238, 207, 173],
        [228, 202, 153]]], dtype=uint8)]"
Image_497.png,365,59,190,149,600,600,555,208,190,daskShared_local/images/Image_497.png,497,"[array([[[  0, 102, 249],
        [  1, 103, 250],
        [  2, 104, 251],
        ...,
        [  1, 119, 255],
        [  1, 119, 255],
        [  1, 119, 255]],

       [[  2, 104, 249],
        [  1, 103, 248],
        [  1, 103, 248],
        ...,
        [  1, 122, 255],
        [  1, 122, 255],
        [  1, 122, 255]],

       [[  2, 104, 249],
        [  2, 104, 249],
        [  2, 104, 249],
        ...,
        [  1, 122, 255],
        [  1, 122, 255],
        [  0, 121, 254]],

       ...,

       [[201, 193, 127],
        [209, 201, 145],
        [187, 157, 110],
        ...,
        [239, 248, 200],
        [238, 248, 192],
        [238, 250, 176]],

       [[208, 218, 227],
        [188, 172, 111],
        [235, 204, 114],
        ...,
        [236, 245, 198],
        [233, 242, 190],
        [239, 248, 187]],

       [[155, 169, 187],
        [174, 156,  77],
        [239, 235, 175],
        ...,
        [248, 254, 212],
        [237, 242, 209],
        [235, 241, 203]]], dtype=uint8)]"
Image_498.jpg,582,83,232,165,1068,601,814,248,232,daskShared_local/images/Image_498.jpg,498,"[array([[[  0,  72, 255],
        [  0,  72, 255],
        [  1,  74, 255],
        ...,
        [  0,  85, 254],
        [  1,  86, 255],
        [  1,  86, 255]],

       [[  0,  72, 255],
        [  0,  72, 255],
        [  0,  73, 255],
        ...,
        [  0,  85, 254],
        [  1,  86, 255],
        [  1,  86, 255]],

       [[  0,  72, 255],
        [  0,  72, 255],
        [  0,  72, 255],
        ...,
        [  0,  85, 254],
        [  1,  86, 255],
        [  1,  86, 255]],

       ...,

       [[219, 194, 164],
        [210, 185, 145],
        [143, 118,  67],
        ...,
        [218, 224, 214],
        [221, 224, 207],
        [220, 224, 190]],

       [[212, 193, 152],
        [216, 192, 147],
        [208, 181, 132],
        ...,
        [216, 222, 207],
        [221, 225, 203],
        [222, 226, 188]],

       [[ 97,  83,  41],
        [204, 184, 144],
        [252, 225, 193],
        ...,
        [216, 223, 203],
        [220, 225, 198],
        [222, 227, 188]]], dtype=uint8)]"
Image_499.jpg,413,153,245,176,1000,667,658,329,245,daskShared_local/images/Image_499.jpg,499,"[array([[[ 22, 170, 250],
        [ 26, 172, 250],
        [ 33, 175, 252],
        ...,
        [  2, 148, 228],
        [  2, 149, 228],
        [  3, 150, 230]],

       [[ 24, 173, 250],
        [ 28, 173, 251],
        [ 31, 174, 251],
        ...,
        [  1, 147, 227],
        [  0, 148, 228],
        [  2, 149, 227]],

       [[ 30, 174, 252],
        [ 30, 174, 251],
        [ 29, 173, 251],
        ...,
        [  0, 146, 226],
        [  0, 146, 226],
        [  0, 147, 226]],

       ...,

       [[200, 184, 131],
        [194, 176, 121],
        [194, 178, 126],
        ...,
        [  1,  61, 104],
        [  0,  60, 104],
        [  1,  60, 103]],

       [[197, 182, 125],
        [195, 179, 122],
        [188, 173, 118],
        ...,
        [  1,  61, 105],
        [  0,  59, 103],
        [  0,  62, 103]],

       [[183, 164, 101],
        [193, 179, 125],
        [199, 184, 133],
        ...,
        [  0,  60, 104],
        [  0,  60, 104],
        [  0,  62, 103]]], dtype=uint8)]"
Image_5.jpg,1044,1498,1088,772,4613,2968,2132,2270,1088,daskShared_local/images/Image_5.jpg,5,"[array([[[140, 166, 169],
        [145, 171, 174],
        [146, 172, 175],
        ...,
        [137, 130, 119],
        [ 49,  32,  22],
        [ 30,  14,   7]],

       [[131, 155, 158],
        [137, 161, 164],
        [141, 164, 166],
        ...,
        [ 85,  72,  63],
        [ 70,  52,  41],
        [ 61,  43,  29]],

       [[126, 143, 146],
        [133, 148, 152],
        [138, 152, 155],
        ...,
        [ 81,  68,  59],
        [ 84,  70,  60],
        [ 86,  72,  60]],

       ...,

       [[ 61,  69,  70],
        [ 64,  71,  73],
        [ 71,  77,  79],
        ...,
        [115, 112,  99],
        [110, 108,  95],
        [ 97,  96,  89]],

       [[ 65,  77,  76],
        [ 59,  68,  70],
        [ 65,  73,  75],
        ...,
        [ 97,  91,  84],
        [ 88,  81,  74],
        [ 93,  86,  79]],

       [[ 60,  65,  68],
        [ 61,  67,  70],
        [ 64,  69,  72],
        ...,
        [142, 119,  96],
        [126, 110,  93],
        [124, 114,  98]]], dtype=uint8)]"
Image_50.jpg,512,78,150,204,1200,630,662,282,204,daskShared_local/images/Image_50.jpg,50,"[array([[[  0, 157, 224],
        [  0, 157, 224],
        [  2, 157, 224],
        ...,
        [  3, 155, 222],
        [  3, 155, 222],
        [  3, 156, 223]],

       [[  0, 157, 224],
        [  0, 157, 224],
        [  2, 157, 224],
        ...,
        [  3, 155, 222],
        [  3, 155, 222],
        [  3, 156, 223]],

       [[  4, 157, 224],
        [  4, 157, 224],
        [  4, 157, 224],
        ...,
        [  3, 155, 222],
        [  3, 155, 222],
        [  4, 155, 226]],

       ...,

       [[ 29,  14,  17],
        [ 43,  30,  33],
        [ 24,  13,  17],
        ...,
        [  2,  82, 119],
        [  3,  83, 120],
        [  4,  78, 113]],

       [[ 25,  13,  15],
        [ 24,  12,  14],
        [ 27,  16,  20],
        ...,
        [  0,  78, 115],
        [  0,  76, 114],
        [  0,  79, 112]],

       [[ 27,  15,  17],
        [ 23,  11,  13],
        [ 22,  11,  15],
        ...,
        [  0,  78, 116],
        [  0,  78, 116],
        [  0,  79, 109]]], dtype=uint8)]"
Image_500.jpg,429,146,720,617,1152,763,1149,763,720,daskShared_local/images/Image_500.jpg,500,"[array([[[  0, 179, 235],
        [  0, 179, 235],
        [  1, 180, 236],
        ...,
        [  0, 183, 237],
        [  0, 183, 237],
        [  0, 183, 237]],

       [[  0, 179, 235],
        [  0, 179, 235],
        [  1, 180, 236],
        ...,
        [  0, 183, 237],
        [  0, 183, 237],
        [  0, 183, 237]],

       [[  0, 179, 235],
        [  0, 179, 235],
        [  1, 180, 236],
        ...,
        [  0, 183, 237],
        [  0, 183, 237],
        [  0, 184, 238]],

       ...,

       [[146, 171, 140],
        [148, 173, 143],
        [150, 176, 150],
        ...,
        [171, 193, 183],
        [156, 183, 165],
        [144, 176, 145]],

       [[152, 175, 147],
        [153, 176, 150],
        [153, 177, 155],
        ...,
        [149, 180, 173],
        [136, 171, 159],
        [130, 165, 133]],

       [[157, 179, 153],
        [157, 179, 155],
        [157, 180, 157],
        ...,
        [121, 157, 136],
        [138, 163, 135],
        [156, 180, 143]]], dtype=uint8)]"
Image_501.jpg,537,235,163,188,990,681,700,423,188,daskShared_local/images/Image_501.jpg,501,"[array([[[ 39,  36,  21],
        [ 36,  33,  18],
        [ 35,  32,  17],
        ...,
        [ 35,  33,  19],
        [ 36,  30,  16],
        [ 35,  28,  12]],

       [[ 37,  34,  19],
        [ 37,  34,  19],
        [ 37,  34,  19],
        ...,
        [ 37,  34,  17],
        [ 41,  36,  17],
        [ 37,  31,   9]],

       [[ 37,  31,  17],
        [ 39,  33,  19],
        [ 40,  34,  20],
        ...,
        [ 36,  34,  13],
        [ 44,  38,  17],
        [ 41,  34,  11]],

       ...,

       [[162, 151, 113],
        [160, 148, 110],
        [145, 133,  93],
        ...,
        [ 51,  57,  45],
        [ 52,  58,  44],
        [ 57,  61,  47]],

       [[143, 134,  95],
        [137, 128,  87],
        [121, 112,  71],
        ...,
        [ 52,  58,  46],
        [ 53,  59,  45],
        [ 55,  60,  46]],

       [[130, 122,  83],
        [130, 123,  81],
        [120, 113,  71],
        ...,
        [ 48,  54,  42],
        [ 50,  56,  42],
        [ 49,  56,  40]]], dtype=uint8)]"
Image_502.jpg,492,165,105,83,660,438,597,248,105,daskShared_local/images/Image_502.jpg,502,"[array([[[  7,  28,  70],
        [  7,  28,  69],
        [  5,  27,  68],
        ...,
        [ 18,  36,  74],
        [ 17,  37,  72],
        [ 16,  37,  72]],

       [[  7,  28,  70],
        [  7,  28,  69],
        [  5,  27,  68],
        ...,
        [ 17,  36,  74],
        [ 16,  36,  71],
        [ 15,  36,  71]],

       [[  7,  27,  69],
        [  7,  27,  69],
        [  6,  27,  69],
        ...,
        [ 13,  31,  70],
        [  7,  25,  60],
        [  6,  24,  59]],

       ...,

       [[115, 130, 129],
        [120, 136, 130],
        [170, 184, 143],
        ...,
        [ 43,  35,  51],
        [ 47,  37,  53],
        [ 47,  37,  54]],

       [[ 44,  66, 104],
        [ 46,  68, 103],
        [ 61,  80,  93],
        ...,
        [ 38,  30,  49],
        [ 45,  36,  54],
        [ 45,  36,  55]],

       [[ 36,  59, 102],
        [ 38,  60, 100],
        [ 49,  68,  88],
        ...,
        [ 38,  30,  49],
        [ 44,  35,  54],
        [ 45,  36,  55]]], dtype=uint8)]"
Image_503.jpg,383,162,119,119,900,600,502,281,119,daskShared_local/images/Image_503.jpg,503,"[array([[[ 27, 119, 186],
        [ 24, 118, 186],
        [ 16, 118, 187],
        ...,
        [ 90, 113, 149],
        [ 82, 109, 147],
        [ 80, 108, 146]],

       [[ 27, 118, 186],
        [ 24, 118, 186],
        [ 15, 118, 188],
        ...,
        [ 76, 108, 150],
        [ 69, 104, 148],
        [ 66, 103, 147]],

       [[ 25, 118, 187],
        [ 22, 118, 188],
        [ 11, 118, 190],
        ...,
        [ 36,  92, 151],
        [ 28,  91, 152],
        [ 26,  91, 152]],

       ...,

       [[  1,  82, 165],
        [  1,  82, 167],
        [  1,  82, 171],
        ...,
        [131, 102, 124],
        [129, 100, 122],
        [129, 100, 122]],

       [[  1,  81, 165],
        [  1,  81, 166],
        [  1,  81, 168],
        ...,
        [131, 103, 125],
        [122,  93, 116],
        [119,  89, 113]],

       [[  0,  81, 165],
        [  1,  81, 166],
        [  1,  81, 167],
        ...,
        [131, 103, 125],
        [119,  90, 114],
        [115,  86, 110]]], dtype=uint8)]"
Image_504.jpg,407,130,121,91,759,422,528,221,121,daskShared_local/images/Image_504.jpg,504,"[array([[[124, 197, 200],
        [116, 188, 192],
        [ 95, 166, 170],
        ...,
        [ 62, 170, 185],
        [ 44, 152, 167],
        [ 38, 145, 161]],

       [[121, 193, 197],
        [114, 186, 189],
        [ 95, 166, 170],
        ...,
        [ 57, 165, 181],
        [ 40, 148, 163],
        [ 33, 141, 157]],

       [[113, 184, 188],
        [108, 179, 183],
        [ 95, 166, 170],
        ...,
        [ 44, 154, 169],
        [ 28, 138, 153],
        [ 22, 132, 147]],

       ...,

       [[  0, 156, 187],
        [  0, 155, 186],
        [  0, 154, 185],
        ...,
        [  0, 137, 163],
        [  0, 137, 163],
        [  0, 137, 163]],

       [[  0, 155, 186],
        [  0, 154, 185],
        [  0, 153, 184],
        ...,
        [  0, 137, 163],
        [  0, 137, 163],
        [  0, 137, 163]],

       [[  0, 154, 185],
        [  0, 154, 185],
        [  0, 153, 184],
        ...,
        [  0, 137, 163],
        [  0, 137, 163],
        [  0, 137, 163]]], dtype=uint8)]"
Image_505.jpg,475,159,233,273,981,650,708,432,273,daskShared_local/images/Image_505.jpg,505,"[array([[[244, 244, 244],
        [244, 244, 244],
        [244, 244, 244],
        ...,
        [243, 243, 243],
        [243, 243, 243],
        [243, 243, 243]],

       [[244, 244, 244],
        [244, 244, 244],
        [244, 244, 244],
        ...,
        [242, 242, 242],
        [242, 242, 242],
        [242, 242, 242]],

       [[244, 244, 244],
        [244, 244, 244],
        [244, 244, 244],
        ...,
        [242, 242, 242],
        [242, 242, 242],
        [242, 242, 242]],

       ...,

       [[ 26,  93, 174],
        [ 26,  93, 171],
        [ 24,  91, 169],
        ...,
        [ 22,  90, 171],
        [ 22,  90, 171],
        [ 22,  91, 170]],

       [[ 26,  93, 174],
        [ 27,  94, 172],
        [ 25,  92, 170],
        ...,
        [ 21,  89, 171],
        [ 23,  91, 172],
        [ 24,  92, 173]],

       [[ 26,  93, 174],
        [ 29,  96, 175],
        [ 26,  93, 171],
        ...,
        [ 21,  89, 173],
        [ 24,  92, 175],
        [ 26,  94, 176]]], dtype=uint8)]"
Image_506.jpg,403,310,245,214,1500,1000,648,524,245,daskShared_local/images/Image_506.jpg,506,"[array([[[  1, 129, 154],
        [  1, 128, 153],
        [  3, 129, 154],
        ...,
        [  0, 100, 122],
        [  0, 100, 122],
        [  0, 100, 122]],

       [[  0, 127, 151],
        [  0, 127, 152],
        [  1, 130, 154],
        ...,
        [  3, 108, 130],
        [  0, 104, 125],
        [  1, 107, 128]],

       [[  0, 129, 152],
        [  0, 129, 152],
        [  0, 131, 154],
        ...,
        [  5, 114, 134],
        [  0, 109, 128],
        [  0, 110, 129]],

       ...,

       [[ 86, 126, 108],
        [ 88, 129, 114],
        [ 80, 123, 109],
        ...,
        [188, 189, 132],
        [193, 194, 137],
        [198, 199, 139]],

       [[ 94, 132, 115],
        [ 95, 135, 120],
        [ 86, 129, 114],
        ...,
        [145, 145,  86],
        [163, 163, 104],
        [170, 169, 108]],

       [[ 92, 127, 110],
        [ 90, 129, 112],
        [ 87, 129, 114],
        ...,
        [ 98,  96,  35],
        [107, 105,  44],
        [143, 139,  78]]], dtype=uint8)]"
Image_507.jpg,1285,642,189,157,2304,1536,1474,799,189,daskShared_local/images/Image_507.jpg,507,"[array([[[  0, 122, 175],
        [  0, 122, 175],
        [  0, 125, 178],
        ...,
        [  0, 105, 143],
        [  0, 108, 146],
        [  0, 106, 145]],

       [[ 11, 140, 195],
        [ 10, 139, 194],
        [ 15, 142, 197],
        ...,
        [  0, 107, 145],
        [  0, 108, 146],
        [  0, 108, 146]],

       [[ 31, 155, 208],
        [ 31, 156, 208],
        [ 36, 158, 211],
        ...,
        [  0, 110, 145],
        [  1, 109, 147],
        [  0, 108, 146]],

       ...,

       [[132, 167, 159],
        [160, 193, 186],
        [164, 199, 193],
        ...,
        [ 37,  28,  45],
        [ 25,  23,  44],
        [ 23,  21,  42]],

       [[176, 212, 201],
        [172, 207, 204],
        [126, 164, 166],
        ...,
        [ 23,  21,  40],
        [ 22,  20,  41],
        [ 22,  20,  41]],

       [[162, 206, 205],
        [127, 169, 183],
        [ 82, 129, 148],
        ...,
        [ 16,  19,  43],
        [ 19,  20,  40],
        [ 20,  21,  41]]], dtype=uint8)]"
Image_508.jpg,182,102,367,279,1024,670,549,381,367,daskShared_local/images/Image_508.jpg,508,"[array([[[ 45,  50,  68],
        [ 25,  30,  44],
        [ 28,  36,  47],
        ...,
        [ 42, 144, 167],
        [ 16, 122, 131],
        [ 14, 127, 126]],

       [[ 30,  35,  53],
        [ 27,  33,  46],
        [ 26,  34,  45],
        ...,
        [ 39, 141, 157],
        [ 44, 152, 155],
        [ 15, 124, 116]],

       [[ 54,  61,  79],
        [ 45,  52,  65],
        [ 32,  42,  51],
        ...,
        [ 21, 103, 118],
        [  4,  93,  93],
        [ 55, 147, 138]],

       ...,

       [[ 76, 172, 194],
        [ 68, 183, 208],
        [ 56, 195, 216],
        ...,
        [184, 237, 236],
        [192, 245, 244],
        [173, 235, 244]],

       [[ 63, 170, 190],
        [ 69, 194, 213],
        [ 63, 201, 215],
        ...,
        [130, 201, 230],
        [149, 220, 249],
        [149, 226, 254]],

       [[ 76, 195, 215],
        [ 51, 189, 199],
        [ 46, 189, 189],
        ...,
        [ 41, 114, 157],
        [ 93, 168, 211],
        [106, 182, 224]]], dtype=uint8)]"
Image_509.jpg,250,218,133,133,775,518,383,351,133,daskShared_local/images/Image_509.jpg,509,"[array([[[174, 146, 135],
        [171, 143, 132],
        [162, 134, 123],
        ...,
        [133, 106,  84],
        [129, 100,  79],
        [126,  96,  76]],

       [[173, 145, 133],
        [165, 137, 126],
        [153, 125, 113],
        ...,
        [126,  99,  78],
        [131, 103,  83],
        [134, 104,  85]],

       [[172, 144, 132],
        [161, 133, 121],
        [147, 119, 106],
        ...,
        [111,  84,  65],
        [128, 101,  82],
        [139, 111,  92]],

       ...,

       [[150, 127,  76],
        [151, 128,  77],
        [155, 131,  82],
        ...,
        [202, 163, 122],
        [199, 160, 119],
        [195, 156, 115]],

       [[162, 138,  85],
        [164, 141,  88],
        [169, 145,  95],
        ...,
        [205, 166, 124],
        [195, 156, 114],
        [188, 149, 107]],

       [[168, 143,  88],
        [170, 146,  93],
        [175, 151, 101],
        ...,
        [205, 166, 124],
        [193, 154, 111],
        [185, 146, 104]]], dtype=uint8)]"
Image_51.jpg,423,175,819,635,1500,1000,1242,810,819,daskShared_local/images/Image_51.jpg,51,"[array([[[  3,  55,  66],
        [  3,  55,  66],
        [  2,  54,  65],
        ...,
        [115, 116, 147],
        [ 94,  99, 138],
        [ 75,  81, 129]],

       [[  3,  56,  66],
        [  3,  55,  66],
        [  2,  54,  65],
        ...,
        [100, 103, 139],
        [ 87,  91, 134],
        [ 77,  80, 128]],

       [[  3,  56,  67],
        [  3,  55,  66],
        [  2,  54,  65],
        ...,
        [ 84,  88, 132],
        [ 78,  82, 128],
        [ 74,  78, 127]],

       ...,

       [[207, 206, 211],
        [204, 204, 208],
        [190, 192, 202],
        ...,
        [ 60,  86,  57],
        [ 57,  86,  56],
        [ 56,  87,  56]],

       [[199, 200, 208],
        [202, 201, 208],
        [193, 194, 204],
        ...,
        [ 61,  87,  58],
        [ 60,  88,  58],
        [ 58,  89,  58]],

       [[186, 191, 204],
        [194, 196, 207],
        [190, 193, 205],
        ...,
        [ 62,  88,  58],
        [ 61,  88,  59],
        [ 59,  89,  58]]], dtype=uint8)]"
Image_510.jpg,310,310,148,129,966,642,458,439,148,daskShared_local/images/Image_510.jpg,510,"[array([[[ 32, 211, 225],
        [ 28, 210, 223],
        [ 20, 207, 217],
        ...,
        [154, 100,  60],
        [146,  98,  57],
        [145, 100,  57]],

       [[ 27, 208, 222],
        [ 24, 207, 221],
        [ 17, 205, 215],
        ...,
        [143,  95,  54],
        [141,  93,  51],
        [145,  96,  52]],

       [[ 24, 206, 219],
        [ 22, 206, 218],
        [ 18, 205, 216],
        ...,
        [127,  82,  43],
        [132,  78,  39],
        [142,  84,  41]],

       ...,

       [[ 24, 199, 207],
        [ 25, 200, 208],
        [ 29, 198, 211],
        ...,
        [ 59, 229, 241],
        [ 63, 228, 243],
        [ 65, 228, 245]],

       [[ 29, 199, 211],
        [ 29, 200, 212],
        [ 29, 200, 213],
        ...,
        [ 58, 228, 239],
        [ 64, 230, 242],
        [ 68, 232, 246]],

       [[ 33, 198, 214],
        [ 32, 199, 215],
        [ 25, 199, 213],
        ...,
        [ 59, 228, 238],
        [ 66, 233, 241],
        [ 71, 237, 246]]], dtype=uint8)]"
Image_511.jpg,731,345,177,143,1600,1000,908,488,177,daskShared_local/images/Image_511.jpg,511,"[array([[[  0,  81, 163],
        [  0,  81, 163],
        [  0,  81, 163],
        ...,
        [  0,  81, 163],
        [  0,  81, 163],
        [  0,  81, 163]],

       [[  0,  81, 163],
        [  0,  81, 163],
        [  0,  81, 163],
        ...,
        [  0,  81, 163],
        [  0,  81, 163],
        [  0,  81, 163]],

       [[  0,  81, 163],
        [  0,  81, 163],
        [  0,  81, 163],
        ...,
        [  0,  81, 163],
        [  0,  81, 163],
        [  0,  81, 163]],

       ...,

       [[ 83, 176, 177],
        [ 85, 180, 174],
        [ 91, 188, 176],
        ...,
        [203, 167, 152],
        [202, 172, 160],
        [190, 166, 154]],

       [[ 80, 173, 164],
        [ 74, 168, 153],
        [ 71, 164, 144],
        ...,
        [232, 194, 177],
        [229, 196, 181],
        [210, 183, 168]],

       [[  8, 102,  88],
        [ 34, 126, 108],
        [ 25, 114,  91],
        ...,
        [212, 170, 151],
        [208, 172, 154],
        [213, 184, 166]]], dtype=uint8)]"
Image_512.jpg,407,323,135,129,800,600,542,452,135,daskShared_local/images/Image_512.jpg,512,"[array([[[197, 173, 134],
        [202, 176, 138],
        [210, 184, 148],
        ...,
        [  1,  90,  99],
        [  1,  90, 100],
        [  1,  90, 100]],

       [[197, 170, 135],
        [201, 170, 135],
        [208, 176, 141],
        ...,
        [  2,  90, 100],
        [  2,  91, 101],
        [  2,  91, 102]],

       [[196, 165, 136],
        [197, 162, 130],
        [202, 164, 130],
        ...,
        [  4,  91, 101],
        [  4,  93, 103],
        [  4,  94, 105]],

       ...,

       [[ 31,  50,  49],
        [ 31,  51,  50],
        [ 32,  52,  51],
        ...,
        [ 44, 117,  68],
        [ 44, 116,  70],
        [ 43, 114,  69]],

       [[ 28,  49,  48],
        [ 29,  49,  49],
        [ 29,  50,  49],
        ...,
        [ 45, 125,  66],
        [ 46, 122,  69],
        [ 45, 118,  69]],

       [[ 27,  48,  49],
        [ 27,  49,  48],
        [ 27,  50,  48],
        ...,
        [ 43, 127,  65],
        [ 44, 123,  68],
        [ 44, 119,  68]]], dtype=uint8)]"
Image_513.jpg,684,312,514,478,1920,1080,1198,790,514,daskShared_local/images/Image_513.jpg,513,"[array([[[ 43, 106, 145],
        [ 49, 101, 128],
        [ 10,  42,  58],
        ...,
        [ 37,  62,  65],
        [ 35,  63,  64],
        [ 38,  73,  71]],

       [[ 45, 104, 143],
        [ 58, 109, 141],
        [ 22,  56,  77],
        ...,
        [ 47,  74,  75],
        [ 32,  69,  67],
        [ 34,  78,  73]],

       [[ 47, 101, 130],
        [ 55, 104, 131],
        [ 46,  83,  99],
        ...,
        [ 37,  74,  71],
        [ 28,  77,  71],
        [ 38,  95,  88]],

       ...,

       [[ 29,  95, 145],
        [ 28,  94, 143],
        [ 28,  94, 143],
        ...,
        [ 22,  36,  37],
        [ 22,  40,  39],
        [ 27,  46,  42]],

       [[ 28,  94, 144],
        [ 27,  93, 143],
        [ 29,  95, 145],
        ...,
        [ 25,  40,  41],
        [ 24,  43,  42],
        [ 27,  45,  42]],

       [[ 29,  95, 145],
        [ 28,  94, 144],
        [ 29,  95, 145],
        ...,
        [ 27,  43,  43],
        [ 24,  42,  41],
        [ 28,  45,  43]]], dtype=uint8)]"
Image_514.jpg,164,176,179,139,728,500,343,315,179,daskShared_local/images/Image_514.jpg,514,"[array([[[  1,  71, 219],
        [  1,  71, 218],
        [  1,  71, 218],
        ...,
        [  0,  80, 227],
        [  1,  82, 226],
        [  2,  83, 227]],

       [[  1,  71, 219],
        [  1,  71, 218],
        [  0,  70, 217],
        ...,
        [  0,  80, 225],
        [  0,  81, 225],
        [  1,  82, 226]],

       [[  2,  72, 219],
        [  2,  72, 219],
        [  1,  71, 218],
        ...,
        [  1,  80, 225],
        [  1,  80, 225],
        [  2,  81, 225]],

       ...,

       [[ 29, 137, 147],
        [ 25, 139, 145],
        [ 20, 139, 146],
        ...,
        [237, 206, 149],
        [250, 238, 190],
        [242, 227, 172]],

       [[ 34, 144, 155],
        [ 25, 140, 147],
        [ 19, 140, 148],
        ...,
        [242, 216, 181],
        [248, 238, 217],
        [240, 225, 193]],

       [[ 28, 146, 150],
        [ 21, 140, 146],
        [ 19, 139, 147],
        ...,
        [236, 200, 164],
        [236, 208, 187],
        [234, 213, 185]]], dtype=uint8)]"
Image_515.jpg,796,337,164,118,1536,1024,960,455,164,daskShared_local/images/Image_515.jpg,515,"[array([[[ 14,  34,  45],
        [ 12,  33,  44],
        [  6,  29,  42],
        ...,
        [ 46, 123, 213],
        [ 46, 123, 213],
        [ 46, 123, 213]],

       [[ 17,  39,  50],
        [ 16,  39,  51],
        [ 11,  36,  49],
        ...,
        [ 46, 123, 213],
        [ 47, 124, 214],
        [ 47, 124, 214]],

       [[ 16,  39,  51],
        [ 17,  41,  54],
        [ 14,  41,  56],
        ...,
        [ 47, 124, 214],
        [ 47, 124, 214],
        [ 48, 125, 215]],

       ...,

       [[ 18, 115, 201],
        [ 20, 115, 202],
        [ 20, 116, 202],
        ...,
        [  9, 115, 204],
        [  8, 114, 204],
        [  6, 113, 202]],

       [[ 18, 116, 202],
        [ 20, 117, 203],
        [ 18, 117, 202],
        ...,
        [  8, 115, 203],
        [  6, 114, 202],
        [  4, 112, 200]],

       [[ 19, 117, 204],
        [ 19, 117, 204],
        [ 16, 115, 202],
        ...,
        [  9, 116, 204],
        [  6, 114, 202],
        [  4, 112, 200]]], dtype=uint8)]"
Image_516.jpg,1769,2547,527,425,2720,4080,2296,2972,527,daskShared_local/images/Image_516.jpg,516,"[array([[[ 45,  60,  58],
        [ 36,  56,  51],
        [ 22,  44,  38],
        ...,
        [  4, 121, 193],
        [  6, 130, 200],
        [  4, 134, 202]],

       [[ 43,  59,  52],
        [ 26,  46,  42],
        [ 14,  35,  33],
        ...,
        [  3, 119, 191],
        [  6, 129, 199],
        [  2, 130, 198]],

       [[ 53,  68,  56],
        [ 38,  56,  53],
        [ 24,  43,  43],
        ...,
        [  6, 126, 195],
        [  2, 123, 191],
        [  6, 133, 200]],

       ...,

       [[  5, 117, 191],
        [  6, 115, 189],
        [  8, 119, 193],
        ...,
        [  3, 114, 190],
        [  7, 118, 194],
        [  4, 115, 191]],

       [[  7, 119, 193],
        [  4, 114, 188],
        [  4, 113, 187],
        ...,
        [  5, 116, 192],
        [  2, 113, 189],
        [  4, 115, 191]],

       [[  3, 111, 185],
        [  3, 114, 188],
        [  5, 115, 189],
        ...,
        [  3, 114, 190],
        [  1, 110, 186],
        [  4, 115, 191]]], dtype=uint8)]"
Image_517.jpg,79,87,116,127,637,450,195,214,127,daskShared_local/images/Image_517.jpg,517,"[array([[[  1, 172, 254],
        [  1, 172, 254],
        [  1, 172, 254],
        ...,
        [  2, 171, 255],
        [  1, 170, 254],
        [  0, 169, 254]],

       [[  1, 171, 254],
        [  1, 171, 254],
        [  1, 171, 254],
        ...,
        [  1, 170, 254],
        [  1, 169, 254],
        [  1, 168, 254]],

       [[  1, 170, 253],
        [  1, 170, 253],
        [  1, 170, 253],
        ...,
        [  0, 169, 254],
        [  1, 168, 253],
        [  1, 167, 253]],

       ...,

       [[  9, 160, 253],
        [  6, 159, 251],
        [  1, 159, 247],
        ...,
        [ 84, 127, 104],
        [ 96, 138, 115],
        [102, 144, 120]],

       [[  9, 162, 254],
        [  7, 162, 253],
        [  2, 161, 249],
        ...,
        [ 76, 123, 102],
        [ 83, 129, 108],
        [ 88, 133, 111]],

       [[  9, 163, 254],
        [  7, 162, 253],
        [  2, 162, 250],
        ...,
        [ 73, 121, 101],
        [ 78, 125, 104],
        [ 81, 127, 107]]], dtype=uint8)]"
Image_518.jpg,283,130,101,117,775,518,384,247,117,daskShared_local/images/Image_518.jpg,518,"[array([[[ 87, 164, 184],
        [ 86, 163, 183],
        [ 86, 163, 183],
        ...,
        [ 91, 160, 176],
        [ 97, 166, 182],
        [ 99, 168, 184]],

       [[ 86, 163, 183],
        [ 86, 163, 183],
        [ 86, 163, 183],
        ...,
        [ 91, 160, 176],
        [ 96, 165, 181],
        [ 98, 167, 183]],

       [[ 86, 163, 183],
        [ 86, 163, 183],
        [ 85, 162, 182],
        ...,
        [ 93, 162, 178],
        [ 94, 163, 179],
        [ 94, 163, 179]],

       ...,

       [[184, 144, 118],
        [187, 147, 121],
        [195, 155, 129],
        ...,
        [172, 125,  98],
        [161, 114,  95],
        [157, 111,  95]],

       [[195, 154, 128],
        [196, 155, 129],
        [198, 159, 131],
        ...,
        [139,  91,  62],
        [147,  99,  81],
        [149, 102,  87]],

       [[199, 157, 132],
        [199, 158, 132],
        [199, 160, 131],
        ...,
        [128,  80,  51],
        [142,  94,  76],
        [147,  99,  84]]], dtype=uint8)]"
Image_519.jpg,626,322,150,120,1440,960,776,442,150,daskShared_local/images/Image_519.jpg,519,"[array([[[  0, 144, 205],
        [  1, 145, 206],
        [  1, 145, 206],
        ...,
        [  0, 144, 214],
        [  0, 144, 214],
        [  1, 145, 215]],

       [[  1, 145, 206],
        [  1, 145, 206],
        [  1, 145, 206],
        ...,
        [  0, 143, 213],
        [  0, 143, 213],
        [  0, 144, 214]],

       [[  1, 145, 206],
        [  1, 145, 206],
        [  1, 145, 206],
        ...,
        [  0, 143, 213],
        [  0, 143, 213],
        [  0, 144, 214]],

       ...,

       [[ 76,  70,  49],
        [ 69,  64,  43],
        [ 58,  55,  34],
        ...,
        [  1,  75, 112],
        [  0,  77, 113],
        [  0,  78, 114]],

       [[ 67,  66,  47],
        [ 68,  67,  48],
        [ 56,  55,  37],
        ...,
        [  0,  75, 111],
        [  0,  76, 112],
        [  1,  78, 114]],

       [[ 63,  66,  49],
        [ 75,  78,  60],
        [ 71,  73,  56],
        ...,
        [  0,  75, 111],
        [  1,  76, 112],
        [  2,  78, 114]]], dtype=uint8)]"
Image_52.jpg,976,388,193,205,2000,1000,1169,593,205,daskShared_local/images/Image_52.jpg,52,"[array([[[209, 187, 150],
        [206, 186, 149],
        [207, 187, 151],
        ...,
        [213, 194, 161],
        [209, 191, 155],
        [202, 184, 148]],

       [[206, 184, 145],
        [205, 185, 148],
        [208, 188, 151],
        ...,
        [204, 188, 155],
        [204, 188, 154],
        [203, 185, 149]],

       [[203, 181, 142],
        [206, 187, 147],
        [209, 189, 152],
        ...,
        [197, 180, 150],
        [199, 183, 150],
        [202, 183, 150]],

       ...,

       [[ 33,  33,  34],
        [ 37,  37,  37],
        [ 38,  38,  38],
        ...,
        [196, 161, 118],
        [199, 169, 130],
        [187, 161, 126]],

       [[ 54,  53,  51],
        [ 62,  60,  61],
        [ 61,  61,  59],
        ...,
        [196, 164, 125],
        [208, 177, 145],
        [196, 165, 136]],

       [[ 89,  88,  83],
        [100, 100,  90],
        [102, 100,  88],
        ...,
        [189, 162, 122],
        [198, 168, 130],
        [199, 166, 131]]], dtype=uint8)]"
Image_520.jpg,454,150,138,122,1024,512,592,272,138,daskShared_local/images/Image_520.jpg,520,"[array([[[  1, 135, 191],
        [  0, 135, 191],
        [  0, 134, 190],
        ...,
        [  0, 161, 206],
        [  0, 161, 206],
        [  0, 161, 206]],

       [[  0, 135, 191],
        [  0, 134, 190],
        [  0, 134, 190],
        ...,
        [  0, 162, 207],
        [  0, 162, 207],
        [  0, 162, 207]],

       [[  0, 134, 190],
        [  0, 133, 190],
        [  0, 133, 189],
        ...,
        [  0, 162, 207],
        [  0, 162, 206],
        [  0, 162, 206]],

       ...,

       [[165, 157, 126],
        [138, 130,  99],
        [ 97,  90,  60],
        ...,
        [  0, 143, 196],
        [  0, 143, 196],
        [  0, 142, 195]],

       [[196, 188, 156],
        [169, 161, 129],
        [122, 115,  83],
        ...,
        [  0, 143, 196],
        [  0, 142, 195],
        [  0, 142, 195]],

       [[207, 198, 166],
        [183, 174, 142],
        [137, 129,  97],
        ...,
        [  0, 142, 195],
        [  0, 142, 195],
        [  0, 142, 195]]], dtype=uint8)]"
Image_521.jpg,107,78,94,65,475,264,201,143,94,daskShared_local/images/Image_521.jpg,521,"[array([[[ 23,  43,  62],
        [ 24,  43,  62],
        [ 23,  43,  61],
        ...,
        [ 44,  73, 101],
        [ 41,  70,  98],
        [ 41,  70,  98]],

       [[ 23,  43,  62],
        [ 23,  43,  62],
        [ 22,  43,  61],
        ...,
        [ 45,  74, 102],
        [ 41,  70,  98],
        [ 42,  71,  99]],

       [[ 26,  42,  61],
        [ 27,  42,  61],
        [ 24,  41,  60],
        ...,
        [ 40,  68,  95],
        [ 38,  65,  93],
        [ 38,  66,  93]],

       ...,

       [[ 17,  27,  35],
        [ 17,  27,  36],
        [ 15,  25,  33],
        ...,
        [ 56,  78,  93],
        [ 48,  72,  86],
        [ 49,  73,  86]],

       [[ 16,  26,  35],
        [ 16,  26,  35],
        [ 15,  26,  34],
        ...,
        [ 63,  87, 108],
        [ 57,  85, 106],
        [ 58,  85, 106]],

       [[ 16,  26,  35],
        [ 16,  26,  35],
        [ 15,  25,  34],
        ...,
        [ 62,  86, 107],
        [ 56,  83, 103],
        [ 57,  84, 104]]], dtype=uint8)]"
Image_522.jpg,585,176,173,172,1000,665,758,348,173,daskShared_local/images/Image_522.jpg,522,"[array([[[ 41, 134, 201],
        [ 46, 135, 200],
        [ 35, 134, 199],
        ...,
        [ 15, 128, 195],
        [ 15, 128, 194],
        [ 14, 129, 196]],

       [[ 36, 132, 199],
        [ 38, 134, 199],
        [ 37, 133, 199],
        ...,
        [ 18, 129, 196],
        [ 19, 129, 195],
        [ 14, 128, 195]],

       [[ 41, 134, 198],
        [ 33, 132, 198],
        [ 40, 134, 199],
        ...,
        [ 15, 129, 196],
        [ 16, 129, 196],
        [ 13, 128, 195]],

       ...,

       [[ 20,  84,  97],
        [ 17,  85,  99],
        [ 18,  94, 108],
        ...,
        [  4,  79,  90],
        [  5,  79,  88],
        [  8,  81,  89]],

       [[  6,  69,  78],
        [ 20,  85,  96],
        [ 20,  94, 110],
        ...,
        [  4,  81,  92],
        [  3,  81,  91],
        [ 10,  84,  93]],

       [[  1,  60,  66],
        [ 14,  74,  81],
        [ 21,  86,  98],
        ...,
        [  5,  82,  93],
        [  6,  84,  94],
        [  6,  83,  93]]], dtype=uint8)]"
Image_523.jpg,777,533,1230,1474,3072,2304,2007,2007,1474,daskShared_local/images/Image_523.jpg,523,"[array([[[119, 121, 117],
        [ 95,  97,  86],
        [ 77,  70,  60],
        ...,
        [120,  90, 100],
        [130, 100, 114],
        [142, 106, 123]],

       [[116, 113, 103],
        [ 92,  89,  76],
        [ 81,  73,  62],
        ...,
        [ 89,  65,  71],
        [106,  81,  93],
        [133, 106, 120]],

       [[107, 103,  91],
        [ 88,  83,  72],
        [ 81,  74,  64],
        ...,
        [ 66,  44,  51],
        [ 74,  50,  64],
        [ 93,  69,  86]],

       ...,

       [[  7, 114, 121],
        [  6, 113, 119],
        [  6, 113, 119],
        ...,
        [ 13,  98, 114],
        [  9,  97, 109],
        [  9,  95, 111]],

       [[  6, 113, 120],
        [  6, 113, 119],
        [  6, 113, 120],
        ...,
        [ 13,  98, 111],
        [  6,  94, 107],
        [ 10,  95, 112]],

       [[  7, 112, 122],
        [  7, 111, 121],
        [  5, 112, 122],
        ...,
        [ 11,  95, 107],
        [  8,  94, 111],
        [ 14, 103, 120]]], dtype=uint8)]"
Image_524.jpg,198,339,271,198,1024,768,469,537,271,daskShared_local/images/Image_524.jpg,524,"[array([[[ 95, 154, 174],
        [ 82, 142, 161],
        [ 76, 135, 153],
        ...,
        [  8,  16,  33],
        [ 31,  39,  57],
        [ 26,  32,  52]],

       [[ 75, 127, 151],
        [ 74, 127, 153],
        [104, 156, 184],
        ...,
        [ 26,  32,  52],
        [ 30,  35,  56],
        [ 19,  24,  46]],

       [[109, 158, 176],
        [109, 157, 179],
        [100, 151, 173],
        ...,
        [ 20,  22,  45],
        [ 20,  22,  45],
        [ 19,  21,  44]],

       ...,

       [[ 10,  30,  85],
        [ 85, 126, 155],
        [ 90, 147, 149],
        ...,
        [ 14,   4,   3],
        [ 12,   2,   1],
        [ 18,   8,   7]],

       [[  9,  28,  77],
        [ 57,  98, 125],
        [ 81, 138, 141],
        ...,
        [ 12,   0,   0],
        [ 12,   1,   1],
        [ 16,   4,   4]],

       [[ 42,  65, 109],
        [ 86, 127, 151],
        [ 89, 146, 148],
        ...,
        [ 14,   2,   2],
        [ 15,   3,   3],
        [ 14,   2,   2]]], dtype=uint8)]"
Image_525.jpg,497,143,213,165,800,600,710,308,213,daskShared_local/images/Image_525.jpg,525,"[array([[[  4,  28,  66],
        [  4,  27,  58],
        [  1,  22,  50],
        ...,
        [  8,   9,  17],
        [  9,   8,  14],
        [  5,   4,  10]],

       [[  1,  36,  73],
        [  0,  29,  59],
        [  2,  25,  51],
        ...,
        [ 10,  14,  19],
        [  5,   8,  13],
        [  8,  10,  15]],

       [[  5,  41,  81],
        [  3,  30,  73],
        [  1,  21,  62],
        ...,
        [ 10,  14,  21],
        [ 10,  13,  20],
        [ 13,  14,  20]],

       ...,

       [[226, 192, 131],
        [220, 187, 136],
        [201, 178, 140],
        ...,
        [ 30,  20,  18],
        [ 31,  18,  15],
        [ 29,  16,  12]],

       [[210, 178, 121],
        [217, 187, 138],
        [202, 178, 140],
        ...,
        [ 26,  13,  12],
        [ 28,  13,  10],
        [ 27,  12,   9]],

       [[206, 176, 122],
        [220, 193, 146],
        [208, 185, 145],
        ...,
        [ 24,  14,  12],
        [ 27,  16,  13],
        [ 29,  15,  12]]], dtype=uint8)]"
Image_526.jpg,106,113,409,284,800,533,515,397,409,daskShared_local/images/Image_526.jpg,526,"[array([[[  3,  11,  57],
        [  3,  12,  59],
        [ 22,  33,  84],
        ...,
        [ 12,  19,  71],
        [ 10,  18,  69],
        [  6,  16,  67]],

       [[  4,  12,  58],
        [  3,  10,  56],
        [  4,  11,  58],
        ...,
        [  9,  18,  71],
        [  9,  18,  71],
        [  8,  18,  69]],

       [[  4,   9,  56],
        [  3,  11,  55],
        [  3,  11,  55],
        ...,
        [  5,  18,  71],
        [  4,  17,  70],
        [  7,  18,  71]],

       ...,

       [[  8,  15,  59],
        [  7,  14,  58],
        [  8,  15,  59],
        ...,
        [106,  88,  48],
        [145, 126,  93],
        [167, 143, 112]],

       [[ 12,  17,  62],
        [  8,  14,  58],
        [  6,  13,  57],
        ...,
        [ 88,  80,  40],
        [118, 110,  78],
        [155, 143, 118]],

       [[  8,  16,  59],
        [  7,  14,  58],
        [  7,  14,  60],
        ...,
        [ 86,  85,  44],
        [ 89,  87,  53],
        [101,  97,  71]]], dtype=uint8)]"
Image_527.jpg,114,387,377,302,1715,1286,491,689,377,daskShared_local/images/Image_527.jpg,527,"[array([[[139, 143, 142],
        [145, 149, 148],
        [147, 152, 152],
        ...,
        [102, 104, 135],
        [105, 114, 143],
        [114, 134, 154]],

       [[141, 144, 140],
        [143, 149, 147],
        [147, 156, 153],
        ...,
        [ 90,  85, 107],
        [ 95,  93, 119],
        [105, 108, 141]],

       [[143, 146, 141],
        [146, 151, 150],
        [149, 160, 155],
        ...,
        [ 92,  84,  92],
        [102,  90, 101],
        [112,  96, 116]],

       ...,

       [[194, 199, 181],
        [190, 191, 181],
        [184, 187, 172],
        ...,
        [164, 182, 196],
        [175, 182, 194],
        [179, 185, 197]],

       [[194, 200, 185],
        [192, 195, 183],
        [188, 191, 182],
        ...,
        [159, 162, 195],
        [173, 178, 189],
        [177, 186, 197]],

       [[189, 199, 187],
        [185, 196, 181],
        [183, 193, 178],
        ...,
        [172, 162, 183],
        [172, 172, 188],
        [174, 180, 192]]], dtype=uint8)]"
Image_528.jpg,315,293,140,100,1280,720,455,393,140,daskShared_local/images/Image_528.jpg,528,"[array([[[  0,  60, 133],
        [  0,  60, 133],
        [  0,  60, 133],
        ...,
        [  0,  61, 136],
        [  0,  61, 136],
        [  0,  61, 136]],

       [[  0,  60, 133],
        [  0,  60, 133],
        [  0,  60, 133],
        ...,
        [  0,  61, 136],
        [  0,  61, 136],
        [  0,  61, 136]],

       [[  0,  60, 133],
        [  0,  60, 133],
        [  0,  60, 133],
        ...,
        [  0,  61, 136],
        [  0,  61, 136],
        [  0,  61, 136]],

       ...,

       [[ 32, 106, 130],
        [ 32, 106, 130],
        [ 32, 106, 130],
        ...,
        [ 21,  97, 131],
        [ 20,  97, 131],
        [ 20,  97, 131]],

       [[ 33, 108, 131],
        [ 33, 108, 131],
        [ 33, 108, 131],
        ...,
        [ 21,  97, 131],
        [ 21,  97, 131],
        [ 21,  97, 131]],

       [[ 34, 109, 132],
        [ 34, 109, 132],
        [ 34, 109, 132],
        ...,
        [ 22,  98, 132],
        [ 22,  98, 132],
        [ 22,  98, 132]]], dtype=uint8)]"
Image_529.jpg,355,20,599,535,1190,595,954,555,599,daskShared_local/images/Image_529.jpg,529,"[array([[[219, 234, 237],
        [213, 228, 233],
        [209, 226, 233],
        ...,
        [203, 217, 207],
        [204, 217, 206],
        [204, 217, 207]],

       [[203, 223, 235],
        [188, 215, 230],
        [176, 207, 225],
        ...,
        [202, 217, 208],
        [203, 217, 207],
        [203, 216, 206]],

       [[192, 220, 232],
        [185, 215, 231],
        [181, 212, 231],
        ...,
        [204, 217, 208],
        [202, 217, 207],
        [204, 217, 207]],

       ...,

       [[ 39,  22,  22],
        [ 40,  17,  19],
        [ 37,  19,  18],
        ...,
        [155, 110, 102],
        [160, 125, 119],
        [151, 118, 115]],

       [[ 42,  14,  20],
        [ 38,  15,  18],
        [ 32,  15,  19],
        ...,
        [151, 104,  95],
        [150, 111, 104],
        [140, 100,  97]],

       [[ 37,  15,  22],
        [ 34,  14,  20],
        [ 28,  16,  21],
        ...,
        [145,  95,  90],
        [134,  93,  87],
        [129,  87,  88]]], dtype=uint8)]"
Image_53.jpg,364,23,150,134,550,380,514,157,150,daskShared_local/images/Image_53.jpg,53,"[array([[[ 75,  94, 150],
        [ 75,  94, 150],
        [ 75,  94, 150],
        ...,
        [ 69,  84, 143],
        [ 69,  84, 143],
        [ 69,  84, 143]],

       [[ 76,  95, 151],
        [ 76,  95, 151],
        [ 76,  95, 151],
        ...,
        [ 70,  85, 144],
        [ 70,  85, 144],
        [ 70,  85, 144]],

       [[ 76,  95, 151],
        [ 76,  95, 151],
        [ 76,  95, 151],
        ...,
        [ 71,  86, 145],
        [ 71,  86, 145],
        [ 71,  86, 145]],

       ...,

       [[174, 159, 133],
        [168, 150, 128],
        [163, 143, 121],
        ...,
        [ 65,  78, 139],
        [ 66,  77, 139],
        [ 66,  77, 139]],

       [[177, 162, 139],
        [170, 154, 133],
        [152, 134, 112],
        ...,
        [ 65,  77, 139],
        [ 65,  76, 138],
        [ 66,  77, 139]],

       [[184, 169, 148],
        [175, 159, 139],
        [150, 132, 110],
        ...,
        [ 65,  77, 138],
        [ 65,  76, 138],
        [ 65,  76, 138]]], dtype=uint8)]"
Image_530.jpg,1614,533,846,543,4100,2660,2460,1076,846,daskShared_local/images/Image_530.jpg,530,"[array([[[183, 172, 160],
        [182, 172, 161],
        [183, 171, 158],
        ...,
        [136, 124, 110],
        [135, 127, 114],
        [139, 132, 119]],

       [[176, 162, 147],
        [180, 166, 151],
        [181, 168, 152],
        ...,
        [136, 124, 111],
        [134, 126, 114],
        [137, 129, 118]],

       [[184, 173, 158],
        [185, 172, 157],
        [185, 173, 159],
        ...,
        [138, 129, 114],
        [136, 130, 117],
        [137, 131, 119]],

       ...,

       [[ 78,  71,  64],
        [ 77,  68,  63],
        [ 72,  62,  58],
        ...,
        [213, 220, 231],
        [216, 221, 236],
        [211, 217, 232]],

       [[ 68,  60,  49],
        [ 71,  61,  53],
        [ 75,  65,  56],
        ...,
        [217, 227, 238],
        [216, 226, 240],
        [206, 213, 231]],

       [[ 71,  63,  53],
        [ 69,  62,  52],
        [ 68,  60,  50],
        ...,
        [220, 231, 243],
        [220, 233, 240],
        [220, 225, 237]]], dtype=uint8)]"
Image_531.jpg,340,124,188,194,770,422,528,318,194,daskShared_local/images/Image_531.jpg,531,"[array([[[241, 188,  60],
        [247, 193,  67],
        [247, 196,  77],
        ...,
        [ 34, 121, 214],
        [ 37, 122, 215],
        [ 35, 120, 213]],

       [[220, 176,  45],
        [222, 173,  42],
        [222, 171,  43],
        ...,
        [ 44, 133, 223],
        [ 45, 134, 226],
        [ 45, 132, 225]],

       [[195, 167,  81],
        [209, 169,  82],
        [227, 181,  94],
        ...,
        [ 49, 140, 229],
        [ 49, 140, 229],
        [ 46, 137, 228]],

       ...,

       [[ 62,  76,  41],
        [ 62,  73,  39],
        [ 60,  71,  37],
        ...,
        [  2,  15,  34],
        [  0,  13,  32],
        [  0,  12,  29]],

       [[ 66,  79,  36],
        [ 62,  75,  32],
        [ 57,  69,  29],
        ...,
        [  2,  10,  29],
        [  4,  12,  31],
        [  0,  10,  28]],

       [[ 72,  86,  33],
        [ 66,  80,  29],
        [ 59,  71,  23],
        ...,
        [  4,  11,  29],
        [  7,  16,  33],
        [  2,  14,  30]]], dtype=uint8)]"
Image_532.jpg,436,199,203,193,900,600,639,392,203,daskShared_local/images/Image_532.jpg,532,"[array([[[  5, 132, 235],
        [  5, 132, 237],
        [  4, 133, 237],
        ...,
        [  0,  89, 207],
        [  1,  90, 208],
        [  2,  91, 207]],

       [[  4, 131, 236],
        [  3, 132, 236],
        [  3, 132, 236],
        ...,
        [  0,  88, 206],
        [  0,  89, 207],
        [  2,  91, 209]],

       [[  3, 132, 236],
        [  3, 132, 236],
        [  1, 132, 238],
        ...,
        [  0,  88, 208],
        [  0,  89, 207],
        [  2,  91, 209]],

       ...,

       [[133, 129,  55],
        [102,  93,  19],
        [107,  93,  18],
        ...,
        [ 50,  88, 106],
        [ 26,  69, 109],
        [ 12,  60, 121]],

       [[194, 190, 121],
        [184, 177, 108],
        [158, 148,  78],
        ...,
        [ 52,  89, 114],
        [ 18,  61, 109],
        [  1,  50, 120]],

       [[198, 193, 138],
        [208, 201, 147],
        [169, 158, 103],
        ...,
        [ 25,  63,  95],
        [  5,  51, 107],
        [  9,  62, 139]]], dtype=uint8)]"
Image_533.jpg,103,108,141,127,500,375,244,235,141,daskShared_local/images/Image_533.jpg,533,"[array([[[ 87, 143, 150],
        [ 84, 144, 155],
        [ 83, 146, 162],
        ...,
        [ 34,  85, 115],
        [ 32,  83, 113],
        [ 31,  82, 112]],

       [[ 97, 159, 166],
        [ 97, 159, 170],
        [ 97, 160, 174],
        ...,
        [ 37,  89, 116],
        [ 36,  87, 114],
        [ 35,  86, 113]],

       [[103, 173, 183],
        [107, 174, 185],
        [111, 174, 186],
        ...,
        [ 43,  95, 119],
        [ 42,  94, 117],
        [ 40,  92, 116]],

       ...,

       [[ 28, 120, 144],
        [ 29, 122, 146],
        [ 31, 124, 148],
        ...,
        [208, 206, 203],
        [210, 211, 211],
        [213, 215, 216]],

       [[ 27, 119, 142],
        [ 30, 122, 145],
        [ 32, 124, 147],
        ...,
        [205, 204, 200],
        [207, 209, 209],
        [209, 212, 215]],

       [[ 26, 118, 141],
        [ 29, 121, 144],
        [ 32, 124, 147],
        ...,
        [205, 204, 201],
        [207, 209, 209],
        [209, 212, 214]]], dtype=uint8)]"
Image_534.jpg,335,278,240,217,750,740,575,495,240,daskShared_local/images/Image_534.jpg,534,"[array([[[ 37, 205, 222],
        [ 54, 214, 218],
        [ 62, 219, 224],
        ...,
        [ 13, 195, 216],
        [ 13, 194, 215],
        [ 13, 194, 215]],

       [[ 58, 227, 242],
        [ 77, 228, 234],
        [ 85, 232, 238],
        ...,
        [ 14, 195, 216],
        [ 13, 194, 215],
        [ 13, 194, 215]],

       [[ 71, 237, 251],
        [ 93, 234, 242],
        [102, 237, 246],
        ...,
        [ 14, 195, 216],
        [ 14, 194, 215],
        [ 14, 193, 215]],

       ...,

       [[111, 184, 172],
        [118, 182, 166],
        [118, 182, 167],
        ...,
        [127, 179, 170],
        [126, 181, 171],
        [124, 180, 170]],

       [[115, 186, 164],
        [119, 186, 169],
        [116, 182, 166],
        ...,
        [133, 185, 179],
        [135, 189, 183],
        [131, 188, 181]],

       [[121, 185, 156],
        [120, 185, 164],
        [119, 183, 165],
        ...,
        [137, 187, 185],
        [141, 192, 192],
        [139, 193, 193]]], dtype=uint8)]"
Image_535.jpg,626,447,218,193,1024,672,844,640,218,daskShared_local/images/Image_535.jpg,535,"[array([[[ 96, 103, 113],
        [103, 107, 116],
        [103, 105, 114],
        ...,
        [ 43,  54,  46],
        [ 46,  57,  44],
        [ 58,  67,  50]],

       [[ 95, 101, 111],
        [ 97, 101, 111],
        [ 91,  93, 102],
        ...,
        [ 39,  56,  47],
        [ 32,  47,  34],
        [ 34,  48,  30]],

       [[ 84,  88,  99],
        [ 81,  84,  95],
        [ 76,  77,  88],
        ...,
        [ 38,  58,  55],
        [ 30,  48,  41],
        [ 35,  52,  39]],

       ...,

       [[ 34,  91, 158],
        [ 34,  91, 157],
        [ 33,  91, 155],
        ...,
        [ 18, 119, 226],
        [ 18, 119, 227],
        [ 20, 119, 228]],

       [[ 35,  92, 159],
        [ 35,  93, 157],
        [ 34,  92, 155],
        ...,
        [ 17, 118, 224],
        [ 17, 118, 226],
        [ 21, 119, 228]],

       [[ 34,  92, 156],
        [ 33,  91, 154],
        [ 33,  92, 151],
        ...,
        [ 17, 118, 224],
        [ 20, 119, 226],
        [ 20, 118, 227]]], dtype=uint8)]"
Image_536.jpg,310,111,224,275,1000,667,534,386,275,daskShared_local/images/Image_536.jpg,536,"[array([[[186, 166, 143],
        [218, 204, 182],
        [228, 220, 217],
        ...,
        [170, 154, 138],
        [189, 173, 157],
        [204, 189, 172]],

       [[178, 181, 184],
        [125, 141, 149],
        [107, 120, 135],
        ...,
        [189, 173, 157],
        [209, 196, 179],
        [222, 211, 193]],

       [[ 40,  72, 104],
        [101, 127, 143],
        [207, 204, 204],
        ...,
        [208, 192, 176],
        [229, 216, 199],
        [238, 227, 209]],

       ...,

       [[ 24, 109, 164],
        [ 24, 109, 164],
        [ 20, 115, 169],
        ...,
        [ 43,  29,  16],
        [ 33,  20,  12],
        [ 33,  23,  14]],

       [[ 25, 111, 165],
        [ 25, 111, 165],
        [ 23, 114, 168],
        ...,
        [ 43,  28,  14],
        [ 30,  17,   8],
        [ 32,  20,  15]],

       [[ 24, 111, 164],
        [ 25, 113, 164],
        [ 28, 113, 167],
        ...,
        [ 50,  37,  23],
        [ 26,  15,   7],
        [ 24,  14,  12]]], dtype=uint8)]"
Image_537.jpg,395,7,83,64,530,180,478,71,83,daskShared_local/images/Image_537.jpg,537,"[array([[[  0,  10,  59],
        [  0,   9,  59],
        [  0,  11,  59],
        ...,
        [ 12,  29,  73],
        [  3,  21,  64],
        [  7,  24,  67]],

       [[  0,  10,  59],
        [  0,   9,  59],
        [  0,  11,  59],
        ...,
        [ 10,  28,  71],
        [  3,  21,  63],
        [  6,  24,  66]],

       [[  0,  10,  58],
        [  0,   9,  58],
        [  0,  11,  58],
        ...,
        [ 14,  30,  75],
        [  4,  20,  65],
        [  8,  24,  69]],

       ...,

       [[ 81,  91,  92],
        [ 83,  92,  93],
        [ 76,  89,  91],
        ...,
        [ 37,  26,  41],
        [ 40,  31,  46],
        [ 39,  29,  44]],

       [[132, 147, 127],
        [147, 161, 136],
        [109, 124, 113],
        ...,
        [ 29,  17,  34],
        [ 32,  23,  39],
        [ 31,  20,  37]],

       [[109, 122, 112],
        [119, 131, 117],
        [ 94, 108, 103],
        ...,
        [ 32,  21,  37],
        [ 36,  26,  42],
        [ 34,  24,  40]]], dtype=uint8)]"
Image_538.jpg,762,276,346,290,1200,906,1108,566,346,daskShared_local/images/Image_538.jpg,538,"[array([[[100,  95, 113],
        [116, 114, 136],
        [ 66,  66,  93],
        ...,
        [ 21,  56,  76],
        [ 17,  54,  73],
        [ 14,  52,  72]],

       [[237, 229, 244],
        [222, 217, 236],
        [ 47,  44,  66],
        ...,
        [ 19,  52,  73],
        [ 16,  51,  71],
        [ 15,  50,  71]],

       [[174, 164, 173],
        [219, 211, 224],
        [107, 101, 119],
        ...,
        [ 20,  51,  72],
        [ 20,  52,  73],
        [ 18,  52,  74]],

       ...,

       [[ 99, 150, 171],
        [ 95, 146, 165],
        [ 66, 114, 134],
        ...,
        [ 22,  60,  79],
        [ 17,  62,  81],
        [ 16,  58,  78]],

       [[114, 166, 186],
        [101, 149, 169],
        [ 82, 128, 147],
        ...,
        [ 18,  55,  75],
        [ 13,  56,  75],
        [ 14,  55,  75]],

       [[100, 146, 169],
        [110, 154, 181],
        [ 97, 141, 171],
        ...,
        [ 15,  53,  71],
        [ 21,  47,  74],
        [ 17,  48,  72]]], dtype=uint8)]"
Image_539.jpg,283,133,152,119,800,505,435,252,152,daskShared_local/images/Image_539.jpg,539,"[array([[[ 52,  68,  65],
        [ 50,  66,  61],
        [ 48,  67,  61],
        ...,
        [  4,  26,  39],
        [  5,  27,  40],
        [  6,  28,  41]],

       [[ 52,  68,  66],
        [ 49,  67,  63],
        [ 49,  71,  64],
        ...,
        [  4,  26,  39],
        [  5,  26,  40],
        [  6,  26,  40]],

       [[ 46,  64,  63],
        [ 46,  68,  64],
        [ 52,  77,  71],
        ...,
        [  3,  24,  37],
        [  4,  24,  37],
        [  4,  23,  37]],

       ...,

       [[ 70,  70,  33],
        [ 81,  81,  43],
        [ 99,  99,  62],
        ...,
        [195, 182, 151],
        [200, 184, 154],
        [191, 174, 144]],

       [[ 86,  85,  47],
        [ 91,  91,  52],
        [103, 103,  65],
        ...,
        [188, 177, 148],
        [193, 179, 150],
        [186, 170, 142]],

       [[ 96,  94,  55],
        [ 96,  96,  57],
        [104, 105,  65],
        ...,
        [183, 173, 145],
        [179, 166, 139],
        [177, 161, 134]]], dtype=uint8)]"
Image_54.jpg,122,155,375,285,1152,768,497,440,375,daskShared_local/images/Image_54.jpg,54,"[array([[[187, 236, 227],
        [191, 238, 229],
        [194, 239, 230],
        ...,
        [155, 227, 222],
        [150, 226, 221],
        [150, 225, 220]],

       [[184, 235, 228],
        [186, 237, 230],
        [189, 238, 232],
        ...,
        [149, 224, 219],
        [149, 224, 219],
        [149, 225, 219]],

       [[182, 233, 226],
        [184, 235, 228],
        [187, 236, 230],
        ...,
        [146, 223, 217],
        [147, 224, 218],
        [147, 224, 218]],

       ...,

       [[103, 182, 191],
        [102, 180, 190],
        [102, 177, 188],
        ...,
        [102, 139, 136],
        [ 97, 130, 120],
        [ 98, 123, 111]],

       [[101, 183, 191],
        [100, 182, 190],
        [100, 178, 188],
        ...,
        [ 98, 134, 131],
        [ 89, 124, 114],
        [ 90, 117, 104]],

       [[ 99, 182, 192],
        [ 97, 181, 191],
        [ 92, 179, 188],
        ...,
        [100, 135, 133],
        [ 97, 129, 120],
        [100, 125, 114]]], dtype=uint8)]"
Image_540.jpg,432,217,120,160,900,600,552,377,160,daskShared_local/images/Image_540.jpg,540,"[array([[[  5, 109, 164],
        [  6, 110, 165],
        [  5, 109, 164],
        ...,
        [  3, 117, 169],
        [  3, 117, 169],
        [  4, 118, 170]],

       [[  5, 109, 164],
        [  6, 110, 165],
        [  5, 109, 164],
        ...,
        [  3, 117, 169],
        [  3, 117, 169],
        [  3, 117, 169]],

       [[  5, 109, 164],
        [  6, 110, 165],
        [  5, 109, 164],
        ...,
        [  3, 117, 169],
        [  3, 117, 169],
        [  3, 117, 169]],

       ...,

       [[ 84,  86,  38],
        [ 74,  77,  30],
        [ 71,  74,  29],
        ...,
        [  3,  94, 141],
        [  3,  94, 141],
        [  3,  94, 141]],

       [[ 85,  87,  38],
        [ 76,  78,  31],
        [ 70,  73,  26],
        ...,
        [  4,  94, 142],
        [  4,  94, 142],
        [  4,  94, 142]],

       [[107, 109,  60],
        [ 90,  92,  45],
        [ 75,  78,  31],
        ...,
        [  7,  95, 143],
        [  7,  95, 143],
        [  7,  95, 143]]], dtype=uint8)]"
Image_541.jpg,768,161,231,187,1050,700,999,348,231,daskShared_local/images/Image_541.jpg,541,"[array([[[  1, 159, 149],
        [  9, 160, 150],
        [ 17, 162, 150],
        ...,
        [ 11,  61,  64],
        [ 13,  71,  73],
        [ 17,  85,  88]],

       [[  6, 161, 147],
        [  6, 149, 137],
        [  4, 137, 126],
        ...,
        [ 18,  79,  82],
        [ 19,  89,  91],
        [ 13,  92,  94]],

       [[ 13, 159, 144],
        [  8, 139, 126],
        [  4, 126, 115],
        ...,
        [ 27,  90,  95],
        [ 26,  96, 100],
        [ 17,  92,  94]],

       ...,

       [[ 33,  44,  48],
        [ 36,  47,  51],
        [ 38,  49,  53],
        ...,
        [ 52,  46,  51],
        [ 41,  39,  45],
        [ 32,  31,  39]],

       [[ 39,  48,  53],
        [ 37,  46,  51],
        [ 35,  45,  50],
        ...,
        [ 58,  60,  58],
        [ 50,  48,  51],
        [ 36,  40,  47]],

       [[ 42,  51,  56],
        [ 40,  49,  54],
        [ 39,  48,  53],
        ...,
        [ 82,  64,  72],
        [ 86,  73,  81],
        [ 80,  66,  80]]], dtype=uint8)]"
Image_542.jpg,351,102,311,285,1024,670,662,387,311,daskShared_local/images/Image_542.jpg,542,"[array([[[  4,  68, 120],
        [  2,  70, 119],
        [  0,  68, 117],
        ...,
        [  8,  20,  34],
        [  7,  19,  33],
        [  4,  16,  30]],

       [[  4,  64, 116],
        [  0,  66, 116],
        [  1,  68, 117],
        ...,
        [  7,  19,  33],
        [  5,  17,  31],
        [  5,  17,  31]],

       [[  3,  62, 114],
        [  0,  65, 115],
        [  4,  68, 119],
        ...,
        [  6,  18,  32],
        [  6,  18,  32],
        [  7,  19,  33]],

       ...,

       [[ 87, 150, 105],
        [ 25,  87,  44],
        [ 28,  85,  41],
        ...,
        [  7,  22,  26],
        [  7,  23,  26],
        [  5,  23,  26]],

       [[ 60, 119,  70],
        [ 19,  75,  38],
        [  7,  44,  20],
        ...,
        [  7,  19,  23],
        [  3,  17,  20],
        [  5,  20,  23]],

       [[ 31,  86,  34],
        [ 23,  71,  40],
        [ 21,  47,  35],
        ...,
        [  8,  18,  22],
        [  9,  21,  25],
        [ 10,  24,  27]]], dtype=uint8)]"
Image_543.jpg,269,329,150,112,900,599,419,441,150,daskShared_local/images/Image_543.jpg,543,"[array([[[ 68, 135, 213],
        [ 68, 135, 213],
        [ 68, 135, 213],
        ...,
        [105, 157, 176],
        [130, 177, 195],
        [150, 193, 209]],

       [[ 68, 135, 213],
        [ 68, 135, 213],
        [ 68, 135, 213],
        ...,
        [119, 166, 179],
        [144, 185, 197],
        [164, 201, 212]],

       [[ 67, 134, 212],
        [ 67, 134, 212],
        [ 67, 134, 212],
        ...,
        [151, 190, 195],
        [171, 206, 210],
        [187, 218, 221]],

       ...,

       [[ 46,  86, 165],
        [ 46,  86, 165],
        [ 46,  86, 165],
        ...,
        [ 48,  91, 169],
        [ 48,  91, 169],
        [ 48,  91, 169]],

       [[ 47,  86, 165],
        [ 47,  86, 165],
        [ 47,  86, 165],
        ...,
        [ 48,  91, 169],
        [ 48,  91, 169],
        [ 48,  91, 169]],

       [[ 46,  85, 164],
        [ 46,  85, 164],
        [ 46,  85, 164],
        ...,
        [ 47,  90, 168],
        [ 47,  90, 168],
        [ 47,  90, 168]]], dtype=uint8)]"
Image_544.jpg,283,166,264,229,1000,541,547,395,264,daskShared_local/images/Image_544.jpg,544,"[array([[[ 41, 126, 164],
        [ 55, 120, 159],
        [ 64, 114, 154],
        ...,
        [ 38,  71,  87],
        [ 42,  77,  94],
        [ 45,  83, 101]],

       [[ 42, 127, 164],
        [ 57, 119, 157],
        [ 63, 112, 150],
        ...,
        [ 37,  72,  90],
        [ 43,  74,  94],
        [ 43,  80,  99]],

       [[ 40, 130, 165],
        [ 51, 122, 156],
        [ 57, 113, 148],
        ...,
        [ 32,  75,  95],
        [ 38,  78,  95],
        [ 38,  81, 100]],

       ...,

       [[  0,  50,  66],
        [  1,  45,  61],
        [  0,  41,  55],
        ...,
        [121, 146, 170],
        [114, 144, 173],
        [102, 131, 157]],

       [[  0,  50,  67],
        [  0,  45,  61],
        [  0,  44,  59],
        ...,
        [ 94, 124, 144],
        [ 82, 120, 141],
        [ 74, 110, 129]],

       [[  0,  47,  64],
        [  1,  47,  63],
        [  0,  46,  61],
        ...,
        [ 78, 110, 128],
        [ 81, 111, 132],
        [ 84, 112, 133]]], dtype=uint8)]"
Image_545.jpg,394,185,154,129,770,578,548,314,154,daskShared_local/images/Image_545.jpg,545,"[array([[[ 60,  67,  73],
        [ 60,  68,  72],
        [ 62,  70,  72],
        ...,
        [ 81,  79,  73],
        [ 80,  79,  75],
        [ 79,  78,  76]],

       [[ 60,  67,  74],
        [ 61,  69,  73],
        [ 63,  72,  73],
        ...,
        [ 87,  86,  81],
        [ 86,  85,  82],
        [ 85,  83,  83]],

       [[ 60,  67,  75],
        [ 62,  69,  75],
        [ 65,  73,  76],
        ...,
        [ 96,  94,  90],
        [ 94,  93,  91],
        [ 93,  91,  91]],

       ...,

       [[100, 104, 105],
        [ 97, 101, 102],
        [101, 105, 106],
        ...,
        [ 68,  68,  61],
        [ 58,  59,  52],
        [ 43,  43,  36]],

       [[ 98, 102, 103],
        [100, 104, 105],
        [102, 106, 107],
        ...,
        [134, 134, 124],
        [ 92,  92,  83],
        [ 61,  61,  52]],

       [[ 98, 102, 103],
        [101, 105, 106],
        [100, 104, 105],
        ...,
        [183, 183, 171],
        [114, 113, 103],
        [ 74,  72,  62]]], dtype=uint8)]"
Image_546.jpg,297,355,180,158,1024,683,477,513,180,daskShared_local/images/Image_546.jpg,546,"[array([[[134, 144, 135],
        [147, 158, 153],
        [162, 173, 174],
        ...,
        [ 45,  53,  58],
        [ 43,  50,  57],
        [ 48,  53,  59]],

       [[142, 148, 137],
        [142, 149, 144],
        [149, 159, 159],
        ...,
        [ 48,  54,  57],
        [ 45,  50,  54],
        [ 45,  50,  54]],

       [[161, 164, 151],
        [151, 155, 146],
        [147, 152, 148],
        ...,
        [ 43,  46,  45],
        [ 39,  43,  45],
        [ 39,  44,  47]],

       ...,

       [[  0, 108, 131],
        [  0, 108, 131],
        [  0, 109, 132],
        ...,
        [  0, 113, 139],
        [  0, 113, 139],
        [  0, 113, 139]],

       [[  0, 109, 132],
        [  0, 109, 132],
        [  0, 109, 132],
        ...,
        [  0, 113, 139],
        [  0, 113, 139],
        [  0, 113, 139]],

       [[  0, 109, 132],
        [  0, 109, 132],
        [  0, 109, 132],
        ...,
        [  0, 113, 139],
        [  0, 113, 139],
        [  0, 113, 139]]], dtype=uint8)]"
Image_547.jpg,180,197,501,316,1599,1065,681,513,501,daskShared_local/images/Image_547.jpg,547,"[array([[[  4,   0,   1],
        [  4,   0,   1],
        [  4,   0,   1],
        ...,
        [  4,   0,   1],
        [  4,   0,   1],
        [  4,   0,   1]],

       [[  4,   0,   1],
        [  4,   0,   1],
        [  4,   0,   1],
        ...,
        [  4,   0,   1],
        [  4,   0,   1],
        [  4,   0,   1]],

       [[  4,   0,   1],
        [  4,   0,   1],
        [  4,   0,   1],
        ...,
        [  4,   0,   1],
        [  4,   0,   1],
        [  4,   0,   1]],

       ...,

       [[  4,   0,   1],
        [  4,   0,   1],
        [  4,   0,   1],
        ...,
        [163, 198, 199],
        [155, 210, 189],
        [157, 205, 179]],

       [[  4,   0,   1],
        [  4,   0,   1],
        [  4,   0,   1],
        ...,
        [128, 164, 157],
        [152, 200, 182],
        [161, 202, 183]],

       [[  4,   0,   1],
        [  4,   0,   1],
        [  4,   0,   1],
        ...,
        [154, 192, 167],
        [135, 173, 152],
        [137, 177, 160]]], dtype=uint8)]"
Image_548.JPG,289,448,1528,1472,2560,1920,1817,1920,1528,daskShared_local/images/Image_548.JPG,548,"[array([[[ 83,  66,  32],
        [ 99,  87,  47],
        [107,  96,  47],
        ...,
        [205, 196, 172],
        [206, 190, 173],
        [167, 154, 137]],

       [[ 79,  68,  28],
        [ 87,  71,  34],
        [ 87,  77,  29],
        ...,
        [193, 180, 150],
        [197, 180, 152],
        [176, 159, 135]],

       [[ 87,  70,  26],
        [ 94,  72,  27],
        [ 86,  75,  28],
        ...,
        [160, 152, 119],
        [168, 157, 122],
        [159, 146, 111]],

       ...,

       [[ 74,  88,  25],
        [ 74,  88,  24],
        [ 75,  87,  20],
        ...,
        [ 89, 101,  26],
        [ 92, 101,  33],
        [ 94, 100,  29]],

       [[ 75,  87,  35],
        [ 73,  85,  35],
        [ 76,  85,  21],
        ...,
        [ 91,  99,  29],
        [ 91, 100,  31],
        [ 89, 100,  29]],

       [[ 75,  88,  26],
        [ 71,  84,  21],
        [ 71,  85,  21],
        ...,
        [ 91,  99,  28],
        [ 89,  98,  36],
        [ 88, 101,  25]]], dtype=uint8)]"
Image_549.jpg,293,411,176,191,1024,768,469,602,191,daskShared_local/images/Image_549.jpg,549,"[array([[[123,  96,  94],
        [133, 116, 106],
        [ 91,  68,  56],
        ...,
        [ 89,  68,  45],
        [ 62,  45,  29],
        [ 54,  40,  27]],

       [[118, 103, 100],
        [ 69,  59,  50],
        [ 92,  81,  64],
        ...,
        [ 96,  73,  48],
        [ 61,  43,  26],
        [ 49,  34,  21]],

       [[111, 106, 103],
        [146, 142, 137],
        [126, 122, 111],
        ...,
        [ 92,  67,  42],
        [ 69,  48,  27],
        [ 52,  36,  21]],

       ...,

       [[232, 204, 167],
        [238, 206, 171],
        [230, 198, 172],
        ...,
        [194, 168, 135],
        [203, 176, 145],
        [214, 188, 157]],

       [[229, 207, 170],
        [243, 218, 178],
        [227, 198, 168],
        ...,
        [190, 164, 127],
        [200, 174, 138],
        [182, 156, 122]],

       [[223, 203, 166],
        [231, 210, 165],
        [235, 212, 175],
        ...,
        [195, 166, 126],
        [196, 167, 127],
        [190, 160, 122]]], dtype=uint8)]"
Image_55.jpg,1076,164,2489,2543,4608,3072,3565,2707,2543,daskShared_local/images/Image_55.jpg,55,"[array([[[ 29,  30,  27],
        [ 35,  36,  35],
        [ 54,  55,  55],
        ...,
        [118, 123, 116],
        [125, 130, 122],
        [136, 139, 125]],

       [[ 42,  43,  44],
        [ 67,  68,  70],
        [ 94,  95,  93],
        ...,
        [115, 119, 112],
        [114, 120, 114],
        [122, 128, 118]],

       [[ 81,  83,  87],
        [106, 107, 106],
        [122, 120, 115],
        ...,
        [120, 123, 115],
        [110, 115, 109],
        [112, 118, 112]],

       ...,

       [[110,  94,  65],
        [109,  94,  67],
        [109,  94,  65],
        ...,
        [166, 154, 116],
        [153, 138,  95],
        [145, 129,  88]],

       [[107,  90,  63],
        [107,  91,  65],
        [106,  90,  65],
        ...,
        [156, 141, 106],
        [140, 126,  91],
        [137, 125,  93]],

       [[104,  87,  63],
        [103,  87,  63],
        [104,  87,  65],
        ...,
        [161, 136,  84],
        [134, 113,  75],
        [121, 109,  81]]], dtype=uint8)]"
Image_550.jpg,541,206,302,268,986,653,843,474,302,daskShared_local/images/Image_550.jpg,550,"[array([[[ 68,  76,  53],
        [ 80,  88,  65],
        [ 65,  74,  57],
        ...,
        [ 61, 119,  97],
        [ 60, 118,  96],
        [ 61, 119,  97]],

       [[ 67,  75,  52],
        [ 78,  86,  63],
        [ 85,  94,  77],
        ...,
        [ 60, 118,  96],
        [ 60, 118,  96],
        [ 61, 119,  97]],

       [[ 91,  89,  72],
        [ 91,  90,  77],
        [ 91,  98,  54],
        ...,
        [ 60, 117,  98],
        [ 60, 117,  98],
        [ 60, 117,  98]],

       ...,

       [[ 96, 110,  59],
        [ 92, 106,  55],
        [ 90, 105,  58],
        ...,
        [ 53,  79,  43],
        [ 52,  78,  43],
        [ 53,  78,  44]],

       [[ 85,  99,  47],
        [ 78,  93,  39],
        [ 72,  89,  37],
        ...,
        [ 54,  80,  42],
        [ 56,  82,  45],
        [ 55,  81,  46]],

       [[ 72,  86,  32],
        [ 68,  83,  27],
        [ 66,  84,  23],
        ...,
        [ 53,  79,  40],
        [ 55,  81,  44],
        [ 54,  80,  44]]], dtype=uint8)]"
Image_551.jpg,658,240,378,305,2121,1063,1036,545,378,daskShared_local/images/Image_551.jpg,551,"[array([[[164, 176, 176],
        [172, 183, 184],
        [175, 186, 188],
        ...,
        [172, 194, 208],
        [175, 196, 213],
        [178, 199, 216]],

       [[163, 175, 175],
        [163, 175, 175],
        [165, 177, 177],
        ...,
        [167, 189, 203],
        [170, 191, 208],
        [172, 193, 211]],

       [[151, 171, 173],
        [151, 166, 167],
        [157, 168, 169],
        ...,
        [162, 181, 199],
        [162, 180, 198],
        [166, 183, 200]],

       ...,

       [[ 55, 106, 125],
        [ 55, 106, 125],
        [ 55, 106, 125],
        ...,
        [157, 157, 145],
        [146, 147, 133],
        [156, 156, 140]],

       [[ 55, 106, 125],
        [ 55, 106, 125],
        [ 54, 105, 124],
        ...,
        [159, 158, 144],
        [156, 156, 142],
        [163, 162, 146]],

       [[ 54, 105, 124],
        [ 55, 106, 125],
        [ 56, 107, 126],
        ...,
        [154, 151, 139],
        [154, 151, 137],
        [146, 143, 127]]], dtype=uint8)]"
Image_552.jpg,1838,412,362,263,3840,2160,2200,675,362,daskShared_local/images/Image_552.jpg,552,"[array([[[ 73, 155, 177],
        [ 70, 154, 178],
        [ 73, 157, 181],
        ...,
        [ 51, 127, 159],
        [ 49, 127, 161],
        [ 41, 121, 156]],

       [[ 74, 159, 180],
        [ 73, 157, 181],
        [ 70, 154, 178],
        ...,
        [ 49, 126, 157],
        [ 67, 148, 178],
        [ 82, 165, 195]],

       [[ 75, 160, 182],
        [ 76, 160, 184],
        [ 70, 154, 178],
        ...,
        [ 88, 167, 198],
        [ 83, 166, 195],
        [ 67, 153, 181]],

       ...,

       [[ 27,  93, 111],
        [ 25,  93, 112],
        [ 22,  90, 109],
        ...,
        [112, 109,  66],
        [116, 115,  71],
        [118, 118,  76]],

       [[ 29,  97, 114],
        [ 25,  93, 112],
        [ 22,  90, 109],
        ...,
        [116, 113,  70],
        [115, 113,  71],
        [113, 113,  72]],

       [[ 28,  99, 114],
        [ 30,  99, 118],
        [ 27,  95, 114],
        ...,
        [120, 117,  75],
        [117, 114,  74],
        [105, 103,  63]]], dtype=uint8)]"
Image_553.jpg,63,141,118,102,525,340,181,243,118,daskShared_local/images/Image_553.jpg,553,"[array([[[ 32,  84, 106],
        [ 30,  82, 104],
        [ 25,  77,  98],
        ...,
        [153, 178, 149],
        [115, 141, 115],
        [103, 130, 103]],

       [[ 33,  85, 106],
        [ 31,  83, 105],
        [ 25,  77,  99],
        ...,
        [144, 168, 139],
        [106, 132, 105],
        [ 94, 121,  94]],

       [[ 33,  85, 107],
        [ 32,  84, 106],
        [ 27,  79, 101],
        ...,
        [115, 138, 109],
        [ 80, 105,  77],
        [ 68,  94,  66]],

       ...,

       [[  8,  26,   9],
        [ 15,  31,  17],
        [ 36,  47,  41],
        ...,
        [  1,   9,   1],
        [ 48,  66,  50],
        [ 64,  84,  66]],

       [[ 35,  46,  32],
        [ 41,  50,  38],
        [ 58,  63,  58],
        ...,
        [ 12,  27,  12],
        [ 43,  62,  45],
        [ 54,  74,  56]],

       [[ 44,  53,  39],
        [ 49,  57,  45],
        [ 65,  68,  63],
        ...,
        [ 16,  32,  16],
        [ 42,  61,  43],
        [ 50,  71,  52]]], dtype=uint8)]"
Image_554.jpg,565,179,92,84,1000,700,657,263,92,daskShared_local/images/Image_554.jpg,554,"[array([[[  2, 158, 229],
        [  2, 158, 230],
        [  2, 158, 229],
        ...,
        [  0, 157, 226],
        [  0, 157, 226],
        [  0, 157, 226]],

       [[  2, 158, 230],
        [  2, 158, 230],
        [  2, 158, 229],
        ...,
        [  0, 156, 226],
        [  0, 157, 225],
        [  0, 157, 225]],

       [[  2, 157, 229],
        [  2, 157, 229],
        [  2, 157, 229],
        ...,
        [  0, 158, 227],
        [  0, 158, 227],
        [  0, 158, 227]],

       ...,

       [[ 16,  79,  99],
        [ 17,  79,  99],
        [ 16,  79,  99],
        ...,
        [  0, 152, 222],
        [  0, 151, 223],
        [  0, 151, 223]],

       [[ 12,  77,  98],
        [ 12,  77,  98],
        [ 12,  77,  98],
        ...,
        [  0, 152, 222],
        [  0, 151, 222],
        [  0, 151, 222]],

       [[ 12,  78,  98],
        [ 12,  78,  98],
        [ 12,  78,  98],
        ...,
        [  0, 152, 222],
        [  0, 151, 222],
        [  0, 151, 222]]], dtype=uint8)]"
Image_555.jpg,394,41,1082,974,1920,1080,1476,1015,1082,daskShared_local/images/Image_555.jpg,555,"[array([[[  0, 124, 156],
        [  0, 124, 156],
        [  0, 123, 156],
        ...,
        [ 51, 104,  84],
        [ 44, 101,  91],
        [ 25,  76,  71]],

       [[  0, 125, 156],
        [  0, 125, 156],
        [  0, 124, 156],
        ...,
        [ 52, 120,  97],
        [ 33, 116, 104],
        [  5,  77,  80]],

       [[  0, 125, 156],
        [  0, 125, 157],
        [  0, 125, 157],
        ...,
        [ 25, 118, 109],
        [ 14, 115, 114],
        [  1,  86,  93]],

       ...,

       [[ 91,  83,  45],
        [100,  92,  55],
        [114, 105,  69],
        ...,
        [ 14,  23,  22],
        [ 15,  24,  24],
        [ 15,  21,  24]],

       [[ 97,  91,  53],
        [107, 101,  64],
        [103,  95,  58],
        ...,
        [ 14,  21,  21],
        [ 15,  21,  21],
        [ 16,  20,  21]],

       [[ 92,  91,  52],
        [ 88,  83,  48],
        [102,  93,  54],
        ...,
        [ 16,  21,  20],
        [ 18,  22,  18],
        [ 25,  26,  20]]], dtype=uint8)]"
Image_556.jpg,297,91,173,161,732,420,470,252,173,daskShared_local/images/Image_556.jpg,556,"[array([[[  0, 166, 216],
        [  1, 167, 217],
        [  1, 167, 217],
        ...,
        [ 28, 186, 221],
        [  4, 178, 210],
        [  0, 181, 211]],

       [[  1, 167, 217],
        [  1, 167, 217],
        [  1, 167, 217],
        ...,
        [ 49, 193, 230],
        [ 18, 181, 215],
        [  1, 179, 211]],

       [[  1, 167, 217],
        [  1, 167, 217],
        [  1, 167, 217],
        ...,
        [ 65, 199, 238],
        [ 33, 186, 223],
        [ 10, 179, 214]],

       ...,

       [[191, 202, 191],
        [191, 203, 192],
        [192, 203, 191],
        ...,
        [ 44,  69,  53],
        [ 76,  96,  76],
        [ 78,  93,  70]],

       [[202, 212, 207],
        [202, 210, 207],
        [205, 213, 207],
        ...,
        [ 75, 100,  66],
        [ 85, 107,  67],
        [ 71,  86,  44]],

       [[180, 184, 159],
        [185, 186, 165],
        [186, 186, 161],
        ...,
        [104, 120,  80],
        [101, 113,  70],
        [ 74,  80,  39]]], dtype=uint8)]"
Image_557.jpg,442,374,209,207,1024,683,651,581,209,daskShared_local/images/Image_557.jpg,557,"[array([[[ 73,  64,  56],
        [ 66,  48,  27],
        [ 92,  65,  32],
        ...,
        [ 74,  62,  60],
        [ 80,  69,  67],
        [ 74,  63,  61]],

       [[ 72,  62,  51],
        [ 70,  47,  21],
        [162, 133,  88],
        ...,
        [ 72,  62,  60],
        [ 80,  70,  68],
        [ 70,  59,  57]],

       [[ 49,  35,  22],
        [ 84,  62,  30],
        [162, 134,  88],
        ...,
        [ 59,  48,  47],
        [ 72,  61,  59],
        [ 67,  55,  53]],

       ...,

       [[105, 125,  83],
        [135, 157,  84],
        [144, 151,  74],
        ...,
        [212, 179, 125],
        [203, 174, 119],
        [217, 189, 141]],

       [[108, 116,  84],
        [ 87,  97,  33],
        [128, 123,  51],
        ...,
        [236, 201, 158],
        [248, 218, 178],
        [251, 236, 202]],

       [[146, 128,  87],
        [113, 105,  36],
        [207, 195, 129],
        ...,
        [245, 215, 182],
        [244, 216, 187],
        [249, 223, 196]]], dtype=uint8)]"
Image_558.jpg,561,95,276,285,1024,770,837,380,285,daskShared_local/images/Image_558.jpg,558,"[array([[[  2, 111, 184],
        [  2, 110, 184],
        [  2, 113, 185],
        ...,
        [ 40,  60,  70],
        [ 41,  61,  73],
        [ 69,  91, 104]],

       [[  3, 113, 188],
        [  1, 111, 186],
        [  4, 114, 189],
        ...,
        [ 46,  71,  76],
        [ 49,  77,  84],
        [ 67,  97, 107]],

       [[  3, 113, 188],
        [  1, 111, 186],
        [  3, 113, 188],
        ...,
        [ 51,  73,  80],
        [ 64,  90,  97],
        [ 59,  87,  97]],

       ...,

       [[102, 116,  99],
        [165, 175, 158],
        [130, 154, 128],
        ...,
        [ 33,  31,  34],
        [ 35,  33,  36],
        [ 36,  34,  37]],

       [[ 61,  73,  56],
        [147, 155, 138],
        [167, 182, 159],
        ...,
        [ 36,  34,  36],
        [ 39,  37,  39],
        [ 42,  40,  43]],

       [[ 52,  64,  47],
        [119, 129, 112],
        [155, 162, 141],
        ...,
        [ 40,  38,  39],
        [ 42,  40,  41],
        [ 42,  40,  41]]], dtype=uint8)]"
Image_559.jpg,2235,265,608,515,3033,1757,2843,780,608,daskShared_local/images/Image_559.jpg,559,"[array([[[  0,  53, 217],
        [  0,  53, 217],
        [  0,  53, 217],
        ...,
        [  0,  53, 217],
        [  0,  53, 217],
        [  0,  53, 217]],

       [[  0,  53, 217],
        [  0,  53, 217],
        [  0,  53, 217],
        ...,
        [  0,  53, 217],
        [  0,  53, 217],
        [  0,  53, 217]],

       [[  0,  53, 217],
        [  0,  53, 217],
        [  0,  53, 217],
        ...,
        [  0,  53, 217],
        [  0,  53, 217],
        [  0,  53, 217]],

       ...,

       [[ 69,  75,  41],
        [ 67,  72,  42],
        [ 67,  74,  42],
        ...,
        [  0,  53, 217],
        [  0,  53, 217],
        [  0,  53, 217]],

       [[ 75,  82,  42],
        [ 66,  72,  37],
        [ 62,  69,  36],
        ...,
        [  0,  53, 217],
        [  0,  53, 217],
        [  0,  53, 217]],

       [[ 86,  93,  51],
        [ 73,  80,  42],
        [ 65,  72,  39],
        ...,
        [  0,  53, 217],
        [  0,  53, 217],
        [  0,  53, 217]]], dtype=uint8)]"
Image_56.jpg,611,222,144,107,1000,667,755,329,144,daskShared_local/images/Image_56.jpg,56,"[array([[[ 24, 149, 168],
        [ 26, 146, 164],
        [ 27, 138, 155],
        ...,
        [ 12,  90, 100],
        [ 12,  89,  99],
        [ 11,  88,  98]],

       [[ 26, 151, 171],
        [ 29, 149, 169],
        [ 32, 145, 163],
        ...,
        [ 23, 103, 113],
        [ 24, 104, 114],
        [ 25, 104, 114]],

       [[ 24, 148, 170],
        [ 29, 149, 171],
        [ 36, 149, 169],
        ...,
        [ 36, 118, 129],
        [ 41, 121, 133],
        [ 44, 123, 134]],

       ...,

       [[166, 182, 158],
        [167, 183, 158],
        [158, 172, 148],
        ...,
        [ 71, 147, 146],
        [ 71, 143, 143],
        [ 72, 142, 143]],

       [[152, 173, 149],
        [159, 179, 156],
        [162, 181, 158],
        ...,
        [ 66, 139, 138],
        [ 65, 135, 135],
        [ 66, 133, 133]],

       [[145, 168, 146],
        [150, 172, 149],
        [157, 178, 155],
        ...,
        [ 64, 135, 133],
        [ 62, 131, 129],
        [ 62, 128, 127]]], dtype=uint8)]"
Image_560.jpg,517,372,183,163,1024,678,700,535,183,daskShared_local/images/Image_560.jpg,560,"[array([[[112, 101, 106],
        [122, 107, 110],
        [159, 140, 139],
        ...,
        [150, 125,  92],
        [158, 122,  84],
        [173, 126,  80]],

       [[185, 181, 166],
        [161, 148, 138],
        [138, 119, 112],
        ...,
        [146, 113,  78],
        [161, 123,  85],
        [189, 149, 107]],

       [[135, 127, 128],
        [138, 123, 128],
        [117, 100, 105],
        ...,
        [175, 139, 109],
        [185, 146, 109],
        [189, 153, 112]],

       ...,

       [[243, 224, 180],
        [239, 219, 174],
        [238, 225, 187],
        ...,
        [239, 211, 162],
        [234, 207, 162],
        [233, 210, 167]],

       [[250, 228, 182],
        [248, 222, 172],
        [237, 217, 171],
        ...,
        [247, 222, 171],
        [240, 213, 164],
        [227, 205, 158]],

       [[248, 228, 188],
        [244, 218, 175],
        [230, 205, 164],
        ...,
        [253, 236, 186],
        [250, 232, 184],
        [234, 216, 170]]], dtype=uint8)]"
Image_561.jpg,469,121,113,82,685,360,582,203,113,daskShared_local/images/Image_561.jpg,561,"[array([[[  0, 107, 150],
        [  0, 107, 150],
        [  0, 107, 150],
        ...,
        [  0, 101, 145],
        [  0, 101, 145],
        [  0, 101, 145]],

       [[  0, 107, 150],
        [  0, 107, 150],
        [  0, 107, 150],
        ...,
        [  0, 101, 145],
        [  0, 101, 145],
        [  0, 101, 145]],

       [[  0, 107, 151],
        [  0, 107, 151],
        [  0, 106, 150],
        ...,
        [  0, 101, 145],
        [  0, 101, 145],
        [  0, 101, 145]],

       ...,

       [[  1,  85, 121],
        [  1,  85, 121],
        [  1,  85, 121],
        ...,
        [  0,  82, 114],
        [  0,  82, 114],
        [  0,  82, 114]],

       [[  1,  85, 121],
        [  1,  85, 121],
        [  1,  85, 121],
        ...,
        [  0,  82, 114],
        [  0,  82, 114],
        [  0,  82, 114]],

       [[  1,  85, 121],
        [  1,  85, 121],
        [  1,  85, 121],
        ...,
        [  0,  82, 114],
        [  0,  82, 114],
        [  0,  82, 114]]], dtype=uint8)]"
Image_562.jpg,329,261,134,141,1000,667,463,402,141,daskShared_local/images/Image_562.jpg,562,"[array([[[  3, 208, 225],
        [  4, 208, 226],
        [  6, 209, 226],
        ...,
        [ 38, 214, 235],
        [ 44, 214, 235],
        [ 52, 213, 235]],

       [[  5, 209, 225],
        [ 11, 209, 226],
        [ 18, 210, 227],
        ...,
        [ 30, 214, 235],
        [ 39, 213, 235],
        [ 51, 214, 235]],

       [[  8, 210, 226],
        [ 16, 210, 226],
        [ 24, 211, 227],
        ...,
        [ 27, 213, 235],
        [ 37, 213, 235],
        [ 50, 214, 235]],

       ...,

       [[179, 117,  13],
        [171, 105,   7],
        [148,  84,   1],
        ...,
        [137, 100,  71],
        [154, 123,  76],
        [159, 136,  76]],

       [[175, 112,  18],
        [176, 109,  14],
        [166, 100,   8],
        ...,
        [145, 111,  49],
        [155, 128,  59],
        [162, 140,  68]],

       [[170, 104,  19],
        [177, 110,  19],
        [175, 110,  14],
        ...,
        [141, 113,  28],
        [152, 128,  46],
        [164, 142,  67]]], dtype=uint8)]"
Image_563.jpg,576,51,172,173,930,500,748,224,173,daskShared_local/images/Image_563.jpg,563,"[array([[[ 11, 149, 211],
        [ 11, 149, 211],
        [ 10, 148, 210],
        ...,
        [ 10, 146, 204],
        [ 10, 146, 204],
        [ 10, 146, 204]],

       [[  9, 147, 209],
        [ 10, 148, 211],
        [ 11, 149, 211],
        ...,
        [ 11, 147, 205],
        [ 11, 147, 205],
        [ 10, 146, 204]],

       [[  7, 145, 208],
        [  9, 147, 210],
        [ 10, 148, 211],
        ...,
        [ 11, 147, 205],
        [ 11, 147, 205],
        [ 10, 146, 204]],

       ...,

       [[245, 245, 243],
        [238, 238, 236],
        [224, 224, 222],
        ...,
        [  6, 134, 199],
        [  6, 134, 199],
        [  6, 134, 199]],

       [[237, 237, 235],
        [223, 223, 221],
        [192, 192, 190],
        ...,
        [  6, 134, 199],
        [  6, 134, 199],
        [  7, 135, 200]],

       [[231, 231, 229],
        [216, 216, 214],
        [182, 182, 180],
        ...,
        [  6, 134, 199],
        [  7, 135, 200],
        [  7, 135, 200]]], dtype=uint8)]"
Image_564.jpg,1275,642,350,249,2106,1578,1625,891,350,daskShared_local/images/Image_564.jpg,564,"[array([[[ 30, 145, 146],
        [ 29, 147, 149],
        [ 24, 146, 144],
        ...,
        [ 20, 143, 142],
        [ 21, 140, 139],
        [ 18, 143, 142]],

       [[ 24, 147, 145],
        [ 23, 146, 144],
        [ 23, 146, 144],
        ...,
        [ 11, 145, 150],
        [ 10, 140, 151],
        [ 14, 143, 145]],

       [[ 25, 148, 146],
        [ 26, 146, 145],
        [ 25, 148, 145],
        ...,
        [ 18, 142, 148],
        [ 14, 138, 143],
        [ 14, 141, 141]],

       ...,

       [[ 33, 156, 155],
        [ 37, 159, 160],
        [ 37, 157, 159],
        ...,
        [ 24, 161, 156],
        [ 25, 162, 158],
        [ 27, 159, 155]],

       [[ 39, 161, 153],
        [ 36, 160, 154],
        [ 34, 159, 152],
        ...,
        [ 31, 160, 155],
        [ 31, 160, 154],
        [ 34, 155, 155]],

       [[ 34, 160, 156],
        [ 32, 159, 155],
        [ 32, 160, 155],
        ...,
        [ 31, 158, 155],
        [ 30, 158, 153],
        [ 27, 158, 153]]], dtype=uint8)]"
Image_565.jpg,950,264,219,158,1600,1280,1169,422,219,daskShared_local/images/Image_565.jpg,565,"[array([[[ 29, 112, 102],
        [ 32, 112, 103],
        [ 27, 103,  93],
        ...,
        [ 52, 163, 122],
        [ 51, 161, 119],
        [ 34, 162, 141]],

       [[ 30, 111, 106],
        [ 29, 107, 102],
        [ 29, 103,  99],
        ...,
        [ 39, 153, 114],
        [ 40, 153, 114],
        [ 25, 155, 136]],

       [[ 28, 107, 108],
        [ 22,  97,  99],
        [ 24,  96,  96],
        ...,
        [ 33, 152, 118],
        [ 34, 153, 120],
        [ 21, 151, 135]],

       ...,

       [[128,  73,  86],
        [ 80,  19,  34],
        [ 91,  27,  34],
        ...,
        [ 47, 167, 119],
        [ 50, 173, 121],
        [ 35, 180, 119]],

       [[120,  85, 107],
        [ 81,  33,  61],
        [ 94,  37,  58],
        ...,
        [ 56, 174, 118],
        [ 49, 172, 111],
        [ 45, 184, 121]],

       [[ 96,  80, 111],
        [ 54,  19,  67],
        [ 89,  39,  85],
        ...,
        [ 53, 166, 104],
        [ 54, 174, 104],
        [ 44, 176, 111]]], dtype=uint8)]"
Image_566.jpg,385,178,454,421,1280,854,839,599,454,daskShared_local/images/Image_566.jpg,566,"[array([[[113, 140, 169],
        [118, 144, 173],
        [119, 144, 173],
        ...,
        [ 95, 183, 211],
        [ 89, 185, 215],
        [ 80, 190, 221]],

       [[114, 139, 166],
        [117, 142, 169],
        [118, 142, 170],
        ...,
        [100, 179, 209],
        [ 97, 183, 214],
        [ 88, 186, 218]],

       [[108, 130, 156],
        [112, 134, 160],
        [118, 140, 167],
        ...,
        [105, 176, 207],
        [104, 180, 212],
        [ 97, 182, 215]],

       ...,

       [[ 14, 150, 189],
        [ 15, 151, 191],
        [ 16, 148, 191],
        ...,
        [  8, 189, 234],
        [  8, 189, 234],
        [  8, 189, 234]],

       [[ 20, 150, 190],
        [ 19, 150, 192],
        [ 20, 150, 194],
        ...,
        [  9, 190, 235],
        [  9, 190, 235],
        [  9, 190, 235]],

       [[ 27, 152, 193],
        [ 24, 151, 194],
        [ 25, 153, 199],
        ...,
        [ 13, 194, 239],
        [ 13, 194, 239],
        [ 13, 194, 239]]], dtype=uint8)]"
Image_567.jpg,62,121,186,173,600,350,248,294,186,daskShared_local/images/Image_567.jpg,567,"[array([[[ 23,  52,  32],
        [ 23,  52,  30],
        [ 24,  51,  35],
        ...,
        [ 50,  39,  47],
        [ 63,  52,  58],
        [ 61,  51,  57]],

       [[ 24,  52,  30],
        [ 23,  52,  30],
        [ 24,  51,  35],
        ...,
        [ 49,  43,  52],
        [ 61,  58,  64],
        [ 68,  67,  69]],

       [[ 23,  51,  29],
        [ 23,  51,  29],
        [ 24,  51,  35],
        ...,
        [ 54,  52,  62],
        [ 63,  65,  70],
        [ 75,  79,  80]],

       ...,

       [[141, 129, 103],
        [143, 128, 104],
        [155, 153, 124],
        ...,
        [119,  72,  49],
        [129,  92,  66],
        [123,  95,  67]],

       [[144, 133, 111],
        [145, 134, 113],
        [151, 144, 121],
        ...,
        [130,  80,  57],
        [124,  82,  57],
        [115,  83,  60]],

       [[149, 138, 120],
        [138, 130, 111],
        [148, 138, 119],
        ...,
        [135,  98,  72],
        [129,  95,  68],
        [128,  99,  75]]], dtype=uint8)]"
Image_568.jpg,129,92,156,121,500,333,285,213,156,daskShared_local/images/Image_568.jpg,568,"[array([[[ 27,  42,  61],
        [ 27,  42,  61],
        [ 27,  42,  61],
        ...,
        [ 26,  44,  66],
        [ 26,  44,  66],
        [ 26,  44,  66]],

       [[ 27,  42,  61],
        [ 27,  42,  61],
        [ 27,  42,  61],
        ...,
        [ 26,  44,  66],
        [ 26,  44,  66],
        [ 26,  44,  66]],

       [[ 27,  42,  61],
        [ 27,  42,  61],
        [ 27,  42,  61],
        ...,
        [ 26,  44,  66],
        [ 26,  44,  66],
        [ 26,  44,  66]],

       ...,

       [[ 24,  42,  56],
        [ 25,  43,  57],
        [ 25,  43,  57],
        ...,
        [119, 136, 128],
        [118, 135, 127],
        [117, 134, 126]],

       [[ 24,  42,  56],
        [ 25,  43,  57],
        [ 25,  43,  57],
        ...,
        [121, 138, 130],
        [119, 136, 128],
        [118, 135, 127]],

       [[ 25,  43,  57],
        [ 25,  43,  57],
        [ 25,  43,  57],
        ...,
        [123, 140, 132],
        [121, 138, 130],
        [120, 137, 129]]], dtype=uint8)]"
Image_569.jpg,405,175,82,69,800,600,487,244,82,daskShared_local/images/Image_569.jpg,569,"[array([[[ 72, 126, 160],
        [ 73, 126, 160],
        [ 71, 126, 158],
        ...,
        [ 60, 119, 177],
        [ 61, 119, 178],
        [ 61, 119, 177]],

       [[ 68, 124, 158],
        [ 69, 124, 159],
        [ 67, 124, 157],
        ...,
        [ 60, 119, 176],
        [ 61, 120, 178],
        [ 61, 119, 177]],

       [[ 78, 130, 162],
        [ 79, 130, 162],
        [ 77, 129, 161],
        ...,
        [ 61, 118, 177],
        [ 61, 119, 178],
        [ 61, 119, 178]],

       ...,

       [[117, 118, 127],
        [116, 117, 127],
        [118, 120, 129],
        ...,
        [ 18, 135, 244],
        [ 19, 135, 246],
        [ 18, 135, 245]],

       [[114, 118, 126],
        [113, 117, 126],
        [116, 119, 127],
        ...,
        [ 18, 135, 245],
        [ 19, 135, 246],
        [ 19, 135, 245]],

       [[115, 118, 127],
        [114, 117, 126],
        [117, 119, 128],
        ...,
        [ 18, 135, 245],
        [ 19, 135, 246],
        [ 19, 135, 245]]], dtype=uint8)]"
Image_57.jpg,219,211,134,152,800,600,353,363,152,daskShared_local/images/Image_57.jpg,57,"[array([[[ 74, 189, 210],
        [ 74, 189, 210],
        [ 73, 188, 210],
        ...,
        [ 27, 166, 195],
        [ 28, 167, 196],
        [ 27, 166, 195]],

       [[ 73, 188, 211],
        [ 73, 188, 211],
        [ 72, 188, 210],
        ...,
        [ 28, 166, 195],
        [ 29, 166, 196],
        [ 28, 166, 195]],

       [[ 70, 188, 210],
        [ 70, 188, 210],
        [ 70, 187, 210],
        ...,
        [ 28, 166, 195],
        [ 29, 165, 195],
        [ 27, 165, 194]],

       ...,

       [[ 27, 136, 121],
        [ 26, 133, 118],
        [ 27, 132, 116],
        ...,
        [225, 198, 144],
        [228, 201, 145],
        [228, 198, 144]],

       [[ 27, 133, 118],
        [ 26, 132, 116],
        [ 28, 131, 115],
        ...,
        [229, 200, 156],
        [231, 203, 155],
        [227, 197, 135]],

       [[ 26, 131, 116],
        [ 27, 131, 114],
        [ 29, 130, 114],
        ...,
        [232, 201, 162],
        [232, 202, 158],
        [225, 195, 134]]], dtype=uint8)]"
Image_570.jpg,881,523,215,190,1920,1200,1096,713,215,daskShared_local/images/Image_570.jpg,570,"[array([[[  0, 114, 113],
        [  1, 117, 115],
        [  0, 114, 113],
        ...,
        [  9, 129, 130],
        [  7, 127, 128],
        [  6, 126, 127]],

       [[  5, 122, 114],
        [  1, 117, 110],
        [  1, 116, 109],
        ...,
        [  3, 127, 123],
        [  0, 125, 121],
        [  0, 121, 117]],

       [[  4, 119, 113],
        [  2, 116, 110],
        [  0, 114, 110],
        ...,
        [  0, 123, 119],
        [  0, 122, 118],
        [  0, 120, 116]],

       ...,

       [[106, 100,  67],
        [121, 112,  80],
        [109,  95,  62],
        ...,
        [112,  96,  46],
        [ 85,  66,  19],
        [192, 171, 130]],

       [[101,  94,  64],
        [114, 103,  72],
        [117, 103,  73],
        ...,
        [130, 108,  58],
        [101,  75,  27],
        [170, 144, 101]],

       [[119, 112,  84],
        [120, 109,  80],
        [123, 108,  79],
        ...,
        [185, 157, 107],
        [132, 101,  54],
        [ 90,  59,  15]]], dtype=uint8)]"
Image_571.jpg,166,9,103,103,498,272,269,112,103,daskShared_local/images/Image_571.jpg,571,"[array([[[  1,  39,  76],
        [  1,  39,  76],
        [  1,  39,  76],
        ...,
        [  1,  31,  55],
        [  0,  30,  54],
        [  0,  30,  54]],

       [[  1,  39,  76],
        [  1,  39,  76],
        [  1,  39,  76],
        ...,
        [  1,  31,  55],
        [  1,  30,  54],
        [  0,  30,  54]],

       [[  0,  38,  75],
        [  0,  38,  75],
        [  0,  38,  75],
        ...,
        [  3,  31,  54],
        [  1,  31,  54],
        [  1,  30,  54]],

       ...,

       [[113, 125, 129],
        [113, 125, 129],
        [114, 128, 128],
        ...,
        [195, 211, 201],
        [193, 209, 201],
        [193, 208, 201]],

       [[108, 120, 121],
        [108, 121, 121],
        [110, 125, 121],
        ...,
        [190, 205, 196],
        [190, 206, 198],
        [190, 206, 198]],

       [[108, 120, 121],
        [108, 120, 121],
        [110, 125, 121],
        ...,
        [189, 205, 196],
        [190, 205, 198],
        [190, 206, 198]]], dtype=uint8)]"
Image_572.JPG,563,404,441,325,1600,1467,1004,729,441,daskShared_local/images/Image_572.JPG,572,"[array([[[ 76, 107, 104],
        [ 85, 100,  88],
        [ 76,  84,  81],
        ...,
        [ 89,  98,  96],
        [ 90,  98,  86],
        [ 90,  97,  81]],

       [[ 80, 109, 111],
        [ 90, 105,  97],
        [ 78,  88,  88],
        ...,
        [ 92, 100, 101],
        [ 91, 101,  92],
        [ 92, 102,  88]],

       [[ 78, 104, 109],
        [ 95, 111, 108],
        [ 89, 101, 101],
        ...,
        [ 94, 102, 103],
        [ 88,  96,  92],
        [ 93, 102,  92]],

       ...,

       [[224, 233, 181],
        [226, 232, 186],
        [226, 232, 189],
        ...,
        [241, 243, 239],
        [243, 245, 242],
        [235, 237, 234]],

       [[218, 226, 174],
        [219, 226, 179],
        [221, 228, 185],
        ...,
        [249, 251, 245],
        [253, 254, 251],
        [252, 253, 251]],

       [[223, 231, 181],
        [222, 231, 184],
        [222, 232, 186],
        ...,
        [245, 248, 240],
        [252, 254, 249],
        [253, 255, 252]]], dtype=uint8)]"
Image_573.jpg,672,287,292,321,1600,900,964,608,321,daskShared_local/images/Image_573.jpg,573,"[array([[[  0, 116, 200],
        [  0, 116, 200],
        [  0, 116, 200],
        ...,
        [  2, 118, 205],
        [  0, 120, 203],
        [  0, 120, 203]],

       [[  0, 116, 199],
        [  0, 116, 199],
        [  0, 116, 199],
        ...,
        [  1, 117, 204],
        [  0, 118, 202],
        [  0, 119, 203]],

       [[  0, 116, 199],
        [  0, 116, 199],
        [  0, 116, 199],
        ...,
        [  1, 117, 204],
        [  1, 117, 202],
        [  0, 118, 202]],

       ...,

       [[142, 132,  91],
        [152, 143, 101],
        [150, 141, 101],
        ...,
        [ 99, 104,  70],
        [101, 117,  94],
        [ 76,  86,  63]],

       [[179, 169, 133],
        [171, 161, 125],
        [185, 177, 141],
        ...,
        [ 65,  75,  52],
        [ 72,  93,  76],
        [ 77,  88,  70]],

       [[193, 182, 150],
        [191, 182, 148],
        [212, 203, 169],
        ...,
        [117, 130, 118],
        [ 72,  93,  81],
        [ 60,  71,  57]]], dtype=uint8)]"
Image_574.jpg,73,72,93,90,300,260,166,162,93,daskShared_local/images/Image_574.jpg,574,"[array([[[  3, 228, 254],
        [  3, 228, 254],
        [  3, 228, 253],
        ...,
        [ 67, 208, 238],
        [ 64, 214, 241],
        [ 64, 213, 240]],

       [[  3, 228, 254],
        [  3, 228, 254],
        [  3, 227, 253],
        ...,
        [ 55, 204, 236],
        [ 51, 211, 239],
        [ 51, 211, 239]],

       [[  3, 228, 253],
        [  3, 228, 253],
        [  2, 228, 253],
        ...,
        [147, 229, 247],
        [152, 229, 248],
        [152, 229, 248]],

       ...,

       [[  1, 187, 238],
        [  1, 187, 238],
        [  1, 187, 238],
        ...,
        [ 42, 108,  67],
        [ 87, 161, 102],
        [ 81, 154,  97]],

       [[  1, 188, 239],
        [  1, 188, 239],
        [  0, 187, 238],
        ...,
        [ 45, 110,  64],
        [ 76, 153,  84],
        [ 72, 148,  82]],

       [[  1, 188, 239],
        [  1, 188, 239],
        [  1, 187, 238],
        ...,
        [ 45, 110,  65],
        [ 77, 154,  87],
        [ 73, 148,  84]]], dtype=uint8)]"
Image_575.jpg,324,273,95,68,800,600,419,341,95,daskShared_local/images/Image_575.jpg,575,"[array([[[  0, 158, 255],
        [  0, 158, 255],
        [  0, 158, 255],
        ...,
        [  0, 162, 253],
        [  0, 163, 254],
        [  0, 163, 254]],

       [[  0, 158, 255],
        [  0, 158, 255],
        [  0, 158, 255],
        ...,
        [  0, 162, 253],
        [  0, 163, 254],
        [  0, 163, 254]],

       [[  0, 158, 255],
        [  0, 158, 255],
        [  0, 158, 255],
        ...,
        [  0, 162, 253],
        [  0, 163, 254],
        [  0, 163, 254]],

       ...,

       [[143, 183, 143],
        [144, 183, 144],
        [139, 181, 134],
        ...,
        [ 40,  45,  38],
        [ 41,  47,  38],
        [ 41,  47,  38]],

       [[134, 172, 131],
        [135, 173, 133],
        [123, 163, 114],
        ...,
        [ 35,  40,  34],
        [ 38,  43,  36],
        [ 38,  43,  36]],

       [[135, 173, 132],
        [136, 174, 134],
        [124, 164, 116],
        ...,
        [ 36,  41,  34],
        [ 38,  44,  36],
        [ 38,  43,  36]]], dtype=uint8)]"
Image_576.jpg,295,235,306,281,1000,664,601,516,306,daskShared_local/images/Image_576.jpg,576,"[array([[[199, 203, 207],
        [199, 203, 207],
        [199, 203, 206],
        ...,
        [167, 145, 134],
        [168, 148, 137],
        [164, 144, 134]],

       [[201, 204, 209],
        [200, 203, 208],
        [200, 203, 208],
        ...,
        [168, 149, 142],
        [170, 152, 145],
        [176, 156, 149]],

       [[201, 204, 209],
        [200, 203, 208],
        [200, 203, 208],
        ...,
        [184, 159, 150],
        [188, 162, 153],
        [189, 163, 155]],

       ...,

       [[141, 139, 135],
        [139, 136, 133],
        [139, 136, 132],
        ...,
        [162, 156, 143],
        [162, 156, 143],
        [163, 157, 145]],

       [[154, 153, 158],
        [149, 148, 151],
        [145, 144, 146],
        ...,
        [163, 157, 145],
        [163, 157, 145],
        [162, 158, 147]],

       [[159, 158, 157],
        [159, 157, 155],
        [154, 151, 149],
        ...,
        [168, 160, 144],
        [168, 160, 144],
        [166, 160, 145]]], dtype=uint8)]"
Image_577.jpg,321,156,160,183,1200,735,481,339,183,daskShared_local/images/Image_577.jpg,577,"[array([[[112, 185, 202],
        [104, 177, 194],
        [105, 179, 195],
        ...,
        [ 15,  50,  79],
        [ 12,  47,  75],
        [  7,  43,  69]],

       [[112, 187, 202],
        [106, 182, 196],
        [105, 181, 195],
        ...,
        [ 18,  57,  83],
        [ 16,  56,  82],
        [  8,  49,  74]],

       [[114, 190, 204],
        [111, 187, 201],
        [111, 187, 201],
        ...,
        [ 17,  59,  83],
        [ 19,  63,  85],
        [ 11,  58,  78]],

       ...,

       [[138, 184, 177],
        [139, 183, 179],
        [141, 185, 182],
        ...,
        [ 11,   1,   4],
        [ 12,   3,   5],
        [  7,   1,   1]],

       [[142, 186, 180],
        [143, 185, 183],
        [142, 181, 181],
        ...,
        [ 12,   2,   3],
        [ 10,   1,   2],
        [  4,   0,   0]],

       [[145, 185, 184],
        [146, 184, 185],
        [143, 178, 180],
        ...,
        [ 11,   2,   1],
        [ 12,   4,   3],
        [  6,   0,   0]]], dtype=uint8)]"
Image_578.jpg,1414,434,479,337,2500,1667,1893,771,479,daskShared_local/images/Image_578.jpg,578,"[array([[[ 10, 134, 159],
        [  5, 135, 163],
        [  4, 131, 160],
        ...,
        [178, 209, 212],
        [180, 207, 216],
        [183, 210, 219]],

       [[ 27, 150, 173],
        [ 23, 146, 172],
        [ 33, 146, 175],
        ...,
        [179, 211, 214],
        [182, 209, 218],
        [182, 209, 218]],

       [[ 42, 154, 175],
        [ 40, 152, 172],
        [ 53, 155, 173],
        ...,
        [183, 210, 217],
        [180, 207, 217],
        [180, 206, 217]],

       ...,

       [[199, 191, 160],
        [183, 173, 142],
        [188, 174, 146],
        ...,
        [164, 164, 131],
        [159, 160, 123],
        [160, 158, 113]],

       [[170, 159, 124],
        [185, 172, 135],
        [189, 173, 138],
        ...,
        [165, 161, 126],
        [163, 158, 118],
        [157, 163, 120]],

       [[177, 163, 124],
        [164, 148, 107],
        [171, 153, 113],
        ...,
        [164, 160, 122],
        [167, 159, 114],
        [147, 159, 120]]], dtype=uint8)]"
Image_579.jpg,632,180,486,429,2000,1000,1118,609,486,daskShared_local/images/Image_579.jpg,579,"[array([[[  1, 162, 210],
        [  1, 163, 209],
        [  0, 162, 208],
        ...,
        [  0, 154, 208],
        [  0, 154, 208],
        [  2, 153, 208]],

       [[  1, 161, 209],
        [  1, 161, 209],
        [  0, 161, 207],
        ...,
        [  0, 154, 208],
        [  0, 154, 208],
        [  2, 153, 208]],

       [[  2, 160, 208],
        [  1, 160, 208],
        [  1, 160, 206],
        ...,
        [  0, 153, 207],
        [  0, 153, 207],
        [  1, 152, 207]],

       ...,

       [[  2, 110, 149],
        [  1, 108, 147],
        [  0, 107, 146],
        ...,
        [ 11,  72,  64],
        [ 15,  88,  77],
        [ 46,  95,  85]],

       [[  1, 107, 146],
        [  1, 105, 144],
        [  0, 104, 143],
        ...,
        [  1,  99,  84],
        [  7,  91,  76],
        [ 39,  93,  81]],

       [[  2, 108, 147],
        [  2, 108, 147],
        [  1, 106, 145],
        ...,
        [  7,  87,  78],
        [ 17,  93,  78],
        [ 19,  99,  79]]], dtype=uint8)]"
Image_58.png,358,58,198,151,600,600,556,209,198,daskShared_local/images/Image_58.png,58,"[array([[[  0, 100, 248],
        [  0, 100, 248],
        [  0, 100, 248],
        ...,
        [  0, 118, 254],
        [  0, 118, 254],
        [  0, 118, 254]],

       [[  0, 100, 248],
        [  0, 100, 248],
        [  0, 102, 249],
        ...,
        [  0, 118, 254],
        [  0, 118, 254],
        [  0, 118, 254]],

       [[  1, 101, 249],
        [  1, 101, 249],
        [  0, 102, 249],
        ...,
        [  0, 118, 254],
        [  0, 118, 254],
        [  0, 118, 254]],

       ...,

       [[199, 151,  66],
        [234, 190, 103],
        [250, 250, 242],
        ...,
        [207, 221, 107],
        [233, 246, 138],
        [234, 238, 205]],

       [[173, 113,   0],
        [213, 159,  51],
        [216, 184,  63],
        ...,
        [237, 253, 118],
        [235, 244, 165],
        [220, 218, 206]],

       [[194, 178,  83],
        [212, 179,  86],
        [225, 216, 111],
        ...,
        [235, 238, 171],
        [221, 226, 185],
        [217, 226, 183]]], dtype=uint8)]"
Image_580.jpg,1020,1487,1109,806,4613,2968,2129,2293,1109,daskShared_local/images/Image_580.jpg,580,"[array([[[141, 168, 170],
        [143, 169, 170],
        [140, 167, 167],
        ...,
        [162, 161, 148],
        [ 66,  61,  49],
        [ 24,   8,   5]],

       [[134, 156, 161],
        [134, 155, 159],
        [133, 153, 158],
        ...,
        [147, 144, 137],
        [ 85,  72,  61],
        [ 46,  28,  18]],

       [[129, 148, 152],
        [126, 144, 148],
        [127, 141, 145],
        ...,
        [ 91,  79,  72],
        [ 76,  62,  51],
        [ 74,  57,  45]],

       ...,

       [[ 64,  67,  69],
        [ 59,  65,  67],
        [ 62,  70,  71],
        ...,
        [181, 171, 153],
        [160, 141, 116],
        [143, 121,  95]],

       [[ 57,  59,  61],
        [ 57,  59,  62],
        [ 61,  71,  71],
        ...,
        [178, 170, 149],
        [189, 174, 153],
        [166, 143, 115]],

       [[ 63,  67,  70],
        [ 58,  60,  63],
        [ 57,  59,  60],
        ...,
        [160, 146, 122],
        [172, 165, 148],
        [170, 162, 145]]], dtype=uint8)]"
Image_581.jpg,389,1005,894,592,4601,3200,1283,1597,894,daskShared_local/images/Image_581.jpg,581,"[array([[[ 37, 164, 237],
        [ 35, 168, 243],
        [ 30, 164, 238],
        ...,
        [ 49, 151, 221],
        [ 54, 158, 230],
        [ 67, 157, 229]],

       [[ 34, 149, 221],
        [ 35, 162, 238],
        [ 33, 165, 241],
        ...,
        [ 55, 163, 234],
        [ 53, 159, 230],
        [ 53, 153, 223]],

       [[ 33, 158, 228],
        [ 32, 159, 232],
        [ 36, 162, 238],
        ...,
        [ 50, 156, 225],
        [ 51, 156, 227],
        [ 44, 157, 226]],

       ...,

       [[ 15, 158, 216],
        [ 18, 156, 221],
        [ 26, 152, 223],
        ...,
        [ 52, 160, 210],
        [ 45, 152, 201],
        [ 48, 155, 211]],

       [[ 21, 159, 218],
        [ 16, 149, 213],
        [ 23, 155, 222],
        ...,
        [ 52, 156, 202],
        [ 49, 152, 198],
        [ 47, 157, 193]],

       [[ 19, 154, 216],
        [ 23, 159, 222],
        [ 23, 156, 219],
        ...,
        [ 53, 153, 200],
        [ 54, 154, 199],
        [ 48, 152, 204]]], dtype=uint8)]"
Image_582.jpeg,635,146,261,247,1200,800,896,393,261,daskShared_local/images/Image_582.jpeg,582,"[array([[[159, 211, 225],
        [156, 207, 223],
        [155, 205, 222],
        ...,
        [181, 214, 229],
        [182, 215, 230],
        [183, 216, 231]],

       [[165, 214, 227],
        [162, 210, 224],
        [161, 210, 224],
        ...,
        [181, 214, 231],
        [181, 214, 231],
        [181, 214, 231]],

       [[167, 215, 226],
        [164, 211, 224],
        [165, 211, 225],
        ...,
        [179, 212, 229],
        [180, 213, 230],
        [179, 212, 229]],

       ...,

       [[ 54,  28,   0],
        [ 85,  55,  22],
        [140, 105,  69],
        ...,
        [167, 146,  97],
        [161, 138,  93],
        [179, 154, 113]],

       [[ 75,  52,   6],
        [ 71,  43,   2],
        [ 94,  61,  14],
        ...,
        [177, 155, 110],
        [165, 141, 101],
        [157, 132,  94]],

       [[125, 104,  37],
        [ 93,  67,  14],
        [ 74,  44,   1],
        ...,
        [175, 152, 111],
        [161, 136,  99],
        [145, 119,  86]]], dtype=uint8)]"
Image_583.jpg,308,213,200,203,1000,600,508,416,203,daskShared_local/images/Image_583.jpg,583,"[array([[[  1, 146, 193],
        [  1, 146, 193],
        [  1, 146, 193],
        ...,
        [  1, 158, 201],
        [  1, 158, 201],
        [  1, 158, 201]],

       [[  1, 146, 193],
        [  1, 146, 193],
        [  1, 146, 193],
        ...,
        [  1, 158, 201],
        [  1, 158, 201],
        [  1, 158, 201]],

       [[  1, 146, 193],
        [  1, 146, 193],
        [  1, 146, 193],
        ...,
        [  1, 158, 201],
        [  1, 158, 201],
        [  1, 158, 201]],

       ...,

       [[ 67,  44,  29],
        [ 32,  15,  30],
        [ 35,  27,  23],
        ...,
        [244, 222, 162],
        [245, 221, 157],
        [244, 219, 152]],

       [[ 41,  25,  24],
        [ 27,  22,  28],
        [ 32,  32,  28],
        ...,
        [242, 221, 166],
        [242, 220, 162],
        [242, 218, 156]],

       [[ 38,  29,  20],
        [ 35,  38,  22],
        [ 24,  28,  27],
        ...,
        [240, 220, 167],
        [239, 218, 163],
        [241, 216, 159]]], dtype=uint8)]"
Image_584.jpg,386,136,223,198,869,574,609,334,223,daskShared_local/images/Image_584.jpg,584,"[array([[[ 38, 163, 233],
        [ 53, 169, 239],
        [ 65, 172, 241],
        ...,
        [ 75, 166, 243],
        [ 72, 167, 243],
        [ 71, 164, 244]],

       [[ 13, 153, 220],
        [ 22, 154, 222],
        [ 35, 158, 226],
        ...,
        [ 76, 165, 242],
        [ 76, 167, 244],
        [ 76, 167, 244]],

       [[  1, 148, 215],
        [  3, 147, 212],
        [  8, 148, 212],
        ...,
        [ 78, 165, 242],
        [ 78, 165, 242],
        [ 74, 163, 238]],

       ...,

       [[  4,   8,   6],
        [  2,   4,   2],
        [  0,  12,   8],
        ...,
        [  1, 107, 181],
        [  1, 107, 181],
        [  2, 105, 179]],

       [[ 22,   4,  10],
        [ 14,   1,   4],
        [  9,   7,   9],
        ...,
        [  1, 107, 181],
        [  1, 107, 181],
        [  2, 104, 179]],

       [[  7,   1,   3],
        [  9,   3,   5],
        [  9,  15,  15],
        ...,
        [  1, 107, 181],
        [  1, 107, 181],
        [  2, 104, 179]]], dtype=uint8)]"
Image_585.jpg,1415,1117,437,366,2522,3332,1852,1483,437,daskShared_local/images/Image_585.jpg,585,"[array([[[ 94,  90,  76],
        [ 98,  95,  84],
        [ 99,  97,  90],
        ...,
        [  9, 153, 195],
        [  2, 143, 186],
        [  1, 140, 185]],

       [[ 77,  76,  81],
        [ 82,  81,  86],
        [ 79,  79,  82],
        ...,
        [  2, 148, 186],
        [  4, 146, 187],
        [  0, 138, 182]],

       [[ 86,  82, 100],
        [ 88,  84,  99],
        [ 90,  86,  96],
        ...,
        [  1, 145, 182],
        [  1, 142, 183],
        [  0, 138, 182]],

       ...,

       [[ 27,  47,  49],
        [ 43,  64,  65],
        [ 45,  69,  69],
        ...,
        [  1, 124, 201],
        [  0, 123, 200],
        [  0, 123, 200]],

       [[ 23,  42,  46],
        [ 33,  55,  57],
        [ 33,  59,  59],
        ...,
        [  2, 125, 202],
        [  0, 123, 200],
        [  0, 123, 200]],

       [[ 23,  43,  46],
        [ 28,  51,  54],
        [ 34,  60,  61],
        ...,
        [  1, 124, 201],
        [  1, 123, 200],
        [  1, 124, 201]]], dtype=uint8)]"
Image_586.jpg,372,421,160,133,1200,800,532,554,160,daskShared_local/images/Image_586.jpg,586,"[array([[[121, 130,  75],
        [120, 129,  74],
        [119, 128,  73],
        ...,
        [190, 180, 142],
        [218, 210, 172],
        [248, 243, 207]],

       [[119, 128,  75],
        [119, 128,  74],
        [118, 127,  73],
        ...,
        [224, 212, 176],
        [239, 228, 193],
        [241, 231, 196]],

       [[118, 127,  74],
        [117, 126,  73],
        [117, 126,  73],
        ...,
        [244, 231, 200],
        [240, 226, 195],
        [219, 205, 174]],

       ...,

       [[ 46, 109,  88],
        [ 46, 109,  88],
        [ 47, 110,  89],
        ...,
        [ 62, 115,  95],
        [ 62, 115,  95],
        [ 61, 114,  94]],

       [[ 45, 109,  88],
        [ 46, 109,  88],
        [ 46, 110,  89],
        ...,
        [ 62, 115,  96],
        [ 61, 115,  95],
        [ 61, 114,  95]],

       [[ 44, 109,  87],
        [ 45, 110,  88],
        [ 46, 110,  89],
        ...,
        [ 61, 116,  97],
        [ 61, 116,  97],
        [ 60, 115,  96]]], dtype=uint8)]"
Image_587.jpg,413,369,274,217,1536,1024,687,586,274,daskShared_local/images/Image_587.jpg,587,"[array([[[ 10, 125, 242],
        [  9, 124, 241],
        [ 10, 125, 244],
        ...,
        [  9, 145, 241],
        [ 10, 144, 243],
        [ 11, 143, 243]],

       [[  9, 124, 241],
        [  8, 123, 240],
        [  9, 124, 243],
        ...,
        [ 14, 142, 240],
        [ 14, 142, 241],
        [ 15, 141, 241]],

       [[ 11, 126, 243],
        [ 11, 126, 243],
        [  7, 120, 240],
        ...,
        [ 13, 140, 245],
        [ 11, 139, 241],
        [ 16, 145, 247]],

       ...,

       [[  9,  63, 213],
        [  9,  63, 213],
        [ 11,  65, 192],
        ...,
        [ 33,  50,  47],
        [ 23,  46,  44],
        [ 24,  48,  34]],

       [[  9,  63, 213],
        [  9,  63, 213],
        [ 18,  73, 189],
        ...,
        [ 26,  51,  48],
        [ 19,  47,  45],
        [ 27,  47,  44]],

       [[  9,  63, 211],
        [  9,  63, 211],
        [ 16,  71, 188],
        ...,
        [ 18,  45,  37],
        [ 24,  45,  41],
        [ 32,  48,  47]]], dtype=uint8)]"
Image_588.jpg,700,656,358,274,2793,2090,1058,930,358,daskShared_local/images/Image_588.jpg,588,"[array([[[  3,  67, 190],
        [  3,  67, 190],
        [  3,  67, 190],
        ...,
        [  3,  68, 186],
        [  3,  68, 186],
        [  3,  68, 186]],

       [[  3,  67, 190],
        [  3,  67, 190],
        [  3,  67, 190],
        ...,
        [  3,  68, 186],
        [  3,  68, 186],
        [  3,  68, 186]],

       [[  3,  67, 190],
        [  3,  67, 190],
        [  3,  67, 190],
        ...,
        [  3,  68, 186],
        [  3,  68, 186],
        [  3,  68, 186]],

       ...,

       [[  5,  52, 156],
        [  5,  52, 156],
        [  5,  52, 156],
        ...,
        [ 62,  71,  42],
        [ 61,  70,  42],
        [ 52,  63,  41]],

       [[  3,  50, 154],
        [  3,  50, 154],
        [  5,  52, 156],
        ...,
        [ 57,  67,  40],
        [ 54,  64,  39],
        [ 55,  67,  50]],

       [[  3,  50, 154],
        [  3,  50, 154],
        [  5,  52, 156],
        ...,
        [ 49,  63,  38],
        [ 52,  65,  40],
        [ 69,  82,  64]]], dtype=uint8)]"
Image_589.jpg,474,126,267,310,1600,1019,741,436,310,daskShared_local/images/Image_589.jpg,589,"[array([[[ 30, 107, 213],
        [ 30, 107, 213],
        [ 30, 107, 213],
        ...,
        [ 28, 116, 213],
        [ 28, 116, 213],
        [ 28, 116, 213]],

       [[ 27, 109, 213],
        [ 27, 109, 213],
        [ 27, 109, 213],
        ...,
        [ 28, 116, 213],
        [ 28, 116, 213],
        [ 28, 116, 213]],

       [[ 26, 109, 213],
        [ 26, 109, 213],
        [ 26, 109, 213],
        ...,
        [ 28, 116, 213],
        [ 28, 116, 213],
        [ 28, 116, 213]],

       ...,

       [[179, 182, 169],
        [196, 197, 188],
        [214, 216, 209],
        ...,
        [ 72,  81,  62],
        [112, 135, 115],
        [ 87, 109,  92]],

       [[194, 197, 181],
        [230, 232, 219],
        [205, 206, 197],
        ...,
        [ 71,  66,  49],
        [ 75,  83,  67],
        [ 67,  85,  68]],

       [[225, 228, 211],
        [236, 238, 225],
        [221, 223, 213],
        ...,
        [ 70,  62,  48],
        [ 98, 100,  86],
        [136, 148, 133]]], dtype=uint8)]"
Image_59.jpg,583,83,228,173,1068,601,811,256,228,daskShared_local/images/Image_59.jpg,59,"[array([[[  0,  72, 255],
        [  0,  71, 254],
        [  0,  71, 254],
        ...,
        [  0,  87, 255],
        [  0,  87, 255],
        [  0,  87, 255]],

       [[  0,  72, 255],
        [  0,  71, 254],
        [  0,  71, 254],
        ...,
        [  0,  87, 255],
        [  0,  87, 255],
        [  0,  87, 255]],

       [[  0,  72, 255],
        [  0,  72, 255],
        [  0,  72, 255],
        ...,
        [  0,  87, 255],
        [  0,  87, 255],
        [  0,  87, 255]],

       ...,

       [[198, 177, 135],
        [245, 219, 181],
        [221, 192, 153],
        ...,
        [210, 223, 215],
        [211, 222, 207],
        [213, 222, 205]],

       [[128, 110,  78],
        [181, 154, 135],
        [194, 162, 144],
        ...,
        [207, 222, 210],
        [210, 223, 203],
        [214, 224, 201]],

       [[129, 114,  93],
        [ 99,  74,  67],
        [118,  87,  84],
        ...,
        [205, 222, 208],
        [209, 224, 200],
        [213, 223, 196]]], dtype=uint8)]"
Image_590.jpg,356,130,220,184,1280,720,576,314,220,daskShared_local/images/Image_590.jpg,590,"[array([[[ 31, 127, 214],
        [ 26, 122, 209],
        [ 20, 117, 204],
        ...,
        [ 19, 132, 212],
        [ 20, 133, 213],
        [ 21, 134, 214]],

       [[ 26, 121, 209],
        [ 24, 120, 207],
        [ 21, 118, 205],
        ...,
        [ 20, 133, 213],
        [ 21, 134, 214],
        [ 21, 134, 214]],

       [[ 24, 118, 206],
        [ 23, 119, 206],
        [ 22, 118, 205],
        ...,
        [ 19, 132, 212],
        [ 20, 133, 213],
        [ 21, 134, 214]],

       ...,

       [[ 12,  77, 169],
        [ 10,  75, 167],
        [ 10,  75, 167],
        ...,
        [ 17,  14,   3],
        [ 34,  31,  15],
        [ 72,  69,  47]],

       [[ 17,  82, 174],
        [ 15,  80, 172],
        [ 12,  77, 169],
        ...,
        [  6,   6,   0],
        [  5,   6,   0],
        [ 16,  16,   3]],

       [[ 12,  77, 169],
        [ 15,  80, 172],
        [ 15,  80, 172],
        ...,
        [ 16,  19,  12],
        [ 12,  15,   6],
        [ 11,  12,   4]]], dtype=uint8)]"
Image_591.jpg,709,187,178,142,1000,600,887,329,178,daskShared_local/images/Image_591.jpg,591,"[array([[[  7, 159, 208],
        [  8, 160, 209],
        [ 10, 161, 210],
        ...,
        [  5, 152, 206],
        [  5, 152, 206],
        [  5, 152, 206]],

       [[ 12, 161, 209],
        [ 11, 160, 208],
        [ 12, 161, 209],
        ...,
        [  5, 152, 206],
        [  5, 152, 206],
        [  5, 152, 206]],

       [[ 14, 160, 207],
        [ 14, 160, 207],
        [ 15, 162, 209],
        ...,
        [  4, 153, 206],
        [  4, 153, 206],
        [  4, 153, 207]],

       ...,

       [[213, 199,  37],
        [202, 188,  31],
        [206, 188,  56],
        ...,
        [238, 237, 231],
        [237, 235, 239],
        [236, 235, 240]],

       [[216, 205,  37],
        [207, 194,  40],
        [210, 190,  70],
        ...,
        [216, 211, 230],
        [214, 212, 219],
        [221, 222, 213]],

       [[212, 205,  27],
        [209, 197,  35],
        [213, 195,  70],
        ...,
        [170, 164, 192],
        [179, 178, 177],
        [194, 198, 171]]], dtype=uint8)]"
Image_592.jpg,664,123,189,184,1156,650,853,307,189,daskShared_local/images/Image_592.jpg,592,"[array([[[  2, 142, 169],
        [  1, 139, 164],
        [  1, 131, 155],
        ...,
        [ 52, 154, 169],
        [ 40, 151, 166],
        [ 38, 151, 167]],

       [[ 33, 158, 182],
        [ 38, 161, 184],
        [ 39, 159, 181],
        ...,
        [ 31, 148, 159],
        [ 21, 147, 157],
        [ 18, 145, 156]],

       [[ 52, 151, 175],
        [ 69, 168, 192],
        [ 84, 182, 205],
        ...,
        [ 47, 169, 178],
        [ 28, 159, 167],
        [ 11, 139, 150]],

       ...,

       [[102,  96,  80],
        [136, 130, 114],
        [148, 142, 124],
        ...,
        [  0, 129, 168],
        [  0, 127, 167],
        [  0, 126, 166]],

       [[ 52,  47,  30],
        [ 94,  88,  71],
        [123, 118,  99],
        ...,
        [  1, 130, 169],
        [  1, 130, 169],
        [  1, 130, 170]],

       [[ 30,  27,   8],
        [ 50,  45,  26],
        [ 74,  69,  49],
        ...,
        [  2, 134, 172],
        [  2, 134, 173],
        [  2, 134, 173]]], dtype=uint8)]"
Image_593.jpg,291,169,226,198,1000,664,517,367,226,daskShared_local/images/Image_593.jpg,593,"[array([[[  1,  80, 146],
        [  1,  80, 147],
        [  2,  79, 147],
        ...,
        [  0, 100, 169],
        [  0, 102, 169],
        [  0, 100, 168]],

       [[  0,  79, 148],
        [  1,  80, 146],
        [  0,  79, 147],
        ...,
        [  1, 101, 169],
        [  0, 100, 168],
        [  0, 100, 168]],

       [[  0,  80, 146],
        [  1,  79, 146],
        [  0,  78, 146],
        ...,
        [  0, 100, 168],
        [  0,  99, 168],
        [  0, 100, 168]],

       ...,

       [[ 46,  46,  35],
        [ 46,  40,  32],
        [ 37,  37,  32],
        ...,
        [200, 183, 129],
        [195, 185, 155],
        [167, 140, 110]],

       [[ 52,  48,  34],
        [ 47,  40,  32],
        [ 37,  41,  33],
        ...,
        [223, 210, 158],
        [206, 197, 166],
        [153, 122,  93]],

       [[ 45,  52,  39],
        [ 42,  43,  31],
        [ 33,  36,  30],
        ...,
        [232, 220, 175],
        [214, 203, 176],
        [128,  92,  72]]], dtype=uint8)]"
Image_594.jpg,654,283,308,331,1600,1000,962,614,331,daskShared_local/images/Image_594.jpg,594,"[array([[[  0,  71, 163],
        [  0,  71, 163],
        [  0,  71, 163],
        ...,
        [  2,  69, 160],
        [  2,  69, 160],
        [  1,  68, 159]],

       [[  0,  71, 161],
        [  0,  71, 163],
        [  0,  71, 163],
        ...,
        [  2,  69, 160],
        [  2,  69, 160],
        [  1,  68, 159]],

       [[  0,  71, 161],
        [  0,  71, 163],
        [  0,  71, 163],
        ...,
        [  2,  69, 160],
        [  2,  69, 160],
        [  1,  68, 159]],

       ...,

       [[ 31,  41,  19],
        [ 61,  78,  47],
        [ 92, 105,  71],
        ...,
        [126, 109,  63],
        [112,  94,  50],
        [ 87,  74,  31]],

       [[ 34,  45,  27],
        [ 39,  57,  33],
        [ 43,  55,  30],
        ...,
        [107,  91,  55],
        [104,  87,  57],
        [ 99,  83,  56]],

       [[ 33,  45,  29],
        [ 29,  46,  28],
        [ 32,  42,  25],
        ...,
        [138, 124,  90],
        [138, 124,  92],
        [122, 108,  78]]], dtype=uint8)]"
Image_595.jpg,403,306,224,216,1500,1000,627,522,224,daskShared_local/images/Image_595.jpg,595,"[array([[[  8, 155, 173],
        [  7, 153, 171],
        [  3, 148, 167],
        ...,
        [  1, 134, 154],
        [  1, 134, 153],
        [  1, 134, 153]],

       [[ 10, 159, 177],
        [  8, 156, 175],
        [  4, 152, 171],
        ...,
        [  3, 133, 155],
        [  3, 133, 153],
        [  3, 134, 154]],

       [[  2, 160, 179],
        [  3, 157, 177],
        [  2, 153, 174],
        ...,
        [  6, 122, 149],
        [  5, 124, 150],
        [  8, 128, 153]],

       ...,

       [[104, 166, 164],
        [ 96, 156, 152],
        [ 82, 141, 136],
        ...,
        [100,  82,   9],
        [118, 102,  23],
        [161, 145,  67]],

       [[155, 209, 198],
        [149, 200, 188],
        [142, 190, 175],
        ...,
        [135, 118,  44],
        [176, 159,  80],
        [195, 179, 101]],

       [[175, 219, 200],
        [177, 216, 195],
        [178, 216, 191],
        ...,
        [192, 174, 102],
        [201, 183, 109],
        [173, 155,  83]]], dtype=uint8)]"
Image_596.jpg,1733,535,1380,1582,4631,3087,3113,2117,1582,daskShared_local/images/Image_596.jpg,596,"[array([[[ 20,  94, 241],
        [ 20,  94, 240],
        [ 20,  93, 240],
        ...,
        [  1,  60, 197],
        [  1,  60, 196],
        [  1,  60, 196]],

       [[ 20,  93, 240],
        [ 20,  93, 240],
        [ 20,  93, 240],
        ...,
        [  0,  59, 196],
        [  0,  59, 196],
        [  0,  59, 195]],

       [[ 21,  93, 239],
        [ 21,  92, 239],
        [ 21,  92, 240],
        ...,
        [  0,  59, 196],
        [  0,  59, 195],
        [  0,  58, 194]],

       ...,

       [[144, 136, 101],
        [139, 133,  94],
        [122, 110,  76],
        ...,
        [ 35,  40,  23],
        [ 33,  40,  22],
        [ 31,  38,  20]],

       [[103, 100,  90],
        [119, 117,  96],
        [133, 132,  99],
        ...,
        [ 33,  40,  22],
        [ 36,  44,  25],
        [ 29,  37,  20]],

       [[ 52,  56,  67],
        [ 74,  77,  81],
        [121, 120, 100],
        ...,
        [ 33,  39,  22],
        [ 37,  44,  27],
        [ 29,  37,  19]]], dtype=uint8)]"
Image_597.jpg,697,283,460,496,1920,1080,1157,779,496,daskShared_local/images/Image_597.jpg,597,"[array([[[  0, 119, 203],
        [  0, 119, 203],
        [  0, 118, 202],
        ...,
        [  1, 116, 199],
        [  1, 116, 199],
        [  1, 116, 199]],

       [[  0, 119, 203],
        [  0, 119, 203],
        [  0, 118, 202],
        ...,
        [  1, 116, 199],
        [  1, 116, 199],
        [  1, 116, 199]],

       [[  1, 117, 202],
        [  1, 117, 200],
        [  1, 117, 200],
        ...,
        [  1, 116, 199],
        [  1, 116, 199],
        [  1, 116, 199]],

       ...,

       [[115, 122,  91],
        [150, 153, 116],
        [201, 202, 161],
        ...,
        [153, 144, 104],
        [151, 144, 101],
        [155, 147, 103]],

       [[ 79,  88,  60],
        [136, 140, 108],
        [170, 171, 139],
        ...,
        [157, 145, 109],
        [160, 148, 110],
        [164, 151, 112]],

       [[ 91, 100,  71],
        [112, 116,  87],
        [120, 118,  94],
        ...,
        [155, 144, 114],
        [167, 154, 124],
        [169, 156, 123]]], dtype=uint8)]"
Image_598.jpg,730,436,439,338,2119,1414,1169,774,439,daskShared_local/images/Image_598.jpg,598,"[array([[[ 99, 153, 184],
        [ 98, 153, 184],
        [ 95, 151, 182],
        ...,
        [ 79, 144, 174],
        [ 76, 141, 171],
        [ 75, 141, 170]],

       [[ 91, 146, 177],
        [ 96, 151, 182],
        [ 93, 149, 180],
        ...,
        [ 82, 147, 177],
        [ 77, 142, 172],
        [ 76, 142, 171]],

       [[ 93, 147, 178],
        [ 92, 147, 178],
        [ 92, 147, 178],
        ...,
        [ 76, 141, 171],
        [ 77, 142, 172],
        [ 78, 143, 173]],

       ...,

       [[ 83, 173, 199],
        [ 86, 176, 202],
        [ 85, 175, 200],
        ...,
        [218, 227, 226],
        [252, 253, 251],
        [254, 252, 253]],

       [[ 86, 178, 203],
        [ 87, 178, 203],
        [ 85, 177, 202],
        ...,
        [198, 208, 237],
        [203, 209, 231],
        [224, 226, 241]],

       [[ 87, 179, 204],
        [ 84, 176, 201],
        [ 84, 176, 201],
        ...,
        [227, 237, 251],
        [204, 208, 232],
        [179, 180, 205]]], dtype=uint8)]"
Image_599.jpg,508,243,329,218,1200,900,837,461,329,daskShared_local/images/Image_599.jpg,599,"[array([[[ 65, 180, 202],
        [ 59, 180, 195],
        [ 61, 181, 203],
        ...,
        [ 89, 189, 212],
        [ 77, 185, 209],
        [ 81, 188, 207]],

       [[ 60, 184, 202],
        [ 63, 183, 199],
        [ 62, 183, 199],
        ...,
        [100, 192, 215],
        [ 81, 187, 209],
        [ 71, 186, 203]],

       [[ 67, 183, 200],
        [ 65, 182, 196],
        [ 63, 180, 193],
        ...,
        [100, 192, 212],
        [ 80, 188, 205],
        [ 72, 185, 200]],

       ...,

       [[ 99, 154, 140],
        [122, 168, 156],
        [104, 155, 149],
        ...,
        [149, 207, 222],
        [157, 212, 224],
        [165, 215, 227]],

       [[110, 153, 146],
        [135, 161, 148],
        [137, 161, 156],
        ...,
        [146, 208, 225],
        [149, 208, 222],
        [160, 213, 227]],

       [[103, 151, 142],
        [131, 163, 153],
        [139, 178, 167],
        ...,
        [138, 206, 219],
        [125, 200, 218],
        [141, 205, 220]]], dtype=uint8)]"
Image_6.jpg,418,370,310,219,1536,1024,728,589,310,daskShared_local/images/Image_6.jpg,6,"[array([[[ 14, 146, 245],
        [ 11, 143, 242],
        [ 14, 144, 242],
        ...,
        [ 13, 174, 244],
        [ 12, 169, 243],
        [ 15, 171, 246]],

       [[ 15, 146, 244],
        [ 15, 145, 243],
        [ 16, 146, 244],
        ...,
        [ 14, 174, 245],
        [ 15, 171, 245],
        [ 15, 169, 244]],

       [[ 13, 141, 242],
        [ 12, 140, 241],
        [ 13, 142, 243],
        ...,
        [ 20, 175, 250],
        [ 17, 172, 248],
        [ 16, 168, 246]],

       ...,

       [[  8,  60, 206],
        [ 11,  63, 209],
        [ 13,  65, 211],
        ...,
        [ 25,  42,  41],
        [ 27,  50,  52],
        [ 18,  62,  63]],

       [[  9,  61, 207],
        [ 10,  62, 208],
        [ 12,  62, 208],
        ...,
        [ 20,  33,  20],
        [ 34,  41,  29],
        [ 26,  28,  23]],

       [[  9,  61, 206],
        [ 10,  61, 206],
        [ 11,  62, 207],
        ...,
        [ 33,  33,  30],
        [ 27,  33,  25],
        [ 27,  30,  22]]], dtype=uint8)]"
Image_60.jpg,423,154,235,184,1000,667,658,338,235,daskShared_local/images/Image_60.jpg,60,"[array([[[ 32, 177, 250],
        [ 31, 175, 251],
        [ 29, 175, 251],
        ...,
        [  0, 139, 220],
        [  0, 140, 221],
        [  1, 140, 221]],

       [[ 37, 179, 253],
        [ 38, 179, 251],
        [ 37, 179, 251],
        ...,
        [  1, 139, 220],
        [  0, 139, 221],
        [  0, 139, 220]],

       [[ 41, 181, 253],
        [ 41, 182, 252],
        [ 38, 180, 251],
        ...,
        [  0, 137, 219],
        [  0, 138, 219],
        [  1, 139, 219]],

       ...,

       [[184, 165, 115],
        [190, 172, 113],
        [210, 197, 137],
        ...,
        [  0,  61, 104],
        [  0,  60, 103],
        [  1,  60, 103]],

       [[198, 183, 137],
        [192, 177, 131],
        [202, 190, 138],
        ...,
        [  1,  61, 105],
        [  0,  59, 103],
        [  0,  62, 103]],

       [[193, 176, 133],
        [197, 184, 148],
        [195, 180, 138],
        ...,
        [  0,  60, 103],
        [  0,  60, 104],
        [  0,  62, 103]]], dtype=uint8)]"
Image_600.jpg,601,221,308,240,924,924,909,461,308,daskShared_local/images/Image_600.jpg,600,"[array([[[  2, 143, 170],
        [  2, 143, 170],
        [  2, 143, 170],
        ...,
        [  2, 131, 162],
        [  2, 131, 162],
        [  2, 131, 162]],

       [[  2, 143, 170],
        [  2, 143, 170],
        [  2, 143, 170],
        ...,
        [  2, 131, 162],
        [  2, 131, 162],
        [  2, 131, 162]],

       [[  2, 143, 170],
        [  2, 143, 170],
        [  2, 143, 170],
        ...,
        [  2, 131, 162],
        [  2, 131, 162],
        [  2, 131, 162]],

       ...,

       [[ 86,  74,  52],
        [ 88,  76,  54],
        [ 83,  71,  49],
        ...,
        [121,  99,  34],
        [118,  97,  34],
        [111,  89,  35]],

       [[ 60,  48,  26],
        [ 70,  58,  36],
        [ 75,  63,  41],
        ...,
        [105,  91,  30],
        [103,  88,  30],
        [ 98,  82,  32]],

       [[ 48,  36,  14],
        [ 49,  37,  15],
        [ 49,  37,  15],
        ...,
        [101,  90,  29],
        [ 99,  88,  30],
        [ 96,  82,  33]]], dtype=uint8)]"
Image_601.jpg,608,221,390,427,1600,1070,998,648,427,daskShared_local/images/Image_601.jpg,601,"[array([[[ 22,  75, 145],
        [ 24,  74, 145],
        [ 24,  74, 145],
        ...,
        [ 28,  69, 133],
        [ 28,  69, 133],
        [ 28,  69, 133]],

       [[ 26,  73, 145],
        [ 24,  75, 142],
        [ 24,  75, 142],
        ...,
        [ 28,  69, 133],
        [ 28,  69, 133],
        [ 28,  69, 133]],

       [[ 28,  72, 145],
        [ 24,  75, 141],
        [ 24,  75, 141],
        ...,
        [ 28,  69, 133],
        [ 28,  69, 133],
        [ 28,  69, 133]],

       ...,

       [[151, 157, 149],
        [148, 156, 143],
        [137, 146, 136],
        ...,
        [147, 128, 103],
        [177, 159, 124],
        [170, 151, 116]],

       [[131, 133, 120],
        [119, 120, 108],
        [109, 111,  97],
        ...,
        [136, 120,  95],
        [153, 136,  98],
        [168, 146, 110]],

       [[123, 111,  84],
        [120, 112,  92],
        [112, 105,  85],
        ...,
        [109,  91,  58],
        [132, 109,  62],
        [161, 132,  87]]], dtype=uint8)]"
Image_602.jpg,998,148,239,319,1686,1216,1237,467,319,daskShared_local/images/Image_602.jpg,602,"[array([[[123, 182, 212],
        [125, 182, 212],
        [125, 182, 212],
        ...,
        [159, 201, 225],
        [159, 201, 225],
        [159, 201, 225]],

       [[124, 183, 213],
        [125, 182, 212],
        [125, 182, 212],
        ...,
        [159, 201, 225],
        [159, 201, 225],
        [159, 201, 225]],

       [[125, 184, 214],
        [124, 182, 212],
        [125, 182, 212],
        ...,
        [158, 200, 224],
        [158, 200, 224],
        [158, 200, 224]],

       ...,

       [[133, 176, 158],
        [101, 150, 132],
        [107, 156, 138],
        ...,
        [ 90, 166, 202],
        [ 90, 166, 202],
        [ 90, 166, 202]],

       [[155, 197, 181],
        [109, 168, 153],
        [ 92, 154, 138],
        ...,
        [ 85, 165, 202],
        [ 84, 164, 201],
        [ 85, 165, 202]],

       [[154, 195, 179],
        [139, 198, 184],
        [ 99, 161, 147],
        ...,
        [ 86, 166, 203],
        [ 89, 169, 206],
        [ 90, 170, 207]]], dtype=uint8)]"
Image_603.jpg,727,345,189,131,1600,1000,916,476,189,daskShared_local/images/Image_603.jpg,603,"[array([[[  0,  83, 169],
        [  0,  83, 169],
        [  0,  83, 169],
        ...,
        [  0,  84, 165],
        [  0,  84, 165],
        [  0,  84, 165]],

       [[  0,  83, 169],
        [  0,  83, 169],
        [  0,  83, 169],
        ...,
        [  0,  84, 165],
        [  0,  84, 165],
        [  0,  84, 165]],

       [[  0,  83, 169],
        [  0,  83, 169],
        [  0,  83, 169],
        ...,
        [  0,  84, 165],
        [  0,  84, 165],
        [  0,  84, 165]],

       ...,

       [[  3,  79, 126],
        [ 13,  94, 130],
        [ 43, 128, 154],
        ...,
        [213, 216, 205],
        [202, 213, 196],
        [201, 215, 196]],

       [[ 10,  95, 130],
        [ 61, 149, 174],
        [ 94, 186, 200],
        ...,
        [214, 216, 203],
        [207, 215, 200],
        [205, 218, 200]],

       [[ 81, 177, 201],
        [102, 200, 214],
        [ 52, 152, 155],
        ...,
        [213, 210, 198],
        [213, 214, 200],
        [211, 218, 202]]], dtype=uint8)]"
Image_604.jpg,761,274,349,295,1200,906,1110,569,349,daskShared_local/images/Image_604.jpg,604,"[array([[[ 58,  53,  70],
        [ 61,  59,  80],
        [ 92,  91, 117],
        ...,
        [ 16,  53,  72],
        [ 14,  52,  73],
        [ 12,  49,  70]],

       [[172, 164, 179],
        [188, 183, 202],
        [102, 100, 123],
        ...,
        [ 17,  53,  73],
        [ 15,  51,  73],
        [ 14,  52,  73]],

       [[173, 162, 172],
        [238, 230, 245],
        [179, 174, 194],
        ...,
        [ 18,  50,  71],
        [ 15,  51,  73],
        [ 13,  51,  73]],

       ...,

       [[ 99, 150, 171],
        [114, 164, 184],
        [ 96, 143, 163],
        ...,
        [ 13,  54,  74],
        [ 14,  54,  74],
        [ 17,  53,  73]],

       [[ 92, 137, 159],
        [102, 148, 172],
        [111, 155, 183],
        ...,
        [ 21,  48,  75],
        [ 17,  49,  72],
        [ 15,  51,  72]],

       [[106, 149, 169],
        [ 83, 125, 149],
        [ 79, 118, 145],
        ...,
        [ 21,  50,  76],
        [ 18,  53,  75],
        [ 17,  53,  74]]], dtype=uint8)]"
Image_605.jpg,1025,160,2563,2604,4608,3072,3588,2764,2604,daskShared_local/images/Image_605.jpg,605,"[array([[[ 31,  31,  29],
        [ 31,  31,  30],
        [ 32,  33,  31],
        ...,
        [132, 137, 125],
        [143, 145, 124],
        [152, 151, 122]],

       [[ 29,  28,  26],
        [ 30,  30,  30],
        [ 32,  34,  31],
        ...,
        [119, 125, 118],
        [131, 135, 120],
        [141, 143, 121]],

       [[ 28,  28,  26],
        [ 29,  30,  29],
        [ 36,  38,  38],
        ...,
        [110, 116, 110],
        [117, 124, 115],
        [126, 132, 118]],

       ...,

       [[ 98,  80,  51],
        [ 98,  80,  48],
        [ 98,  81,  50],
        ...,
        [158, 146, 105],
        [154, 143,  98],
        [153, 143,  91]],

       [[ 97,  77,  46],
        [ 97,  78,  44],
        [ 96,  78,  43],
        ...,
        [142, 123,  89],
        [133, 117,  91],
        [133, 122, 101]],

       [[ 93,  75,  47],
        [ 93,  75,  45],
        [ 93,  75,  42],
        ...,
        [144, 113,  59],
        [130, 104,  61],
        [133, 110,  79]]], dtype=uint8)]"
Image_606.jpg,395,318,146,135,800,600,541,453,146,daskShared_local/images/Image_606.jpg,606,"[array([[[218, 212, 186],
        [219, 212, 185],
        [217, 209, 181],
        ...,
        [  1,  87, 100],
        [  2,  88, 102],
        [  3,  89, 104]],

       [[216, 211, 184],
        [216, 211, 183],
        [215, 208, 179],
        ...,
        [  1,  89, 101],
        [  2,  91, 103],
        [  3,  92, 104]],

       [[217, 212, 185],
        [217, 212, 184],
        [216, 209, 180],
        ...,
        [  2,  94, 104],
        [  3,  96, 106],
        [  4,  96, 107]],

       ...,

       [[ 23,  50,  51],
        [ 23,  50,  51],
        [ 23,  50,  51],
        ...,
        [ 38, 116,  68],
        [ 42, 120,  70],
        [ 48, 126,  75]],

       [[ 22,  50,  51],
        [ 22,  50,  51],
        [ 23,  50,  51],
        ...,
        [ 56, 139,  84],
        [ 58, 142,  85],
        [ 66, 151,  94]],

       [[ 22,  50,  51],
        [ 22,  50,  51],
        [ 22,  50,  51],
        ...,
        [ 71, 158, 100],
        [ 70, 158, 102],
        [ 83, 171, 116]]], dtype=uint8)]"
Image_607.jpg,1172,1011,483,438,2592,1944,1655,1449,483,daskShared_local/images/Image_607.jpg,607,"[array([[[ 90,  68,  55],
        [108,  86,  74],
        [102,  79,  71],
        ...,
        [ 44,  96, 157],
        [ 34,  79, 140],
        [ 37,  77, 132]],

       [[109,  90,  79],
        [ 98,  79,  68],
        [102,  83,  72],
        ...,
        [ 42, 104, 166],
        [ 37,  86, 147],
        [ 41,  80, 136]],

       [[113,  94,  84],
        [103,  83,  73],
        [101,  81,  71],
        ...,
        [ 43, 108, 169],
        [ 47, 101, 161],
        [ 43,  89, 144]],

       ...,

       [[ 36, 122, 167],
        [ 37, 122, 168],
        [ 39, 123, 169],
        ...,
        [ 42, 126, 168],
        [ 39, 123, 165],
        [ 40, 124, 167]],

       [[ 36, 120, 166],
        [ 36, 120, 166],
        [ 41, 123, 170],
        ...,
        [ 40, 122, 167],
        [ 39, 121, 166],
        [ 40, 121, 167]],

       [[ 39, 121, 168],
        [ 40, 122, 168],
        [ 40, 121, 167],
        ...,
        [ 40, 119, 166],
        [ 44, 123, 171],
        [ 42, 121, 169]]], dtype=uint8)]"
Image_608.jpg,475,158,233,273,981,650,708,431,273,daskShared_local/images/Image_608.jpg,608,"[array([[[244, 244, 244],
        [244, 244, 244],
        [244, 244, 244],
        ...,
        [243, 243, 243],
        [243, 243, 243],
        [243, 243, 243]],

       [[244, 244, 244],
        [244, 244, 244],
        [244, 244, 244],
        ...,
        [242, 242, 242],
        [242, 242, 242],
        [242, 242, 242]],

       [[244, 244, 244],
        [244, 244, 244],
        [244, 244, 244],
        ...,
        [242, 242, 242],
        [242, 242, 242],
        [242, 242, 242]],

       ...,

       [[ 26,  93, 174],
        [ 27,  94, 173],
        [ 26,  93, 172],
        ...,
        [ 23,  91, 172],
        [ 22,  91, 169],
        [ 21,  90, 168]],

       [[ 26,  93, 174],
        [ 26,  93, 171],
        [ 24,  91, 169],
        ...,
        [ 22,  90, 171],
        [ 22,  90, 171],
        [ 22,  91, 171]],

       [[ 26,  93, 173],
        [ 27,  94, 173],
        [ 25,  92, 171],
        ...,
        [ 20,  88, 171],
        [ 23,  91, 173],
        [ 24,  92, 174]]], dtype=uint8)]"
Image_609.jpg,114,391,396,297,1715,1286,510,688,396,daskShared_local/images/Image_609.jpg,609,"[array([[[130, 140, 142],
        [135, 145, 148],
        [137, 148, 149],
        ...,
        [ 80,  83,  68],
        [ 84, 111,  88],
        [ 65, 110, 120]],

       [[127, 138, 139],
        [131, 141, 143],
        [137, 147, 149],
        ...,
        [ 66,  73,  90],
        [ 69,  71, 120],
        [ 69,  60, 131]],

       [[130, 137, 137],
        [134, 143, 145],
        [137, 146, 149],
        ...,
        [ 52,  46, 100],
        [ 59,  51, 104],
        [ 71,  70,  84]],

       ...,

       [[179, 189, 191],
        [178, 188, 190],
        [180, 189, 191],
        ...,
        [196, 205, 225],
        [198, 204, 226],
        [196, 203, 222]],

       [[173, 185, 186],
        [173, 185, 187],
        [178, 188, 191],
        ...,
        [191, 199, 221],
        [194, 197, 222],
        [197, 200, 223]],

       [[177, 183, 185],
        [179, 185, 188],
        [182, 189, 190],
        ...,
        [190, 195, 211],
        [191, 198, 216],
        [196, 201, 221]]], dtype=uint8)]"
Image_61.jpg,429,150,721,611,1152,763,1150,761,721,daskShared_local/images/Image_61.jpg,61,"[array([[[  0, 179, 235],
        [  0, 179, 235],
        [  1, 180, 236],
        ...,
        [  0, 183, 237],
        [  0, 183, 237],
        [  0, 183, 237]],

       [[  0, 179, 235],
        [  0, 179, 235],
        [  1, 180, 236],
        ...,
        [  0, 183, 237],
        [  0, 183, 237],
        [  0, 183, 237]],

       [[  0, 179, 235],
        [  0, 179, 235],
        [  1, 180, 236],
        ...,
        [  0, 183, 237],
        [  0, 183, 237],
        [  0, 183, 237]],

       ...,

       [[145, 171, 136],
        [147, 172, 140],
        [148, 174, 146],
        ...,
        [178, 197, 184],
        [161, 185, 170],
        [148, 177, 145]],

       [[150, 173, 144],
        [151, 174, 147],
        [151, 176, 152],
        ...,
        [156, 184, 177],
        [143, 177, 162],
        [133, 168, 140]],

       [[155, 178, 151],
        [156, 179, 153],
        [156, 179, 156],
        ...,
        [124, 161, 146],
        [128, 158, 136],
        [146, 172, 130]]], dtype=uint8)]"
Image_610.jpg,426,141,226,223,1024,686,652,364,226,daskShared_local/images/Image_610.jpg,610,"[array([[[ 31, 185, 239],
        [ 31, 185, 239],
        [ 30, 184, 238],
        ...,
        [  0, 156, 217],
        [  0, 156, 217],
        [  1, 157, 218]],

       [[ 29, 185, 239],
        [ 28, 184, 237],
        [ 27, 183, 236],
        ...,
        [  0, 156, 217],
        [  0, 156, 217],
        [  1, 157, 218]],

       [[ 24, 184, 236],
        [ 23, 183, 235],
        [ 22, 183, 235],
        ...,
        [  0, 156, 217],
        [  0, 156, 217],
        [  1, 157, 218]],

       ...,

       [[230, 226, 227],
        [230, 226, 225],
        [220, 215, 215],
        ...,
        [  2, 113, 182],
        [  3, 114, 183],
        [  4, 115, 184]],

       [[231, 226, 224],
        [219, 215, 213],
        [215, 211, 210],
        ...,
        [  4, 115, 184],
        [  3, 114, 183],
        [  2, 113, 182]],

       [[228, 223, 220],
        [217, 212, 209],
        [216, 213, 211],
        ...,
        [  4, 115, 184],
        [  2, 113, 182],
        [  0, 111, 180]]], dtype=uint8)]"
Image_611.jpg,364,23,149,123,550,380,513,146,149,daskShared_local/images/Image_611.jpg,611,"[array([[[ 74,  93, 149],
        [ 74,  93, 149],
        [ 74,  93, 149],
        ...,
        [ 68,  84, 143],
        [ 68,  84, 143],
        [ 70,  85, 144]],

       [[ 74,  93, 149],
        [ 74,  93, 149],
        [ 74,  93, 149],
        ...,
        [ 68,  84, 143],
        [ 68,  84, 143],
        [ 69,  85, 144]],

       [[ 74,  93, 149],
        [ 74,  93, 149],
        [ 74,  93, 149],
        ...,
        [ 69,  85, 144],
        [ 68,  84, 143],
        [ 69,  84, 143]],

       ...,

       [[139, 118,  93],
        [118,  98,  71],
        [112,  94,  63],
        ...,
        [ 66,  80, 141],
        [ 65,  79, 140],
        [ 63,  77, 138]],

       [[173, 152, 128],
        [146, 125, 100],
        [127, 110,  82],
        ...,
        [ 66,  80, 141],
        [ 65,  79, 140],
        [ 64,  78, 139]],

       [[194, 173, 149],
        [168, 148, 124],
        [145, 128, 102],
        ...,
        [ 66,  80, 141],
        [ 65,  79, 140],
        [ 64,  78, 139]]], dtype=uint8)]"
Image_612.png,241,33,83,78,589,295,324,111,83,daskShared_local/images/Image_612.png,612,"[array([[[  0, 167, 189],
        [  0, 167, 187],
        [  0, 167, 192],
        ...,
        [  0, 169, 195],
        [  0, 165, 191],
        [  0, 166, 192]],

       [[  0, 167, 189],
        [  0, 167, 187],
        [  0, 167, 192],
        ...,
        [  0, 169, 196],
        [  0, 166, 192],
        [  0, 167, 193]],

       [[  0, 168, 190],
        [  0, 168, 187],
        [  0, 168, 193],
        ...,
        [  0, 167, 193],
        [  0, 164, 189],
        [  0, 165, 191]],

       ...,

       [[118,  60,  41],
        [118,  59,  40],
        [119,  61,  43],
        ...,
        [185, 109,  90],
        [172,  94,  74],
        [177, 100,  81]],

       [[133,  73,  49],
        [134,  75,  49],
        [131,  71,  49],
        ...,
        [220, 135, 119],
        [199, 111,  95],
        [207, 121, 104]],

       [[127,  68,  46],
        [128,  69,  46],
        [126,  67,  46],
        ...,
        [207, 125, 108],
        [189, 105,  87],
        [196, 113,  95]]], dtype=uint8)]"
Image_613.jpg,512,78,147,202,1200,630,659,280,202,daskShared_local/images/Image_613.jpg,613,"[array([[[  0, 157, 224],
        [  0, 157, 224],
        [  2, 157, 224],
        ...,
        [  4, 156, 223],
        [  3, 155, 222],
        [  3, 155, 222]],

       [[  0, 157, 224],
        [  0, 157, 224],
        [  2, 157, 224],
        ...,
        [  4, 156, 223],
        [  3, 155, 222],
        [  3, 155, 222]],

       [[  4, 157, 224],
        [  4, 157, 224],
        [  4, 157, 224],
        ...,
        [  3, 155, 222],
        [  3, 155, 222],
        [  3, 155, 222]],

       ...,

       [[ 69,  54,  57],
        [ 62,  47,  50],
        [ 32,  17,  22],
        ...,
        [  0,  80, 117],
        [  0,  79, 116],
        [  0,  79, 116]],

       [[ 12,   2,   2],
        [ 26,  11,  15],
        [ 34,  22,  26],
        ...,
        [  0,  80, 117],
        [  0,  79, 116],
        [  0,  80, 117]],

       [[ 30,  15,  18],
        [ 44,  32,  34],
        [ 24,  12,  16],
        ...,
        [  0,  80, 117],
        [  0,  80, 117],
        [  2,  82, 119]]], dtype=uint8)]"
Image_614.jpg,965,254,200,158,1600,1280,1165,412,200,daskShared_local/images/Image_614.jpg,614,"[array([[[ 26, 114,  76],
        [ 34, 121,  86],
        [ 30, 115,  73],
        ...,
        [ 45, 160, 127],
        [ 36, 150, 116],
        [ 32, 144, 108]],

       [[ 19, 104,  75],
        [ 28, 114,  87],
        [ 33, 119,  84],
        ...,
        [ 53, 168, 137],
        [ 46, 160, 127],
        [ 45, 157, 121]],

       [[ 18, 100,  77],
        [ 23, 108,  85],
        [ 35, 118,  88],
        ...,
        [ 44, 163, 131],
        [ 53, 169, 136],
        [ 57, 171, 137]],

       ...,

       [[112,  80,  33],
        [106,  84,  38],
        [125,  98,  72],
        ...,
        [ 38, 178, 151],
        [ 36, 170, 137],
        [ 43, 168, 136]],

       [[140, 109,  63],
        [137, 119,  72],
        [133, 112,  81],
        ...,
        [ 47, 187, 160],
        [ 47, 181, 146],
        [ 50, 175, 141]],

       [[111,  73,  37],
        [145,  72,  55],
        [179, 105,  83],
        ...,
        [ 43, 162, 132],
        [ 29, 145, 109],
        [ 43, 155, 115]]], dtype=uint8)]"
Image_615.jpg,248,384,859,657,1512,1231,1107,1041,859,daskShared_local/images/Image_615.jpg,615,"[array([[[ 77,  89,  80],
        [ 78,  88,  80],
        [ 75,  86,  78],
        ...,
        [ 78, 115,  81],
        [ 77, 112,  79],
        [ 76, 108,  79]],

       [[ 77,  88,  80],
        [ 76,  86,  78],
        [ 74,  84,  76],
        ...,
        [ 83, 120,  84],
        [ 78, 112,  79],
        [ 77, 107,  79]],

       [[ 73,  85,  75],
        [ 75,  86,  76],
        [ 73,  85,  75],
        ...,
        [ 86, 121,  87],
        [ 81, 115,  82],
        [ 79, 110,  80]],

       ...,

       [[253, 235, 211],
        [254, 236, 212],
        [254, 237, 214],
        ...,
        [241, 219, 187],
        [241, 222, 189],
        [238, 220, 186]],

       [[253, 235, 210],
        [253, 234, 211],
        [249, 231, 208],
        ...,
        [245, 225, 199],
        [245, 229, 202],
        [246, 232, 205]],

       [[245, 228, 205],
        [226, 207, 189],
        [202, 185, 166],
        ...,
        [248, 231, 208],
        [251, 240, 219],
        [249, 242, 222]]], dtype=uint8)]"
Image_616.jpg,907,443,674,539,3008,2000,1581,982,674,daskShared_local/images/Image_616.jpg,616,"[array([[[148, 187, 194],
        [148, 187, 194],
        [148, 187, 194],
        ...,
        [135, 177, 189],
        [135, 177, 189],
        [135, 177, 189]],

       [[148, 187, 194],
        [148, 187, 194],
        [148, 187, 194],
        ...,
        [135, 177, 189],
        [135, 177, 189],
        [135, 177, 189]],

       [[148, 187, 194],
        [148, 187, 194],
        [148, 187, 194],
        ...,
        [136, 178, 190],
        [136, 178, 190],
        [136, 178, 190]],

       ...,

       [[118, 177, 183],
        [118, 174, 181],
        [120, 173, 181],
        ...,
        [ 59,  77,  82],
        [ 55,  73,  78],
        [ 60,  78,  83]],

       [[114, 173, 179],
        [114, 170, 177],
        [117, 170, 178],
        ...,
        [ 60,  79,  83],
        [ 58,  77,  81],
        [ 52,  71,  75]],

       [[111, 170, 176],
        [113, 169, 176],
        [115, 168, 176],
        ...,
        [ 82, 101, 105],
        [ 78,  97, 101],
        [ 71,  90,  94]]], dtype=uint8)]"
Image_617.jpg,409,128,121,93,759,422,530,221,121,daskShared_local/images/Image_617.jpg,617,"[array([[[127, 198, 200],
        [133, 204, 206],
        [149, 219, 221],
        ...,
        [ 28, 130, 146],
        [ 29, 132, 147],
        [ 30, 133, 148]],

       [[119, 190, 192],
        [124, 195, 197],
        [138, 208, 210],
        ...,
        [ 27, 130, 146],
        [ 28, 133, 148],
        [ 29, 134, 149]],

       [[ 97, 168, 170],
        [100, 171, 173],
        [109, 179, 181],
        ...,
        [ 23, 130, 146],
        [ 27, 136, 151],
        [ 28, 138, 153]],

       ...,

       [[  0, 156, 186],
        [  0, 156, 186],
        [  0, 156, 186],
        ...,
        [  2, 141, 164],
        [  1, 140, 163],
        [  1, 140, 163]],

       [[  0, 155, 185],
        [  0, 155, 185],
        [  0, 155, 185],
        ...,
        [  3, 140, 162],
        [  2, 140, 162],
        [  2, 139, 162]],

       [[  0, 154, 185],
        [  0, 154, 185],
        [  0, 154, 185],
        ...,
        [  3, 139, 162],
        [  3, 139, 161],
        [  3, 139, 161]]], dtype=uint8)]"
Image_618.jpg,225,186,157,171,500,559,382,357,171,daskShared_local/images/Image_618.jpg,618,"[array([[[118, 190, 187],
        [127, 191, 188],
        [129, 190, 186],
        ...,
        [125, 215, 201],
        [128, 215, 199],
        [129, 216, 200]],

       [[109, 183, 181],
        [118, 188, 185],
        [122, 188, 184],
        ...,
        [129, 213, 200],
        [132, 214, 200],
        [134, 217, 201]],

       [[103, 183, 183],
        [111, 187, 187],
        [114, 188, 187],
        ...,
        [137, 212, 202],
        [141, 214, 202],
        [143, 215, 203]],

       ...,

       [[  9,   1,   0],
        [ 10,   2,   0],
        [ 13,   5,   0],
        ...,
        [  0, 180, 181],
        [  1, 177, 175],
        [  1, 174, 170]],

       [[ 11,   1,   1],
        [ 12,   3,   1],
        [ 22,  12,   5],
        ...,
        [  1, 186, 192],
        [  3, 186, 189],
        [  3, 186, 188]],

       [[ 19,   3,   3],
        [ 21,   6,   6],
        [ 38,  24,  21],
        ...,
        [  3, 182, 189],
        [  4, 182, 187],
        [  4, 182, 186]]], dtype=uint8)]"
Image_619.jpg,620,314,157,142,1440,960,777,456,157,daskShared_local/images/Image_619.jpg,619,"[array([[[  0, 144, 205],
        [  0, 144, 205],
        [  0, 144, 205],
        ...,
        [  0, 144, 214],
        [  1, 145, 214],
        [  1, 144, 212]],

       [[  0, 143, 204],
        [  0, 143, 204],
        [  0, 143, 204],
        ...,
        [  0, 143, 213],
        [  1, 144, 213],
        [  1, 144, 212]],

       [[  0, 143, 204],
        [  0, 143, 204],
        [  0, 143, 204],
        ...,
        [  0, 144, 214],
        [  1, 144, 213],
        [  1, 144, 212]],

       ...,

       [[ 60,  82,  77],
        [ 58,  78,  73],
        [ 52,  70,  65],
        ...,
        [  0,  72, 109],
        [  0,  73, 110],
        [  0,  74, 112]],

       [[ 32,  57,  50],
        [ 27,  50,  42],
        [ 21,  42,  35],
        ...,
        [  0,  74, 111],
        [  1,  75, 112],
        [  0,  74, 112]],

       [[  9,  34,  26],
        [  7,  30,  22],
        [  7,  28,  20],
        ...,
        [  1,  75, 112],
        [  2,  76, 114],
        [  0,  76, 114]]], dtype=uint8)]"
Image_62.jpg,533,237,165,190,990,681,698,427,190,daskShared_local/images/Image_62.jpg,62,"[array([[[ 29,  23,  11],
        [ 32,  26,  14],
        [ 34,  28,  16],
        ...,
        [ 21,  21,   5],
        [ 26,  25,   7],
        [ 35,  33,  12]],

       [[ 29,  23,  11],
        [ 32,  26,  14],
        [ 34,  28,  16],
        ...,
        [ 17,  18,   1],
        [ 23,  22,   2],
        [ 32,  30,   7]],

       [[ 31,  25,  13],
        [ 33,  27,  15],
        [ 35,  29,  17],
        ...,
        [ 15,  16,   0],
        [ 22,  21,   0],
        [ 30,  28,   5]],

       ...,

       [[130, 124,  95],
        [148, 143, 111],
        [171, 165, 131],
        ...,
        [ 30,  36,  26],
        [ 32,  38,  26],
        [ 31,  37,  24]],

       [[103,  98,  68],
        [117, 112,  80],
        [154, 148, 115],
        ...,
        [ 24,  32,  21],
        [ 28,  35,  22],
        [ 27,  33,  19]],

       [[ 78,  71,  42],
        [ 92,  86,  54],
        [130, 124,  89],
        ...,
        [ 18,  26,  14],
        [ 22,  30,  17],
        [ 22,  28,  14]]], dtype=uint8)]"
Image_620.jpg,426,164,794,644,1500,1000,1220,808,794,daskShared_local/images/Image_620.jpg,620,"[array([[[  3,  55,  66],
        [  2,  54,  65],
        [  2,  54,  65],
        ...,
        [162, 151, 170],
        [170, 159, 175],
        [173, 164, 179]],

       [[  3,  55,  66],
        [  2,  54,  65],
        [  2,  54,  66],
        ...,
        [167, 157, 177],
        [164, 154, 174],
        [158, 150, 174]],

       [[  3,  55,  66],
        [  2,  54,  66],
        [  2,  54,  67],
        ...,
        [170, 161, 180],
        [150, 144, 167],
        [131, 125, 156]],

       ...,

       [[123, 135, 171],
        [138, 154, 187],
        [171, 184, 199],
        ...,
        [ 33,  61,  39],
        [ 34,  61,  40],
        [ 39,  64,  43]],

       [[153, 160, 174],
        [137, 149, 179],
        [155, 166, 196],
        ...,
        [ 35,  63,  41],
        [ 35,  63,  41],
        [ 38,  63,  41]],

       [[178, 181, 188],
        [154, 161, 181],
        [144, 151, 188],
        ...,
        [ 38,  66,  43],
        [ 37,  64,  42],
        [ 37,  63,  41]]], dtype=uint8)]"
Image_621.jpg,288,104,141,182,800,533,429,286,182,daskShared_local/images/Image_621.jpg,621,"[array([[[  2, 172, 207],
        [  2, 172, 207],
        [  2, 172, 207],
        ...,
        [  2, 170, 207],
        [  2, 170, 207],
        [  2, 170, 207]],

       [[  2, 172, 207],
        [  2, 172, 207],
        [  2, 172, 207],
        ...,
        [  2, 170, 207],
        [  2, 170, 207],
        [  2, 170, 207]],

       [[  2, 172, 207],
        [  2, 172, 207],
        [  2, 172, 207],
        ...,
        [  2, 170, 207],
        [  2, 170, 207],
        [  2, 170, 207]],

       ...,

       [[141, 108,  46],
        [140, 100,  53],
        [151, 105,  62],
        ...,
        [168, 121,  92],
        [215, 176, 128],
        [217, 181, 132]],

       [[134,  97,  40],
        [154, 112,  57],
        [188, 141,  83],
        ...,
        [ 79,  76,  52],
        [140, 123,  75],
        [180, 156, 110]],

       [[172, 130,  47],
        [187, 144,  45],
        [202, 154,  71],
        ...,
        [ 61,  35,  33],
        [ 89,  58,  31],
        [110,  83,  54]]], dtype=uint8)]"
Image_622.jpg,247,218,136,153,775,518,383,371,153,daskShared_local/images/Image_622.jpg,622,"[array([[[ 58,  59,  30],
        [ 43,  45,  25],
        [ 30,  31,  17],
        ...,
        [ 72,  42,   6],
        [ 82,  53,  15],
        [ 99,  70,  33]],

       [[ 55,  55,  27],
        [ 37,  36,  17],
        [ 41,  40,  25],
        ...,
        [ 96,  67,  28],
        [ 87,  58,  19],
        [ 95,  67,  28]],

       [[ 46,  43,  18],
        [ 47,  44,  24],
        [ 86,  82,  65],
        ...,
        [128,  98,  58],
        [115,  86,  45],
        [115,  86,  46]],

       ...,

       [[125,  89,  52],
        [138, 100,  62],
        [138,  98,  59],
        ...,
        [150, 108,  66],
        [149, 107,  65],
        [146, 103,  62]],

       [[117,  83,  47],
        [131,  94,  56],
        [131,  92,  54],
        ...,
        [148, 108,  64],
        [147, 106,  63],
        [144, 103,  60]],

       [[107,  76,  40],
        [122,  87,  50],
        [123,  85,  48],
        ...,
        [140, 101,  57],
        [139, 100,  56],
        [137,  98,  54]]], dtype=uint8)]"
Image_623.jpg,629,449,216,177,1024,672,845,626,216,daskShared_local/images/Image_623.jpg,623,"[array([[[118, 120, 134],
        [118, 122, 134],
        [118, 122, 134],
        ...,
        [105, 116, 106],
        [108, 116, 102],
        [123, 128, 111]],

       [[127, 130, 144],
        [127, 130, 144],
        [123, 128, 140],
        ...,
        [144, 153, 142],
        [134, 141, 127],
        [129, 133, 115]],

       [[132, 132, 140],
        [131, 129, 135],
        [124, 122, 128],
        ...,
        [159, 160, 157],
        [158, 157, 154],
        [148, 147, 143]],

       ...,

       [[ 37,  83, 139],
        [ 38,  85, 140],
        [ 38,  85, 139],
        ...,
        [ 13, 119, 228],
        [ 15, 120, 229],
        [ 16, 121, 230]],

       [[ 39,  87, 145],
        [ 39,  88, 145],
        [ 39,  87, 145],
        ...,
        [ 17, 122, 231],
        [ 18, 123, 232],
        [ 19, 121, 231]],

       [[ 41,  91, 152],
        [ 41,  91, 151],
        [ 40,  90, 149],
        ...,
        [ 19, 124, 233],
        [ 21, 123, 233],
        [ 17, 119, 229]]], dtype=uint8)]"
Image_624.jpg,215,120,118,87,598,325,333,207,118,daskShared_local/images/Image_624.jpg,624,"[array([[[ 75,  74,  48],
        [ 66,  67,  44],
        [ 38,  44,  32],
        ...,
        [107, 112, 103],
        [108, 116, 101],
        [109, 118, 100]],

       [[ 73,  76,  51],
        [ 68,  72,  51],
        [ 53,  60,  50],
        ...,
        [108, 113, 101],
        [109, 117,  99],
        [110, 118,  98]],

       [[ 69,  80,  62],
        [ 77,  87,  73],
        [100, 109, 105],
        ...,
        [111, 116,  96],
        [113, 119,  92],
        [113, 120,  91]],

       ...,

       [[ 67, 104,  67],
        [ 71, 112,  54],
        [ 82, 136,  14],
        ...,
        [  1,  72, 124],
        [  3,  74, 125],
        [  3,  75, 126]],

       [[ 44,  84,  44],
        [ 45,  90,  35],
        [ 47, 109,   9],
        ...,
        [  0,  76, 125],
        [  1,  76, 124],
        [  1,  76, 123]],

       [[ 36,  78,  37],
        [ 36,  83,  29],
        [ 36, 101,   7],
        ...,
        [  0,  78, 125],
        [  1,  76, 123],
        [  1,  76, 123]]], dtype=uint8)]"
Image_625.jpg,296,357,176,158,1024,683,472,515,176,daskShared_local/images/Image_625.jpg,625,"[array([[[224, 220, 195],
        [198, 195, 174],
        [174, 172, 155],
        ...,
        [ 78,  66,  58],
        [ 71,  58,  52],
        [ 63,  50,  44]],

       [[230, 228, 203],
        [212, 210, 189],
        [185, 183, 166],
        ...,
        [ 87,  78,  70],
        [ 81,  73,  65],
        [ 83,  75,  67]],

       [[231, 231, 205],
        [226, 225, 203],
        [204, 203, 186],
        ...,
        [103, 101,  91],
        [105, 104,  94],
        [106, 105,  96]],

       ...,

       [[  0, 108, 131],
        [  0, 108, 131],
        [  0, 108, 131],
        ...,
        [  0, 114, 140],
        [  0, 114, 140],
        [  1, 115, 141]],

       [[  0, 108, 131],
        [  0, 109, 132],
        [  0, 109, 132],
        ...,
        [  0, 114, 140],
        [  0, 114, 140],
        [  0, 114, 140]],

       [[  0, 109, 132],
        [  0, 109, 132],
        [  0, 109, 132],
        ...,
        [  0, 114, 140],
        [  0, 114, 140],
        [  0, 114, 140]]], dtype=uint8)]"
Image_626.jpg,378,160,121,121,900,600,499,281,121,daskShared_local/images/Image_626.jpg,626,"[array([[[ 67, 116, 178],
        [ 69, 118, 179],
        [ 74, 123, 184],
        ...,
        [156, 147, 149],
        [138, 133, 139],
        [131, 128, 135]],

       [[ 61, 115, 178],
        [ 64, 117, 180],
        [ 71, 123, 185],
        ...,
        [157, 148, 151],
        [141, 136, 142],
        [134, 131, 138]],

       [[ 46, 114, 178],
        [ 50, 116, 181],
        [ 62, 122, 187],
        ...,
        [160, 152, 155],
        [148, 142, 148],
        [143, 139, 146]],

       ...,

       [[  0,  75, 160],
        [  1,  76, 161],
        [  2,  78, 164],
        ...,
        [108,  80, 103],
        [112,  84, 107],
        [113,  85, 108]],

       [[  1,  74, 160],
        [  1,  76, 161],
        [  1,  79, 164],
        ...,
        [114,  84, 108],
        [113,  85, 108],
        [113,  85, 107]],

       [[  1,  74, 159],
        [  1,  76, 161],
        [  1,  79, 164],
        ...,
        [116,  86, 110],
        [114,  85, 108],
        [113,  85, 107]]], dtype=uint8)]"
Image_627.jpg,278,171,270,233,1000,541,548,404,270,daskShared_local/images/Image_627.jpg,627,"[array([[[  0, 120, 150],
        [  4, 127, 160],
        [ 21, 138, 173],
        ...,
        [ 35,  81,  96],
        [ 38,  85, 100],
        [ 38,  86, 105]],

       [[  0, 125, 158],
        [  7, 132, 168],
        [ 22, 140, 177],
        ...,
        [ 35,  82,  97],
        [ 39,  83, 100],
        [ 41,  83, 105]],

       [[  0, 130, 165],
        [  7, 136, 175],
        [ 19, 142, 181],
        ...,
        [ 38,  80, 102],
        [ 42,  82, 107],
        [ 41,  84, 111]],

       ...,

       [[  3,  46,  56],
        [  3,  38,  50],
        [  0,  31,  42],
        ...,
        [ 58,  98, 123],
        [ 43,  83, 108],
        [ 70, 110, 135]],

       [[  2,  49,  60],
        [  1,  39,  50],
        [  0,  33,  46],
        ...,
        [ 39,  80, 102],
        [ 45,  86, 108],
        [ 74, 115, 137]],

       [[  1,  55,  68],
        [  1,  45,  56],
        [  0,  38,  50],
        ...,
        [ 46,  87, 108],
        [ 42,  83, 103],
        [ 41,  82, 102]]], dtype=uint8)]"
Image_628.jpg,382,331,344,222,1904,803,726,553,344,daskShared_local/images/Image_628.jpg,628,"[array([[[  0,  80,  94],
        [  9,  84, 114],
        [  0,  89, 109],
        ...,
        [ 72, 159, 182],
        [ 49, 160, 175],
        [ 45, 162, 173]],

       [[  8,  65, 101],
        [  0,  78,  83],
        [  0,  83,  87],
        ...,
        [ 73, 177, 181],
        [ 89, 162, 170],
        [104, 140, 152]],

       [[  5,  60,  98],
        [  0,  69,  82],
        [  0,  73,  85],
        ...,
        [ 79, 173, 179],
        [ 82, 149, 157],
        [128, 165, 173]],

       ...,

       [[ 11, 140, 145],
        [ 11, 154, 156],
        [ 28, 160, 162],
        ...,
        [250, 245, 255],
        [238, 249, 255],
        [216, 245, 252]],

       [[  1, 141, 154],
        [  5, 139, 157],
        [ 26, 153, 168],
        ...,
        [216, 252, 253],
        [185, 233, 236],
        [149, 212, 217]],

       [[  0, 129, 156],
        [ 19, 136, 171],
        [ 18, 137, 167],
        ...,
        [153, 229, 228],
        [107, 192, 191],
        [ 93, 188, 189]]], dtype=uint8)]"
Image_629.jpg,452,234,161,163,900,586,613,397,163,daskShared_local/images/Image_629.jpg,629,"[array([[[150, 227, 237],
        [130, 220, 234],
        [101, 209, 225],
        ...,
        [ 98, 203, 227],
        [ 99, 203, 228],
        [ 99, 203, 228]],

       [[176, 233, 239],
        [167, 230, 240],
        [153, 224, 240],
        ...,
        [ 96, 203, 227],
        [ 98, 203, 227],
        [ 98, 203, 227]],

       [[182, 226, 232],
        [183, 226, 235],
        [184, 226, 239],
        ...,
        [ 93, 202, 227],
        [ 94, 202, 227],
        [ 95, 202, 227]],

       ...,

       [[  0,  38,  33],
        [  0,  42,  38],
        [  2,  48,  45],
        ...,
        [  1, 163, 209],
        [  1, 163, 209],
        [  1, 163, 209]],

       [[  0,  37,  32],
        [  2,  40,  36],
        [  6,  49,  47],
        ...,
        [  1, 163, 209],
        [  1, 163, 209],
        [  1, 163, 209]],

       [[  1,  42,  38],
        [  6,  49,  46],
        [ 16,  63,  60],
        ...,
        [  1, 163, 209],
        [  1, 163, 209],
        [  1, 163, 209]]], dtype=uint8)]"
Image_63.jpg,495,166,100,77,660,438,595,243,100,daskShared_local/images/Image_63.jpg,63,"[array([[[  2,  25,  64],
        [  2,  25,  64],
        [  1,  21,  61],
        ...,
        [  2,  14,  57],
        [  5,  21,  64],
        [  5,  21,  64]],

       [[  2,  25,  64],
        [  2,  25,  64],
        [  1,  21,  62],
        ...,
        [  2,  14,  57],
        [  5,  21,  64],
        [  5,  21,  64]],

       [[  7,  32,  71],
        [  7,  32,  71],
        [  4,  29,  69],
        ...,
        [  1,  16,  59],
        [  3,  22,  64],
        [  3,  22,  64]],

       ...,

       [[217, 197, 158],
        [216, 196, 157],
        [186, 149, 102],
        ...,
        [ 54,  42,  55],
        [ 56,  42,  57],
        [ 56,  42,  57]],

       [[195, 179, 142],
        [196, 179, 141],
        [204, 166, 123],
        ...,
        [ 51,  38,  54],
        [ 54,  40,  58],
        [ 54,  40,  58]],

       [[195, 179, 141],
        [195, 179, 141],
        [204, 167, 124],
        ...,
        [ 51,  37,  54],
        [ 54,  40,  58],
        [ 54,  40,  58]]], dtype=uint8)]"
Image_630.JPG,285,437,1424,1472,2560,1920,1709,1909,1472,daskShared_local/images/Image_630.JPG,630,"[array([[[ 72,  59,  31],
        [ 76,  63,  22],
        [ 74,  64,  23],
        ...,
        [179, 160, 122],
        [167, 149, 115],
        [152, 131,  96]],

       [[ 65,  56,  30],
        [ 65,  58,  29],
        [ 69,  62,  33],
        ...,
        [210, 196, 168],
        [201, 187, 161],
        [176, 164, 137]],

       [[ 63,  57,  31],
        [ 65,  58,  25],
        [ 71,  59,  26],
        ...,
        [225, 212, 184],
        [219, 205, 176],
        [203, 188, 161]],

       ...,

       [[ 75,  87,  28],
        [ 74,  85,  18],
        [ 73,  86,  21],
        ...,
        [ 89, 100,  20],
        [ 90,  97,  25],
        [ 90,  96,  29]],

       [[ 75,  87,  29],
        [ 74,  87,  18],
        [ 77,  86,  22],
        ...,
        [ 84,  99,  28],
        [ 89,  96,  29],
        [ 89,  97,  28]],

       [[ 81,  83,  25],
        [ 72,  86,  29],
        [ 70,  86,  24],
        ...,
        [ 81,  97,  27],
        [ 87,  98,  22],
        [ 87,  99,  26]]], dtype=uint8)]"
Image_631.jpg,2409,928,634,548,3840,2160,3043,1476,634,daskShared_local/images/Image_631.jpg,631,"[array([[[ 96,  74,  50],
        [139, 117,  95],
        [214, 193, 172],
        ...,
        [  4, 131, 176],
        [  5, 133, 178],
        [  2, 134, 177]],

       [[174, 152, 128],
        [192, 170, 148],
        [197, 175, 154],
        ...,
        [  5, 132, 175],
        [  6, 133, 177],
        [  1, 132, 176]],

       [[218, 196, 172],
        [213, 191, 169],
        [180, 159, 138],
        ...,
        [  5, 132, 173],
        [  3, 130, 173],
        [  1, 131, 175]],

       ...,

       [[  0, 149, 172],
        [  1, 147, 172],
        [  3, 145, 172],
        ...,
        [  0, 121, 164],
        [  1, 121, 164],
        [  2, 121, 162]],

       [[  0, 149, 170],
        [  0, 148, 170],
        [  1, 145, 170],
        ...,
        [  1, 121, 164],
        [  1, 120, 163],
        [  1, 120, 162]],

       [[  1, 151, 170],
        [  1, 149, 169],
        [  1, 146, 168],
        ...,
        [  1, 120, 163],
        [  1, 120, 163],
        [  1, 120, 162]]], dtype=uint8)]"
Image_632.jpg,107,77,86,64,475,264,193,141,86,daskShared_local/images/Image_632.jpg,632,"[array([[[23, 36, 54],
        [22, 35, 54],
        [23, 36, 53],
        ...,
        [24, 40, 64],
        [24, 40, 63],
        [24, 40, 63]],

       [[24, 36, 53],
        [23, 35, 53],
        [24, 37, 54],
        ...,
        [24, 40, 64],
        [24, 40, 63],
        [24, 40, 63]],

       [[21, 36, 54],
        [20, 35, 54],
        [21, 36, 53],
        ...,
        [24, 40, 64],
        [24, 40, 63],
        [24, 40, 63]],

       ...,

       [[11, 19, 29],
        [11, 19, 29],
        [11, 20, 29],
        ...,
        [47, 58, 59],
        [46, 57, 56],
        [46, 58, 57]],

       [[11, 19, 29],
        [12, 19, 29],
        [11, 20, 29],
        ...,
        [46, 57, 61],
        [45, 55, 61],
        [45, 56, 61]],

       [[11, 19, 29],
        [11, 19, 29],
        [11, 20, 29],
        ...,
        [47, 58, 61],
        [45, 56, 60],
        [46, 56, 60]]], dtype=uint8)]"
Image_633.jpg,388,80,113,78,580,435,501,158,113,daskShared_local/images/Image_633.jpg,633,"[array([[[ 76, 128, 126],
        [ 75, 127, 125],
        [ 70, 123, 121],
        ...,
        [ 83, 140, 141],
        [ 82, 141, 142],
        [ 82, 141, 142]],

       [[ 75, 126, 125],
        [ 74, 125, 123],
        [ 68, 121, 119],
        ...,
        [ 83, 140, 142],
        [ 83, 142, 143],
        [ 83, 142, 143]],

       [[ 70, 118, 118],
        [ 68, 117, 116],
        [ 60, 110, 109],
        ...,
        [ 85, 141, 143],
        [ 88, 145, 146],
        [ 88, 146, 147]],

       ...,

       [[121, 160, 141],
        [123, 162, 143],
        [134, 173, 154],
        ...,
        [107, 139, 116],
        [107, 139, 117],
        [107, 139, 118]],

       [[108, 147, 128],
        [113, 152, 134],
        [137, 176, 157],
        ...,
        [104, 136, 112],
        [105, 137, 114],
        [105, 137, 114]],

       [[104, 143, 125],
        [111, 150, 132],
        [137, 176, 158],
        ...,
        [103, 135, 112],
        [104, 136, 113],
        [104, 136, 114]]], dtype=uint8)]"
Image_634.jpg,328,35,130,82,623,200,458,117,130,daskShared_local/images/Image_634.jpg,634,"[array([[[  0, 163, 252],
        [  0, 163, 252],
        [  0, 163, 252],
        ...,
        [  0, 128, 255],
        [  0, 128, 255],
        [  0, 128, 255]],

       [[  0, 163, 252],
        [  0, 163, 252],
        [  0, 163, 252],
        ...,
        [  0, 128, 255],
        [  0, 128, 255],
        [  0, 128, 255]],

       [[  0, 163, 252],
        [  0, 163, 252],
        [  0, 163, 252],
        ...,
        [  0, 128, 255],
        [  0, 128, 255],
        [  0, 128, 255]],

       ...,

       [[ 53,  78,  51],
        [ 45,  70,  44],
        [ 30,  54,  29],
        ...,
        [  0,  97, 249],
        [  0,  97, 250],
        [  0,  97, 251]],

       [[ 55,  82,  49],
        [ 48,  74,  43],
        [ 36,  61,  32],
        ...,
        [  1,  99, 249],
        [  1,  98, 249],
        [  1,  98, 249]],

       [[ 57,  84,  48],
        [ 50,  77,  43],
        [ 39,  66,  34],
        ...,
        [  2,  99, 249],
        [  1,  99, 248],
        [  1,  99, 248]]], dtype=uint8)]"
Image_635.jpg,1282,636,198,163,2304,1536,1480,799,198,daskShared_local/images/Image_635.jpg,635,"[array([[[  0, 105, 150],
        [  0, 105, 150],
        [  0, 105, 150],
        ...,
        [  0, 108, 144],
        [  1, 109, 145],
        [  0, 110, 143]],

       [[  0, 105, 150],
        [  0, 105, 150],
        [  0, 104, 149],
        ...,
        [  0, 107, 143],
        [  1, 108, 144],
        [  1, 108, 144]],

       [[  0, 105, 150],
        [  0, 104, 149],
        [  0, 104, 149],
        ...,
        [  1, 105, 142],
        [  1, 105, 142],
        [  1, 105, 142]],

       ...,

       [[ 97, 142, 139],
        [119, 167, 153],
        [161, 208, 192],
        ...,
        [ 20,  19,  35],
        [ 22,  21,  35],
        [ 25,  24,  38]],

       [[139, 187, 171],
        [139, 194, 173],
        [139, 195, 184],
        ...,
        [ 22,  21,  37],
        [ 22,  21,  35],
        [ 23,  22,  36]],

       [[125, 178, 182],
        [103, 156, 170],
        [ 85, 138, 156],
        ...,
        [ 23,  25,  40],
        [ 24,  27,  42],
        [ 26,  32,  46]]], dtype=uint8)]"
Image_636.jpg,491,164,105,81,660,438,596,245,105,daskShared_local/images/Image_636.jpg,636,"[array([[[  7,  29,  69],
        [  7,  29,  69],
        [  9,  31,  70],
        ...,
        [  7,  21,  57],
        [ 19,  36,  71],
        [ 20,  38,  72]],

       [[  7,  29,  69],
        [  7,  29,  69],
        [  8,  30,  70],
        ...,
        [  7,  20,  57],
        [ 18,  35,  70],
        [ 20,  37,  72]],

       [[  5,  27,  68],
        [  5,  27,  68],
        [  3,  25,  65],
        ...,
        [  4,  14,  52],
        [ 12,  28,  64],
        [ 14,  30,  66]],

       ...,

       [[ 50,  62,  80],
        [ 49,  61,  77],
        [ 46,  50,  58],
        ...,
        [ 51,  38,  61],
        [ 38,  27,  50],
        [ 37,  26,  49]],

       [[180, 186, 164],
        [180, 185, 164],
        [180, 182, 161],
        ...,
        [ 49,  37,  55],
        [ 42,  31,  49],
        [ 42,  31,  48]],

       [[195, 200, 174],
        [195, 200, 173],
        [195, 197, 172],
        ...,
        [ 49,  37,  54],
        [ 43,  32,  48],
        [ 42,  31,  48]]], dtype=uint8)]"
Image_637.jpg,453,273,162,175,850,567,615,448,175,daskShared_local/images/Image_637.jpg,637,"[array([[[145, 101,  86],
        [191, 133, 113],
        [171, 119, 102],
        ...,
        [ 43,  55,  80],
        [ 32,  48,  68],
        [ 21,  39,  59]],

       [[162, 103,  88],
        [187, 121, 103],
        [170, 111,  99],
        ...,
        [ 42,  54,  81],
        [ 37,  53,  73],
        [ 26,  43,  61]],

       [[206, 142, 115],
        [183, 122,  97],
        [151,  88,  75],
        ...,
        [ 41,  56,  81],
        [ 35,  52,  71],
        [ 30,  45,  68]],

       ...,

       [[ 10, 126, 237],
        [ 10, 125, 236],
        [  9, 123, 235],
        ...,
        [ 11, 129, 235],
        [ 11, 129, 235],
        [  9, 127, 233]],

       [[  9, 125, 236],
        [ 11, 125, 237],
        [ 10, 124, 236],
        ...,
        [ 11, 129, 235],
        [ 11, 129, 235],
        [ 10, 128, 234]],

       [[  8, 124, 235],
        [ 10, 125, 237],
        [ 10, 124, 236],
        ...,
        [ 10, 128, 234],
        [  9, 127, 233],
        [  9, 127, 233]]], dtype=uint8)]"
Image_638.jpg,649,105,370,507,2000,1000,1019,612,507,daskShared_local/images/Image_638.jpg,638,"[array([[[  0, 155, 209],
        [  0, 155, 209],
        [  0, 155, 209],
        ...,
        [150, 199, 242],
        [151, 198, 242],
        [152, 199, 243]],

       [[  0, 155, 209],
        [  0, 155, 209],
        [  0, 155, 209],
        ...,
        [150, 199, 242],
        [151, 199, 242],
        [152, 199, 243]],

       [[  1, 156, 210],
        [  1, 156, 210],
        [  0, 155, 209],
        ...,
        [150, 199, 242],
        [152, 199, 243],
        [152, 199, 243]],

       ...,

       [[  0, 142, 202],
        [  0, 143, 203],
        [  0, 142, 202],
        ...,
        [116, 103,  89],
        [143, 132, 119],
        [154, 142, 126]],

       [[  0, 143, 203],
        [  0, 142, 202],
        [  0, 142, 202],
        ...,
        [140, 127, 115],
        [174, 159, 147],
        [173, 156, 142]],

       [[  0, 143, 203],
        [  0, 142, 202],
        [  0, 142, 202],
        ...,
        [127, 114, 104],
        [166, 151, 142],
        [169, 153, 144]]], dtype=uint8)]"
Image_639.jpg,965,388,215,200,2000,1000,1180,588,215,daskShared_local/images/Image_639.jpg,639,"[array([[[205, 179, 144],
        [203, 177, 143],
        [198, 173, 137],
        ...,
        [211, 192, 159],
        [213, 193, 158],
        [216, 194, 157]],

       [[203, 180, 148],
        [202, 179, 147],
        [198, 176, 143],
        ...,
        [213, 193, 160],
        [215, 193, 159],
        [218, 194, 158]],

       [[202, 182, 148],
        [202, 183, 149],
        [200, 181, 148],
        ...,
        [213, 192, 160],
        [212, 190, 156],
        [212, 190, 153]],

       ...,

       [[ 94,  94,  90],
        [102, 102,  99],
        [ 96,  97,  94],
        ...,
        [198, 170, 131],
        [204, 176, 139],
        [201, 175, 138]],

       [[109, 109, 101],
        [103, 103,  95],
        [ 99,  99,  93],
        ...,
        [186, 160, 124],
        [198, 172, 136],
        [209, 183, 148]],

       [[113, 113, 101],
        [110, 110, 100],
        [108, 108,  99],
        ...,
        [188, 164, 129],
        [188, 162, 127],
        [196, 170, 135]]], dtype=uint8)]"
Image_64.jpg,381,159,125,128,900,600,506,287,128,daskShared_local/images/Image_64.jpg,64,"[array([[[101, 128, 182],
        [ 98, 127, 181],
        [ 91, 126, 180],
        ...,
        [140, 133, 138],
        [152, 144, 146],
        [157, 149, 150]],

       [[ 96, 128, 183],
        [ 94, 127, 183],
        [ 88, 126, 181],
        ...,
        [140, 132, 136],
        [155, 145, 147],
        [161, 151, 152]],

       [[ 87, 128, 187],
        [ 85, 127, 186],
        [ 80, 126, 184],
        ...,
        [138, 128, 133],
        [158, 145, 148],
        [168, 153, 156]],

       ...,

       [[  0,  78, 165],
        [  0,  79, 166],
        [  0,  80, 167],
        ...,
        [134, 103, 121],
        [134, 105, 124],
        [135, 105, 125]],

       [[  1,  77, 165],
        [  1,  78, 166],
        [  1,  79, 167],
        ...,
        [133, 103, 121],
        [134, 103, 122],
        [134, 104, 123]],

       [[  1,  77, 165],
        [  1,  78, 166],
        [  1,  79, 166],
        ...,
        [132, 103, 121],
        [133, 103, 121],
        [134, 103, 122]]], dtype=uint8)]"
Image_640.png,364,58,194,145,600,600,558,203,194,daskShared_local/images/Image_640.png,640,"[array([[[  0, 100, 248],
        [  0, 100, 248],
        [  0, 100, 248],
        ...,
        [  0, 118, 254],
        [  0, 118, 254],
        [  0, 118, 254]],

       [[  0, 100, 248],
        [  0, 100, 248],
        [  1, 101, 249],
        ...,
        [  0, 118, 254],
        [  0, 118, 254],
        [  0, 118, 254]],

       [[  0, 102, 249],
        [  0, 102, 249],
        [  0, 102, 249],
        ...,
        [  0, 118, 254],
        [  0, 118, 254],
        [  0, 118, 254]],

       ...,

       [[183, 158, 102],
        [167, 162,  99],
        [180, 167,  95],
        ...,
        [244, 253, 174],
        [245, 253, 172],
        [245, 246, 188]],

       [[204, 179, 120],
        [200, 191, 119],
        [211, 203, 148],
        ...,
        [238, 249, 172],
        [244, 250, 190],
        [247, 252, 196]],

       [[225, 251, 236],
        [212, 223, 231],
        [189, 173, 113],
        ...,
        [240, 250, 190],
        [240, 246, 197],
        [241, 250, 183]]], dtype=uint8)]"
Image_641.jpg,470,121,108,82,685,360,578,203,108,daskShared_local/images/Image_641.jpg,641,"[array([[[  0, 107, 149],
        [  0, 107, 149],
        [  0, 107, 149],
        ...,
        [  0, 101, 145],
        [  0, 101, 145],
        [  0, 101, 145]],

       [[  0, 107, 149],
        [  0, 107, 149],
        [  0, 106, 148],
        ...,
        [  0, 101, 145],
        [  0, 101, 145],
        [  0, 101, 145]],

       [[  0, 106, 148],
        [  0, 106, 148],
        [  0, 105, 147],
        ...,
        [  0, 101, 145],
        [  0, 101, 145],
        [  0, 101, 145]],

       ...,

       [[  1,  85, 121],
        [  1,  85, 121],
        [  2,  86, 122],
        ...,
        [  0,  83, 119],
        [  0,  83, 119],
        [  0,  83, 119]],

       [[  1,  85, 121],
        [  1,  85, 121],
        [  2,  86, 122],
        ...,
        [  0,  83, 119],
        [  0,  83, 119],
        [  0,  83, 119]],

       [[  1,  85, 121],
        [  1,  85, 121],
        [  2,  86, 122],
        ...,
        [  0,  83, 119],
        [  0,  83, 119],
        [  0,  83, 119]]], dtype=uint8)]"
Image_642.jpg,629,342,340,326,2361,1176,969,668,340,daskShared_local/images/Image_642.jpg,642,"[array([[[ 11, 144, 196],
        [ 10, 143, 195],
        [  9, 144, 196],
        ...,
        [ 36, 170, 206],
        [ 39, 172, 210],
        [ 42, 172, 211]],

       [[  6, 143, 195],
        [ 11, 149, 201],
        [  8, 148, 199],
        ...,
        [ 41, 168, 207],
        [ 42, 168, 208],
        [ 41, 167, 208]],

       [[ 11, 148, 200],
        [ 11, 148, 200],
        [ 10, 150, 201],
        ...,
        [ 42, 170, 209],
        [ 44, 170, 210],
        [ 44, 170, 211]],

       ...,

       [[  6, 174, 238],
        [  9, 177, 240],
        [  7, 177, 239],
        ...,
        [ 15,  46,  51],
        [ 19,  52,  57],
        [ 21,  58,  61]],

       [[  6, 174, 241],
        [  5, 173, 238],
        [  8, 177, 243],
        ...,
        [  8,  62,  60],
        [ 11,  68,  66],
        [ 17,  72,  71]],

       [[  6, 176, 239],
        [  1, 171, 232],
        [  6, 176, 238],
        ...,
        [  7,  61,  58],
        [ 13,  68,  67],
        [ 18,  72,  72]]], dtype=uint8)]"
Image_643.jpg,395,3,82,69,530,180,477,72,82,daskShared_local/images/Image_643.jpg,643,"[array([[[  3,  24,  73],
        [  3,  26,  75],
        [  2,  20,  70],
        ...,
        [ 46,  58,  99],
        [ 37,  51,  93],
        [ 41,  54,  96]],

       [[  1,  22,  72],
        [  1,  24,  73],
        [  2,  20,  70],
        ...,
        [ 51,  64, 104],
        [ 38,  52,  96],
        [ 43,  57,  99]],

       [[  4,  25,  74],
        [  4,  28,  76],
        [  3,  20,  70],
        ...,
        [ 41,  53,  95],
        [ 37,  51,  90],
        [ 39,  52,  92]],

       ...,

       [[220, 212, 179],
        [223, 214, 180],
        [216, 209, 177],
        ...,
        [ 40,  32,  49],
        [ 42,  35,  45],
        [ 42,  34,  47]],

       [[214, 203, 163],
        [207, 192, 154],
        [225, 217, 175],
        ...,
        [ 46,  37,  57],
        [ 35,  27,  41],
        [ 39,  31,  47]],

       [[217, 207, 171],
        [215, 203, 167],
        [220, 213, 176],
        ...,
        [ 43,  35,  53],
        [ 39,  31,  43],
        [ 41,  33,  47]]], dtype=uint8)]"
Image_644.jpg,210,451,177,180,2015,1510,387,631,180,daskShared_local/images/Image_644.jpg,644,"[array([[[ 23,  14,  12],
        [ 28,  18,  16],
        [ 52,  42,  40],
        ...,
        [ 10,  10,   5],
        [ 11,  11,   7],
        [ 12,  11,   7]],

       [[ 25,  19,  16],
        [ 29,  23,  21],
        [ 52,  47,  44],
        ...,
        [ 15,  14,  10],
        [ 19,  18,  14],
        [ 23,  20,  16]],

       [[ 26,  24,  22],
        [ 27,  26,  23],
        [ 45,  43,  41],
        ...,
        [ 20,  16,  12],
        [ 26,  22,  19],
        [ 30,  25,  22]],

       ...,

       [[159, 153, 137],
        [183, 177, 161],
        [186, 180, 164],
        ...,
        [146, 156, 158],
        [138, 148, 150],
        [139, 148, 151]],

       [[157, 151, 135],
        [185, 179, 164],
        [188, 182, 166],
        ...,
        [138, 148, 150],
        [136, 145, 148],
        [138, 146, 149]],

       [[148, 142, 128],
        [174, 168, 154],
        [177, 171, 157],
        ...,
        [137, 147, 149],
        [137, 147, 149],
        [139, 147, 150]]], dtype=uint8)]"
Image_645.png,377,185,321,280,900,600,698,465,321,daskShared_local/images/Image_645.png,645,"[array([[[115, 119, 107],
        [110, 106, 102],
        [113, 113, 108],
        ...,
        [ 18, 152, 182],
        [ 27, 146, 180],
        [ 21, 150, 185]],

       [[125, 106,  87],
        [127, 109,  98],
        [129, 110, 101],
        ...,
        [ 17, 148, 181],
        [ 37, 146, 184],
        [ 28, 150, 181]],

       [[ 97,  81,  80],
        [108,  90,  93],
        [ 99,  89,  84],
        ...,
        [ 24, 150, 181],
        [ 26, 149, 179],
        [ 22, 149, 179]],

       ...,

       [[ 30,  88,  84],
        [ 28,  80,  78],
        [ 26,  74,  78],
        ...,
        [ 77, 151, 141],
        [ 78, 151, 145],
        [ 79, 151, 144]],

       [[ 26,  69,  63],
        [ 26,  72,  66],
        [ 23,  69,  59],
        ...,
        [ 80, 149, 150],
        [ 86, 146, 149],
        [ 84, 146, 145]],

       [[ 28,  68,  64],
        [ 24,  70,  67],
        [ 24,  67,  63],
        ...,
        [ 84, 148, 150],
        [ 87, 148, 148],
        [ 88, 147, 146]]], dtype=uint8)]"
Image_646.jpg,492,370,204,167,1024,678,696,537,204,daskShared_local/images/Image_646.jpg,646,"[array([[[ 97,  67,  72],
        [122,  89,  92],
        [165, 121, 112],
        ...,
        [120, 136, 159],
        [129, 140, 158],
        [144, 152, 161]],

       [[109,  79,  81],
        [106,  81,  85],
        [133, 107, 110],
        ...,
        [ 90,  89,  95],
        [161, 155, 124],
        [205, 190, 142]],

       [[104,  83,  82],
        [114,  94,  96],
        [120,  94, 100],
        ...,
        [157, 143, 108],
        [175, 157, 111],
        [151, 123,  77]],

       ...,

       [[241, 233, 204],
        [234, 227, 203],
        [232, 222, 197],
        ...,
        [232, 215, 170],
        [244, 223, 174],
        [237, 219, 173]],

       [[248, 234, 203],
        [239, 226, 194],
        [239, 223, 189],
        ...,
        [235, 213, 164],
        [251, 229, 179],
        [243, 227, 176]],

       [[250, 241, 210],
        [237, 230, 198],
        [237, 220, 186],
        ...,
        [242, 214, 165],
        [248, 217, 163],
        [245, 215, 163]]], dtype=uint8)]"
Image_647.jpg,136,55,601,574,1000,750,737,629,601,daskShared_local/images/Image_647.jpg,647,"[array([[[ 33, 138, 124],
        [ 31, 116, 100],
        [ 32,  97,  82],
        ...,
        [  4,   8,   7],
        [  4,   8,   7],
        [  5,   8,   7]],

       [[ 36, 138, 117],
        [ 34, 114,  93],
        [ 30,  87,  73],
        ...,
        [  4,   8,   7],
        [  4,   8,   7],
        [  5,   8,   7]],

       [[ 36, 109,  84],
        [ 34,  89,  75],
        [ 23,  71,  71],
        ...,
        [  5,   5,   5],
        [  5,   5,   5],
        [  5,   5,   5]],

       ...,

       [[134, 118,  93],
        [145, 133, 108],
        [151, 140, 109],
        ...,
        [ 20,  31,  24],
        [ 18,  29,  23],
        [ 17,  27,  22]],

       [[119, 100,  73],
        [131, 114,  90],
        [135, 120,  90],
        ...,
        [ 16,  27,  21],
        [ 15,  26,  22],
        [ 17,  25,  22]],

       [[110,  92,  57],
        [114,  97,  66],
        [117, 101,  67],
        ...,
        [ 18,  26,  16],
        [ 18,  26,  14],
        [ 18,  26,  14]]], dtype=uint8)]"
Image_648.jpg,185,103,364,275,1024,670,549,378,364,daskShared_local/images/Image_648.jpg,648,"[array([[[ 23,  30,  41],
        [ 32,  43,  54],
        [ 41,  53,  70],
        ...,
        [ 52, 158, 176],
        [ 42, 153, 158],
        [ 14, 128, 122]],

       [[ 26,  34,  44],
        [ 18,  32,  41],
        [ 33,  49,  63],
        ...,
        [ 17, 110, 124],
        [ 19, 119, 118],
        [ 32, 133, 124]],

       [[ 47,  57,  67],
        [ 32,  46,  55],
        [ 35,  53,  65],
        ...,
        [ 29,  99, 117],
        [  8,  85,  89],
        [ 37, 116, 112]],

       ...,

       [[ 81, 213, 235],
        [ 71, 219, 233],
        [ 57, 178, 193],
        ...,
        [219, 250, 238],
        [221, 252, 249],
        [131, 186, 194]],

       [[ 64, 195, 217],
        [ 51, 188, 208],
        [ 52, 162, 184],
        ...,
        [190, 240, 237],
        [194, 246, 244],
        [171, 233, 241]],

       [[ 70, 206, 223],
        [ 47, 180, 194],
        [ 51, 156, 172],
        ...,
        [136, 206, 231],
        [155, 224, 250],
        [154, 229, 255]]], dtype=uint8)]"
Image_649.jpg,38,81,245,164,800,600,283,245,245,daskShared_local/images/Image_649.jpg,649,"[array([[[ 14, 158, 211],
        [ 10, 155, 206],
        [  6, 153, 204],
        ...,
        [ 21, 175, 225],
        [ 24, 178, 229],
        [ 27, 181, 233]],

       [[ 12, 157, 210],
        [ 13, 158, 210],
        [ 10, 155, 207],
        ...,
        [ 25, 176, 229],
        [ 22, 176, 228],
        [ 22, 177, 229]],

       [[  8, 154, 206],
        [ 34, 180, 231],
        [ 29, 174, 226],
        ...,
        [ 27, 179, 231],
        [ 19, 175, 226],
        [ 18, 175, 228]],

       ...,

       [[ 76, 151, 120],
        [ 70, 147, 113],
        [ 70, 148, 110],
        ...,
        [ 75,  25,  10],
        [ 85,  38,  21],
        [ 88,  47,  25]],

       [[ 71, 146, 112],
        [ 69, 145, 110],
        [ 70, 148, 111],
        ...,
        [ 90,  47,  30],
        [ 88,  48,  30],
        [ 88,  51,  31]],

       [[ 71, 143, 107],
        [ 68, 144, 108],
        [ 67, 145, 110],
        ...,
        [110,  76,  56],
        [103,  71,  50],
        [ 88,  57,  37]]], dtype=uint8)]"
Image_65.jpg,409,131,121,91,759,422,530,222,121,daskShared_local/images/Image_65.jpg,65,"[array([[[122, 193, 195],
        [126, 196, 198],
        [137, 207, 209],
        ...,
        [ 30, 147, 165],
        [ 26, 144, 161],
        [ 24, 143, 160]],

       [[134, 204, 206],
        [137, 208, 210],
        [148, 218, 219],
        ...,
        [ 29, 147, 165],
        [ 24, 143, 161],
        [ 21, 141, 159]],

       [[164, 234, 236],
        [167, 237, 239],
        [175, 245, 247],
        ...,
        [ 25, 148, 166],
        [ 16, 141, 159],
        [ 13, 138, 156]],

       ...,

       [[  0, 153, 184],
        [  0, 153, 184],
        [  0, 154, 185],
        ...,
        [  4, 139, 161],
        [  3, 138, 160],
        [  3, 138, 160]],

       [[  0, 153, 185],
        [  0, 153, 186],
        [  0, 153, 186],
        ...,
        [  3, 138, 159],
        [  3, 138, 159],
        [  3, 138, 158]],

       [[  0, 152, 186],
        [  0, 153, 186],
        [  0, 153, 187],
        ...,
        [  3, 138, 159],
        [  3, 138, 158],
        [  2, 137, 158]]], dtype=uint8)]"
Image_650.jpg,212,36,225,172,900,521,437,208,225,daskShared_local/images/Image_650.jpg,650,"[array([[[ 17,  59, 171],
        [ 17,  59, 171],
        [ 17,  59, 171],
        ...,
        [ 33,  70, 185],
        [ 33,  70, 185],
        [ 33,  70, 185]],

       [[ 16,  58, 170],
        [ 16,  58, 170],
        [ 16,  58, 170],
        ...,
        [ 33,  70, 185],
        [ 33,  70, 185],
        [ 33,  70, 185]],

       [[ 16,  58, 170],
        [ 16,  58, 170],
        [ 16,  58, 170],
        ...,
        [ 33,  70, 185],
        [ 33,  70, 185],
        [ 33,  70, 185]],

       ...,

       [[  0,  55, 138],
        [  0,  55, 141],
        [  0,  54, 144],
        ...,
        [219, 235, 233],
        [220, 237, 235],
        [219, 235, 234]],

       [[  0,  56, 137],
        [  0,  55, 141],
        [  0,  55, 145],
        ...,
        [215, 231, 231],
        [217, 233, 233],
        [216, 232, 232]],

       [[  0,  57, 136],
        [  0,  56, 140],
        [  0,  56, 144],
        ...,
        [216, 232, 231],
        [215, 231, 230],
        [214, 230, 229]]], dtype=uint8)]"
Image_651.jpg,165,355,269,163,1200,900,434,518,269,daskShared_local/images/Image_651.jpg,651,"[array([[[ 45, 211, 188],
        [ 45, 202, 182],
        [ 47, 185, 174],
        ...,
        [ 21, 144, 144],
        [ 17, 137, 142],
        [ 11, 145, 147]],

       [[ 59, 191, 176],
        [ 40, 191, 170],
        [ 34, 186, 166],
        ...,
        [ 29, 145, 148],
        [ 23, 140, 144],
        [ 18, 150, 150]],

       [[ 43, 180, 165],
        [ 26, 180, 159],
        [ 26, 182, 161],
        ...,
        [ 18, 145, 146],
        [ 18, 146, 145],
        [ 23, 157, 153]],

       ...,

       [[ 38,  65,  67],
        [ 46,  69,  71],
        [ 38,  67,  74],
        ...,
        [183, 157, 108],
        [161, 130,  87],
        [147, 118,  82]],

       [[ 31,  53,  56],
        [ 41,  66,  71],
        [ 43,  74,  73],
        ...,
        [193, 190, 155],
        [185, 169, 132],
        [173, 158, 117]],

       [[ 22,  45,  53],
        [ 23,  50,  62],
        [ 30,  60,  69],
        ...,
        [169, 166, 148],
        [206, 205, 186],
        [212, 214, 189]]], dtype=uint8)]"
Image_652.jpg,93,87,76,60,450,300,169,147,76,daskShared_local/images/Image_652.jpg,652,"[array([[[  1,  86, 205],
        [  1,  86, 205],
        [  1,  86, 205],
        ...,
        [239, 222,   1],
        [234, 222,   0],
        [237, 222,   1]],

       [[  0,  86, 205],
        [  0,  86, 205],
        [  0,  86, 205],
        ...,
        [242, 225,   0],
        [238, 224,   0],
        [240, 224,   0]],

       [[  1,  86, 205],
        [  1,  86, 205],
        [  1,  86, 205],
        ...,
        [237, 220,   1],
        [232, 220,   0],
        [235, 220,   1]],

       ...,

       [[  0,  86, 195],
        [  0,  86, 195],
        [  0,  86, 195],
        ...,
        [178, 165, 142],
        [209, 200, 179],
        [190, 179, 157]],

       [[  0,  86, 195],
        [  0,  86, 195],
        [  0,  86, 195],
        ...,
        [202, 191, 166],
        [241, 234, 213],
        [217, 208, 184]],

       [[  0,  86, 195],
        [  0,  86, 195],
        [  0,  86, 195],
        ...,
        [187, 175, 152],
        [222, 214, 192],
        [201, 191, 168]]], dtype=uint8)]"
Image_653.jpg,266,202,188,122,1000,667,454,324,188,daskShared_local/images/Image_653.jpg,653,"[array([[[  0,  68, 171],
        [  2,  71, 175],
        [  1,  68, 175],
        ...,
        [  2,  50, 135],
        [  1,  47, 132],
        [  0,  46, 132]],

       [[  0,  67, 171],
        [  1,  70, 174],
        [  3,  67, 173],
        ...,
        [  3,  49, 136],
        [  1,  49, 134],
        [  1,  49, 134]],

       [[  2,  69, 173],
        [  0,  69, 173],
        [  3,  68, 172],
        ...,
        [  2,  48, 134],
        [  2,  48, 133],
        [  1,  48, 131]],

       ...,

       [[ 81, 138, 120],
        [ 83, 143, 119],
        [ 84, 140, 115],
        ...,
        [194, 193, 135],
        [183, 190, 125],
        [188, 192, 139]],

       [[ 79, 136, 126],
        [ 87, 147, 131],
        [ 85, 138, 122],
        ...,
        [177, 175, 116],
        [148, 141,  85],
        [185, 182, 136]],

       [[ 91, 145, 129],
        [ 94, 150, 127],
        [ 86, 141, 120],
        ...,
        [141, 145,  87],
        [105, 111,  74],
        [176, 177, 121]]], dtype=uint8)]"
Image_654.jpg,395,184,97,52,800,600,492,236,97,daskShared_local/images/Image_654.jpg,654,"[array([[[ 65, 103, 121],
        [ 65, 103, 121],
        [ 67, 104, 126],
        ...,
        [ 86,  97, 169],
        [ 86,  96, 163],
        [ 86,  96, 163]],

       [[ 65, 103, 121],
        [ 65, 103, 121],
        [ 67, 104, 126],
        ...,
        [ 87,  97, 169],
        [ 86,  96, 163],
        [ 86,  96, 163]],

       [[ 64, 106, 123],
        [ 64, 106, 123],
        [ 66, 106, 127],
        ...,
        [ 82,  95, 177],
        [ 82,  93, 171],
        [ 82,  93, 171]],

       ...,

       [[102, 111, 137],
        [102, 111, 137],
        [100, 109, 138],
        ...,
        [ 17, 131, 245],
        [ 19, 131, 246],
        [ 19, 131, 246]],

       [[107, 116, 145],
        [107, 116, 145],
        [105, 114, 145],
        ...,
        [ 15, 130, 243],
        [ 16, 130, 245],
        [ 16, 130, 245]],

       [[107, 116, 144],
        [107, 116, 144],
        [105, 114, 145],
        ...,
        [ 15, 130, 243],
        [ 16, 130, 245],
        [ 16, 130, 245]]], dtype=uint8)]"
Image_655.jpg,622,226,132,99,1000,667,754,325,132,daskShared_local/images/Image_655.jpg,655,"[array([[[ 56, 124, 122],
        [ 53, 122, 120],
        [ 50, 120, 118],
        ...,
        [  2,  86,  97],
        [  1,  88,  99],
        [  1,  88, 100]],

       [[ 56, 123, 121],
        [ 53, 120, 118],
        [ 50, 117, 116],
        ...,
        [  4,  88, 100],
        [  3,  89, 101],
        [  2,  89, 101]],

       [[ 56, 120, 119],
        [ 53, 117, 115],
        [ 48, 113, 111],
        ...,
        [  9,  92, 104],
        [  6,  92, 105],
        [  5,  91, 104]],

       ...,

       [[155, 156, 122],
        [152, 153, 119],
        [145, 146, 112],
        ...,
        [ 87, 170, 177],
        [ 87, 169, 176],
        [ 88, 169, 176]],

       [[135, 137, 104],
        [135, 137, 103],
        [134, 136, 102],
        ...,
        [ 86, 169, 174],
        [ 86, 168, 173],
        [ 87, 168, 173]],

       [[122, 125,  92],
        [124, 127,  93],
        [127, 128,  94],
        ...,
        [ 86, 168, 173],
        [ 85, 167, 172],
        [ 86, 167, 172]]], dtype=uint8)]"
Image_656.jpg,1625,543,830,615,4100,2660,2455,1158,830,daskShared_local/images/Image_656.jpg,656,"[array([[[187, 174, 157],
        [192, 179, 167],
        [190, 177, 168],
        ...,
        [156, 144, 128],
        [157, 145, 129],
        [156, 145, 128]],

       [[188, 174, 158],
        [191, 179, 165],
        [191, 178, 166],
        ...,
        [158, 148, 133],
        [155, 142, 126],
        [153, 140, 124]],

       [[192, 177, 166],
        [193, 181, 169],
        [193, 179, 168],
        ...,
        [158, 148, 133],
        [158, 145, 129],
        [153, 140, 124]],

       ...,

       [[ 52,  37,  31],
        [ 52,  37,  33],
        [ 51,  36,  31],
        ...,
        [218, 226, 240],
        [228, 238, 245],
        [225, 233, 245]],

       [[ 55,  40,  35],
        [ 54,  39,  34],
        [ 53,  38,  33],
        ...,
        [223, 232, 241],
        [235, 243, 250],
        [225, 234, 242]],

       [[ 55,  40,  34],
        [ 55,  40,  34],
        [ 55,  40,  35],
        ...,
        [228, 236, 241],
        [221, 230, 240],
        [212, 221, 233]]], dtype=uint8)]"
Image_657.jpg,438,368,215,220,1024,683,653,588,220,daskShared_local/images/Image_657.jpg,657,"[array([[[ 70,  63,  67],
        [109,  96,  97],
        [110,  87,  85],
        ...,
        [ 49,  38,  34],
        [ 55,  45,  39],
        [ 50,  41,  34]],

       [[ 76,  67,  69],
        [138, 122, 123],
        [125, 103,  99],
        ...,
        [ 53,  42,  38],
        [ 51,  42,  35],
        [ 46,  37,  30]],

       [[ 68,  57,  57],
        [ 59,  43,  42],
        [ 74,  52,  48],
        ...,
        [ 48,  35,  32],
        [ 49,  38,  32],
        [ 49,  38,  32]],

       ...,

       [[127, 108,  58],
        [210, 186, 139],
        [230, 201, 159],
        ...,
        [210, 153, 105],
        [220, 174, 125],
        [239, 222, 166]],

       [[162, 131,  80],
        [215, 187, 138],
        [229, 206, 157],
        ...,
        [183, 129,  95],
        [179, 123,  88],
        [225, 193, 149]],

       [[162, 119,  76],
        [235, 199, 154],
        [172, 145,  98],
        ...,
        [246, 203, 178],
        [239, 188, 161],
        [241, 206, 169]]], dtype=uint8)]"
Image_658.jpg,230,18,245,232,980,500,475,250,245,daskShared_local/images/Image_658.jpg,658,"[array([[[122, 182, 254],
        [121, 182, 254],
        [116, 179, 254],
        ...,
        [112, 175, 253],
        [108, 171, 250],
        [ 92, 155, 237]],

       [[124, 181, 254],
        [125, 184, 255],
        [126, 186, 255],
        ...,
        [112, 176, 255],
        [111, 174, 254],
        [106, 170, 247]],

       [[126, 182, 255],
        [133, 186, 253],
        [139, 189, 252],
        ...,
        [111, 176, 255],
        [111, 174, 254],
        [115, 179, 252]],

       ...,

       [[ 99, 180, 208],
        [ 64, 148, 175],
        [ 44, 134, 166],
        ...,
        [ 63,  89,  96],
        [ 55,  69,  73],
        [ 46,  57,  57]],

       [[ 66, 155, 190],
        [ 49, 141, 176],
        [ 65, 157, 186],
        ...,
        [ 51,  72,  75],
        [ 55,  65,  63],
        [ 53,  63,  61]],

       [[ 58, 143, 183],
        [ 44, 143, 183],
        [ 62, 154, 193],
        ...,
        [ 66,  87,  85],
        [ 57,  71,  66],
        [ 45,  47,  50]]], dtype=uint8)]"
Image_659.jpg,554,99,282,289,1024,770,836,388,289,daskShared_local/images/Image_659.jpg,659,"[array([[[  1, 111, 186],
        [  1, 111, 186],
        [  1, 111, 186],
        ...,
        [ 50,  68,  75],
        [ 48,  68,  75],
        [ 76, 101, 108]],

       [[  1, 110, 184],
        [  2, 111, 184],
        [  3, 112, 185],
        ...,
        [ 57,  74,  82],
        [ 64,  83,  90],
        [ 85, 105, 114]],

       [[  4, 112, 185],
        [  3, 111, 184],
        [  4, 112, 185],
        ...,
        [ 45,  61,  70],
        [ 60,  78,  86],
        [ 66,  84,  93]],

       ...,

       [[ 74,  82,  75],
        [ 43,  49,  44],
        [ 45,  51,  44],
        ...,
        [ 33,  32,  30],
        [ 37,  33,  31],
        [ 40,  35,  34]],

       [[102, 108, 101],
        [ 57,  63,  59],
        [ 49,  54,  48],
        ...,
        [ 34,  33,  31],
        [ 40,  36,  35],
        [ 43,  38,  38]],

       [[ 93,  97,  88],
        [ 61,  66,  60],
        [ 47,  52,  46],
        ...,
        [ 39,  36,  35],
        [ 44,  39,  38],
        [ 50,  44,  44]]], dtype=uint8)]"
Image_66.jpg,474,159,234,268,981,650,708,427,268,daskShared_local/images/Image_66.jpg,66,"[array([[[244, 244, 244],
        [244, 244, 244],
        [244, 244, 244],
        ...,
        [243, 243, 243],
        [243, 243, 243],
        [243, 243, 243]],

       [[244, 244, 244],
        [244, 244, 244],
        [244, 244, 244],
        ...,
        [242, 242, 242],
        [242, 242, 242],
        [242, 242, 242]],

       [[244, 244, 244],
        [244, 244, 244],
        [244, 244, 244],
        ...,
        [242, 242, 242],
        [242, 242, 242],
        [242, 242, 242]],

       ...,

       [[ 33, 100, 176],
        [ 29,  95, 171],
        [ 29,  95, 173],
        ...,
        [ 22,  91, 169],
        [ 22,  91, 169],
        [ 23,  91, 172]],

       [[ 27,  94, 173],
        [ 27,  94, 173],
        [ 28,  95, 175],
        ...,
        [ 22,  91, 170],
        [ 24,  92, 172],
        [ 25,  93, 174]],

       [[ 28,  95, 174],
        [ 27,  94, 173],
        [ 28,  95, 176],
        ...,
        [ 22,  90, 173],
        [ 23,  91, 174],
        [ 24,  92, 173]]], dtype=uint8)]"
Image_660.jpg,804,331,154,126,1536,1024,958,457,154,daskShared_local/images/Image_660.jpg,660,"[array([[[ 40, 124, 205],
        [ 43, 124, 207],
        [ 47, 124, 209],
        ...,
        [ 46, 123, 213],
        [ 46, 123, 213],
        [ 47, 124, 214]],

       [[ 45, 122, 206],
        [ 43, 123, 209],
        [ 43, 124, 212],
        ...,
        [ 45, 122, 212],
        [ 46, 123, 213],
        [ 46, 123, 213]],

       [[ 51, 120, 208],
        [ 46, 122, 214],
        [ 39, 124, 217],
        ...,
        [ 45, 122, 212],
        [ 45, 122, 212],
        [ 45, 122, 212]],

       ...,

       [[ 17, 116, 203],
        [ 17, 117, 203],
        [ 15, 117, 202],
        ...,
        [ 15, 114, 203],
        [ 15, 115, 203],
        [ 14, 115, 204]],

       [[ 18, 115, 202],
        [ 17, 116, 203],
        [ 16, 116, 202],
        ...,
        [ 15, 115, 203],
        [ 14, 114, 203],
        [ 13, 113, 203]],

       [[ 19, 115, 202],
        [ 18, 116, 203],
        [ 17, 116, 203],
        ...,
        [ 14, 114, 202],
        [ 13, 113, 202],
        [ 12, 112, 202]]], dtype=uint8)]"
Image_661.jpg,333,22,623,533,1190,595,956,555,623,daskShared_local/images/Image_661.jpg,661,"[array([[[191, 219, 233],
        [187, 217, 232],
        [188, 217, 234],
        ...,
        [203, 216, 206],
        [201, 215, 205],
        [201, 214, 207]],

       [[197, 225, 239],
        [195, 223, 238],
        [198, 224, 237],
        ...,
        [201, 217, 207],
        [202, 216, 205],
        [201, 214, 207]],

       [[194, 222, 237],
        [192, 221, 236],
        [194, 222, 237],
        ...,
        [202, 217, 208],
        [202, 216, 205],
        [201, 214, 207]],

       ...,

       [[186,  64, 110],
        [173,  53,  99],
        [162,  41,  87],
        ...,
        [ 97,  45,  42],
        [ 95,  43,  37],
        [105,  62,  52]],

       [[192,  58, 110],
        [191,  55, 107],
        [187,  51, 102],
        ...,
        [ 93,  42,  35],
        [114,  75,  66],
        [152, 141, 125]],

       [[189,  53, 104],
        [202,  60, 114],
        [201,  51, 107],
        ...,
        [129, 107,  90],
        [165, 161, 145],
        [182, 187, 176]]], dtype=uint8)]"
Image_662.jpg,429,150,723,610,1152,763,1152,760,723,daskShared_local/images/Image_662.jpg,662,"[array([[[  0, 179, 235],
        [  0, 179, 235],
        [  0, 179, 235],
        ...,
        [  0, 184, 238],
        [  0, 184, 238],
        [  0, 183, 237]],

       [[  0, 179, 235],
        [  0, 179, 235],
        [  0, 179, 235],
        ...,
        [  0, 183, 237],
        [  0, 183, 237],
        [  0, 183, 237]],

       [[  0, 179, 235],
        [  0, 179, 235],
        [  0, 179, 235],
        ...,
        [  0, 183, 237],
        [  0, 183, 237],
        [  0, 183, 237]],

       ...,

       [[143, 170, 134],
        [144, 171, 136],
        [146, 172, 142],
        ...,
        [180, 199, 186],
        [159, 184, 166],
        [149, 177, 143]],

       [[148, 172, 142],
        [149, 173, 144],
        [150, 175, 149],
        ...,
        [159, 185, 176],
        [145, 179, 157],
        [134, 170, 139]],

       [[154, 178, 149],
        [154, 177, 151],
        [154, 178, 154],
        ...,
        [134, 170, 159],
        [125, 158, 139],
        [138, 168, 131]]], dtype=uint8)]"
Image_663.jpg,119,155,364,283,1152,768,483,438,364,daskShared_local/images/Image_663.jpg,663,"[array([[[180, 233, 224],
        [180, 233, 224],
        [182, 233, 225],
        ...,
        [152, 226, 221],
        [151, 225, 219],
        [150, 224, 219]],

       [[181, 233, 224],
        [181, 234, 224],
        [182, 233, 224],
        ...,
        [147, 223, 219],
        [144, 223, 218],
        [142, 222, 217]],

       [[182, 234, 224],
        [182, 234, 225],
        [183, 234, 224],
        ...,
        [145, 219, 218],
        [141, 221, 217],
        [140, 221, 218]],

       ...,

       [[ 99, 181, 191],
        [100, 183, 191],
        [100, 183, 191],
        ...,
        [ 90, 118, 129],
        [ 91, 123, 134],
        [ 93, 124, 131]],

       [[100, 179, 192],
        [101, 181, 190],
        [101, 181, 190],
        ...,
        [ 88, 115, 126],
        [ 81, 115, 126],
        [ 85, 121, 128]],

       [[101, 179, 192],
        [103, 181, 191],
        [102, 181, 191],
        ...,
        [ 83, 112, 123],
        [ 83, 117, 129],
        [ 85, 120, 128]]], dtype=uint8)]"
Image_664.jpg,100,262,147,112,900,600,247,374,147,daskShared_local/images/Image_664.jpg,664,"[array([[[ 0, 77, 86],
        [ 0, 74, 83],
        [ 0, 72, 81],
        ...,
        [ 0, 80, 91],
        [ 0, 82, 92],
        [ 0, 86, 96]],

       [[ 2, 82, 89],
        [ 1, 80, 88],
        [ 1, 77, 86],
        ...,
        [ 0, 80, 92],
        [ 0, 82, 93],
        [ 1, 85, 96]],

       [[ 6, 90, 96],
        [ 6, 90, 96],
        [ 6, 86, 94],
        ...,
        [ 1, 82, 94],
        [ 1, 82, 94],
        [ 2, 85, 96]],

       ...,

       [[ 0, 66, 76],
        [ 0, 65, 77],
        [ 0, 65, 77],
        ...,
        [ 8, 37, 35],
        [ 9, 38, 36],
        [10, 39, 38]],

       [[ 0, 66, 75],
        [ 0, 66, 76],
        [ 0, 65, 77],
        ...,
        [ 8, 37, 35],
        [ 9, 38, 36],
        [10, 39, 37]],

       [[ 0, 66, 75],
        [ 0, 66, 75],
        [ 0, 66, 76],
        ...,
        [ 9, 38, 36],
        [ 9, 38, 36],
        [10, 39, 37]]], dtype=uint8)]"
Image_665.png,211,6,363,426,860,460,574,432,426,daskShared_local/images/Image_665.png,665,"[array([[[ 54,  59,  54],
        [ 76,  80,  64],
        [ 82,  83,  56],
        ...,
        [ 16, 218, 204],
        [ 14, 215, 208],
        [ 17, 219, 214]],

       [[ 55,  60,  54],
        [ 59,  62,  55],
        [ 66,  68,  54],
        ...,
        [ 17, 197, 194],
        [ 13, 212, 209],
        [  7, 207, 204]],

       [[ 51,  58,  51],
        [ 57,  61,  55],
        [ 59,  62,  53],
        ...,
        [ 17, 221, 219],
        [ 10, 195, 199],
        [ 19, 173, 187]],

       ...,

       [[ 65, 116, 121],
        [ 66, 117, 120],
        [ 67, 117, 118],
        ...,
        [ 44, 164, 180],
        [ 44, 164, 179],
        [ 45, 166, 180]],

       [[ 58, 108, 113],
        [ 67, 119, 123],
        [ 70, 123, 125],
        ...,
        [ 45, 167, 180],
        [ 46, 167, 179],
        [ 52, 172, 183]],

       [[ 65, 116, 120],
        [ 66, 118, 122],
        [ 65, 120, 122],
        ...,
        [ 46, 174, 186],
        [ 45, 177, 184],
        [ 78, 184, 189]]], dtype=uint8)]"
Image_666.jpg,881,523,217,201,1920,1200,1098,724,217,daskShared_local/images/Image_666.jpg,666,"[array([[[  0, 113, 111],
        [  2, 115, 113],
        [  2, 115, 113],
        ...,
        [  2, 124, 122],
        [  0, 121, 118],
        [  0, 121, 118]],

       [[  0, 110, 111],
        [  3, 113, 114],
        [  5, 115, 116],
        ...,
        [  0, 118, 118],
        [  1, 119, 119],
        [  3, 123, 121]],

       [[  1, 108, 111],
        [  2, 110, 113],
        [  5, 113, 116],
        ...,
        [  1, 117, 117],
        [  2, 117, 117],
        [  6, 122, 122]],

       ...,

       [[108,  97,  78],
        [100,  87,  67],
        [107,  92,  69],
        ...,
        [ 65,  35,   9],
        [ 70,  41,  14],
        [ 73,  46,  22]],

       [[ 91,  83,  64],
        [110,  99,  79],
        [112,  99,  77],
        ...,
        [ 53,  26,   1],
        [ 62,  37,  12],
        [ 79,  57,  35]],

       [[ 71,  63,  44],
        [ 94,  83,  62],
        [120, 107,  85],
        ...,
        [ 55,  33,   9],
        [ 51,  29,   8],
        [ 77,  59,  38]]], dtype=uint8)]"
Image_667.jpg,865,197,166,123,1600,1200,1031,320,166,daskShared_local/images/Image_667.jpg,667,"[array([[[  7, 175, 211],
        [  5, 173, 209],
        [  6, 174, 210],
        ...,
        [ 18, 183, 215],
        [ 17, 182, 214],
        [ 21, 186, 218]],

       [[  7, 175, 211],
        [  5, 173, 209],
        [  4, 172, 208],
        ...,
        [ 20, 185, 217],
        [ 20, 185, 217],
        [ 22, 187, 219]],

       [[  6, 174, 210],
        [  3, 171, 207],
        [  2, 170, 206],
        ...,
        [ 22, 187, 219],
        [ 22, 187, 219],
        [ 23, 188, 220]],

       ...,

       [[  4, 148, 182],
        [  4, 148, 182],
        [  4, 148, 182],
        ...,
        [ 47,  83,  86],
        [ 39,  76,  80],
        [ 38,  77,  82]],

       [[  4, 148, 182],
        [  5, 149, 183],
        [  5, 149, 183],
        ...,
        [ 45,  83,  88],
        [ 35,  75,  80],
        [ 33,  74,  80]],

       [[  2, 146, 180],
        [  4, 148, 182],
        [  5, 149, 183],
        ...,
        [ 53,  92,  99],
        [ 38,  79,  85],
        [ 33,  73,  81]]], dtype=uint8)]"
Image_668.jpg,500,72,161,145,1024,335,661,217,161,daskShared_local/images/Image_668.jpg,668,"[array([[[  1, 202, 230],
        [  2, 203, 229],
        [  3, 204, 229],
        ...,
        [  1, 178, 220],
        [  1, 178, 220],
        [  1, 178, 220]],

       [[  0, 201, 230],
        [  0, 203, 230],
        [  2, 204, 230],
        ...,
        [  0, 177, 219],
        [  0, 177, 219],
        [  0, 177, 219]],

       [[  0, 203, 231],
        [  0, 202, 230],
        [  1, 202, 230],
        ...,
        [  0, 176, 218],
        [  0, 176, 218],
        [  0, 176, 218]],

       ...,

       [[131, 133,  79],
        [130, 136,  80],
        [125, 134,  79],
        ...,
        [194, 200, 162],
        [192, 201, 164],
        [191, 202, 165]],

       [[144, 146,  80],
        [143, 148,  82],
        [137, 144,  82],
        ...,
        [190, 196, 155],
        [189, 198, 158],
        [187, 197, 159]],

       [[159, 167,  82],
        [163, 171,  89],
        [162, 169,  97],
        ...,
        [193, 196, 149],
        [194, 198, 152],
        [190, 194, 150]]], dtype=uint8)]"
Image_669.jpg,180,386,208,271,1536,1028,388,657,271,daskShared_local/images/Image_669.jpg,669,"[array([[[172, 206, 205],
        [172, 205, 205],
        [166, 203, 203],
        ...,
        [ 87, 136, 114],
        [101, 139, 120],
        [104, 135, 117]],

       [[162, 200, 200],
        [162, 203, 202],
        [160, 198, 201],
        ...,
        [ 89, 128, 111],
        [ 88, 132, 112],
        [ 99, 137, 117]],

       [[159, 201, 201],
        [154, 199, 198],
        [156, 197, 199],
        ...,
        [ 90, 134, 112],
        [104, 139, 120],
        [107, 138, 122]],

       ...,

       [[139, 166, 160],
        [156, 174, 152],
        [172, 179, 130],
        ...,
        [105, 129, 113],
        [107, 129, 115],
        [109, 127, 115]],

       [[151, 175, 167],
        [170, 186, 163],
        [177, 180, 131],
        ...,
        [ 96, 117, 102],
        [104, 123, 109],
        [110, 127, 115]],

       [[172, 186, 170],
        [180, 189, 170],
        [180, 193, 155],
        ...,
        [ 95, 114,  99],
        [107, 125, 111],
        [109, 126, 115]]], dtype=uint8)]"
Image_67.jpg,403,313,246,216,1500,1000,649,529,246,daskShared_local/images/Image_67.jpg,67,"[array([[[  0, 130, 152],
        [  0, 131, 153],
        [  0, 131, 154],
        ...,
        [  2, 113, 132],
        [  1, 113, 132],
        [  0, 112, 130]],

       [[  0, 137, 157],
        [  0, 135, 156],
        [  0, 134, 155],
        ...,
        [  7, 125, 141],
        [  8, 126, 142],
        [  4, 121, 137]],

       [[  2, 145, 165],
        [  1, 143, 163],
        [  0, 139, 160],
        ...,
        [  6, 131, 143],
        [  6, 131, 143],
        [  7, 129, 142]],

       ...,

       [[ 78, 111,  91],
        [ 76, 111,  93],
        [ 84, 123, 106],
        ...,
        [160, 155,  93],
        [128, 121,  59],
        [114, 104,  43]],

       [[ 64,  94,  74],
        [ 67, 100,  82],
        [ 77, 114,  97],
        ...,
        [177, 170, 107],
        [131, 122,  60],
        [ 92,  78,  19]],

       [[ 51,  80,  58],
        [ 62,  95,  76],
        [ 68, 104,  87],
        ...,
        [140, 131,  69],
        [142, 131,  70],
        [105,  90,  31]]], dtype=uint8)]"
Image_670.jpg,583,81,230,179,1068,601,813,260,230,daskShared_local/images/Image_670.jpg,670,"[array([[[  0,  72, 255],
        [  0,  71, 254],
        [  0,  71, 254],
        ...,
        [  0,  87, 255],
        [  0,  87, 255],
        [  0,  87, 255]],

       [[  0,  72, 255],
        [  0,  71, 254],
        [  0,  71, 254],
        ...,
        [  0,  87, 255],
        [  0,  87, 255],
        [  0,  87, 255]],

       [[  0,  72, 255],
        [  0,  72, 255],
        [  0,  72, 255],
        ...,
        [  0,  87, 255],
        [  0,  87, 255],
        [  0,  87, 255]],

       ...,

       [[122, 106,  82],
        [121,  95,  85],
        [140, 108, 101],
        ...,
        [212, 224, 198],
        [216, 224, 199],
        [219, 224, 195]],

       [[152, 139, 124],
        [115,  93,  87],
        [139, 112, 108],
        ...,
        [211, 225, 195],
        [215, 224, 196],
        [217, 224, 193]],

       [[129, 118, 106],
        [153, 138, 122],
        [127, 108,  91],
        ...,
        [210, 225, 191],
        [213, 225, 192],
        [216, 222, 194]]], dtype=uint8)]"
Image_671.jpg,310,308,143,130,966,642,453,438,143,daskShared_local/images/Image_671.jpg,671,"[array([[[ 24, 206, 219],
        [ 21, 206, 219],
        [ 17, 205, 215],
        ...,
        [ 84,  49,  34],
        [ 85,  42,  24],
        [ 75,  31,  10]],

       [[ 24, 207, 219],
        [ 23, 206, 218],
        [ 20, 206, 218],
        ...,
        [ 64,  33,  17],
        [ 70,  35,  12],
        [ 68,  32,   5]],

       [[ 23, 207, 218],
        [ 24, 208, 219],
        [ 24, 209, 222],
        ...,
        [ 47,  25,   3],
        [ 50,  28,   0],
        [ 52,  29,   0]],

       ...,

       [[ 22, 198, 206],
        [ 21, 198, 206],
        [ 20, 198, 207],
        ...,
        [ 61, 228, 238],
        [ 59, 225, 235],
        [ 57, 223, 234]],

       [[ 20, 198, 205],
        [ 20, 198, 205],
        [ 21, 198, 207],
        ...,
        [ 58, 229, 238],
        [ 58, 228, 238],
        [ 58, 226, 237]],

       [[ 19, 197, 204],
        [ 19, 198, 205],
        [ 21, 198, 207],
        ...,
        [ 56, 229, 238],
        [ 57, 229, 239],
        [ 58, 229, 239]]], dtype=uint8)]"
Image_672.jpg,250,69,321,349,800,600,571,418,349,daskShared_local/images/Image_672.jpg,672,"[array([[[ 24,  91, 117],
        [ 11,  81, 117],
        [ 28, 104, 141],
        ...,
        [  2,  96, 170],
        [  1,  95, 169],
        [  1,  95, 169]],

       [[ 11,  88, 122],
        [  3,  86, 137],
        [ 21, 126, 169],
        ...,
        [  2,  96, 170],
        [  1,  95, 169],
        [  2,  96, 170]],

       [[ 46, 134, 145],
        [ 54, 131, 135],
        [ 75, 136, 127],
        ...,
        [  2,  96, 170],
        [  2,  96, 170],
        [  2,  96, 169]],

       ...,

       [[122, 133,  88],
        [128, 142, 116],
        [136, 166, 137],
        ...,
        [  8,  43,  10],
        [  3,  38,   5],
        [ 12,  49,  13]],

       [[135, 146, 102],
        [146, 154, 115],
        [150, 160, 122],
        ...,
        [ 16,  48,  15],
        [  9,  43,   8],
        [  7,  47,   8]],

       [[139, 168, 116],
        [141, 159, 122],
        [163, 179, 144],
        ...,
        [ 22,  58,  25],
        [ 22,  63,  28],
        [  5,  42,   6]]], dtype=uint8)]"
Image_673.jpg,426,149,241,230,1200,822,667,379,241,daskShared_local/images/Image_673.jpg,673,"[array([[[  0, 143, 170],
        [  0, 142, 169],
        [  0, 141, 168],
        ...,
        [  1, 159, 186],
        [  0, 159, 185],
        [  0, 159, 185]],

       [[  0, 145, 172],
        [  0, 144, 171],
        [  0, 144, 171],
        ...,
        [  0, 158, 185],
        [  0, 158, 185],
        [  0, 159, 185]],

       [[  1, 146, 173],
        [  1, 146, 173],
        [  1, 146, 173],
        ...,
        [  0, 157, 185],
        [  0, 157, 184],
        [  0, 158, 186]],

       ...,

       [[101, 121,  58],
        [ 85, 110,  66],
        [ 83, 107,  57],
        ...,
        [134, 110,  96],
        [137, 109,  92],
        [173, 141, 120]],

       [[103, 119,  55],
        [ 84, 107,  62],
        [ 80, 104,  53],
        ...,
        [136, 107,  94],
        [145, 116,  99],
        [165, 136, 115]],

       [[101, 118,  58],
        [ 95, 106,  55],
        [ 94, 106,  56],
        ...,
        [141, 104,  88],
        [137, 102,  75],
        [142, 115,  81]]], dtype=uint8)]"
Image_674.jpg,319,75,99,98,479,313,418,173,99,daskShared_local/images/Image_674.jpg,674,"[array([[[  5,  54,  99],
        [  5,  54,  99],
        [  5,  57, 102],
        ...,
        [  6,  45,  93],
        [  7,  47,  95],
        [  7,  47,  95]],

       [[  5,  54,  99],
        [  5,  54,  99],
        [  5,  57, 102],
        ...,
        [  6,  45,  93],
        [  7,  47,  95],
        [  7,  47,  95]],

       [[  8,  55,  98],
        [  8,  55,  98],
        [  4,  50,  93],
        ...,
        [ 10,  51,  99],
        [  5,  45,  93],
        [  5,  45,  93]],

       ...,

       [[ 59,  83,  62],
        [ 59,  83,  62],
        [ 73,  98,  78],
        ...,
        [  1,  23,  72],
        [  1,  23,  72],
        [  1,  23,  72]],

       [[ 63,  88,  65],
        [ 63,  88,  65],
        [ 71,  98,  76],
        ...,
        [  1,  23,  72],
        [  1,  23,  72],
        [  1,  23,  72]],

       [[ 63,  88,  65],
        [ 63,  88,  65],
        [ 71,  98,  76],
        ...,
        [  1,  23,  72],
        [  1,  23,  72],
        [  1,  23,  72]]], dtype=uint8)]"
Image_675.jpg,1633,842,291,232,2100,1400,1924,1074,291,daskShared_local/images/Image_675.jpg,675,"[array([[[115, 125, 128],
        [138, 145, 141],
        [162, 166, 169],
        ...,
        [ 16,  24,  32],
        [  7,  21,  20],
        [ 20,  24,  27]],

       [[118, 130, 131],
        [148, 154, 157],
        [185, 189, 200],
        ...,
        [  3,  16,  25],
        [  6,  17,  19],
        [  8,  16,  22]],

       [[144, 151, 151],
        [169, 171, 176],
        [194, 203, 213],
        ...,
        [  5,  19,  24],
        [ 20,  29,  33],
        [ 25,  30,  33]],

       ...,

       [[  9,  26,  31],
        [  9,  25,  32],
        [ 17,  35,  39],
        ...,
        [  0,   5,  20],
        [  1,   4,  22],
        [  0,   2,  21]],

       [[ 20,  36,  40],
        [ 17,  32,  41],
        [ 15,  30,  38],
        ...,
        [  1,   4,  22],
        [  0,   3,  23],
        [  0,   8,  25]],

       [[ 10,  29,  30],
        [  9,  31,  32],
        [  7,  26,  27],
        ...,
        [  0,   2,  18],
        [  1,   0,  14],
        [  0,   2,  20]]], dtype=uint8)]"
Image_676.jpg,117,329,193,195,735,1102,310,524,195,daskShared_local/images/Image_676.jpg,676,"[array([[[  0, 120, 206],
        [  0, 125, 209],
        [  0, 126, 210],
        ...,
        [  4, 148, 221],
        [  0, 145, 220],
        [  0, 143, 220]],

       [[  0, 125, 210],
        [  0, 125, 210],
        [  0, 125, 209],
        ...,
        [  1, 144, 222],
        [  1, 147, 222],
        [  0, 147, 221]],

       [[  0, 125, 210],
        [  1, 125, 211],
        [  1, 125, 211],
        ...,
        [  1, 144, 223],
        [  0, 147, 224],
        [  0, 148, 220]],

       ...,

       [[  1, 123, 209],
        [  0, 122, 207],
        [  0, 122, 205],
        ...,
        [ 44,  80,  96],
        [ 49,  76,  82],
        [ 54,  76,  74]],

       [[  0, 122, 207],
        [  1, 123, 206],
        [  0, 122, 202],
        ...,
        [ 46,  82,  98],
        [ 60,  92,  91],
        [ 48,  77,  75]],

       [[  0, 122, 207],
        [  0, 121, 204],
        [  0, 120, 201],
        ...,
        [ 45,  85,  92],
        [ 67, 101, 102],
        [ 45,  75,  83]]], dtype=uint8)]"
Image_677.jpg,370,117,164,115,624,468,534,232,164,daskShared_local/images/Image_677.jpg,677,"[array([[[  4,  61, 113],
        [  1,  50,  96],
        [  0,  38,  76],
        ...,
        [ 16,  14,  21],
        [ 15,  15,  21],
        [ 12,  13,  18]],

       [[ 10,  75, 130],
        [  4,  60, 110],
        [  1,  44,  85],
        ...,
        [ 14,  18,  28],
        [ 11,  18,  25],
        [  5,  16,  20]],

       [[ 13,  84, 141],
        [  8,  71, 123],
        [  3,  52,  97],
        ...,
        [ 13,  21,  34],
        [ 10,  22,  31],
        [  2,  20,  24]],

       ...,

       [[201, 188, 157],
        [192, 179, 148],
        [172, 155, 122],
        ...,
        [ 24,  15,  15],
        [ 26,  16,  14],
        [ 28,  18,  16]],

       [[184, 169, 136],
        [167, 152, 120],
        [151, 133,  99],
        ...,
        [ 22,  12,  11],
        [ 24,  13,  12],
        [ 28,  17,  15]],

       [[176, 149, 102],
        [159, 132,  88],
        [157, 127,  87],
        ...,
        [ 23,  11,  10],
        [ 24,  11,  10],
        [ 28,  16,  14]]], dtype=uint8)]"
Image_678.jpg,444,221,183,190,1200,630,627,411,190,daskShared_local/images/Image_678.jpg,678,"[array([[[ 29, 104, 172],
        [ 27, 102, 170],
        [ 28, 103, 171],
        ...,
        [ 29,  57,  56],
        [ 26,  47,  50],
        [ 21,  38,  45]],

       [[ 29, 104, 172],
        [ 29, 104, 172],
        [ 29, 104, 172],
        ...,
        [ 56,  82,  81],
        [ 45,  66,  69],
        [ 33,  51,  57]],

       [[ 34, 109, 177],
        [ 34, 109, 177],
        [ 33, 108, 176],
        ...,
        [ 69,  94,  94],
        [ 52,  71,  75],
        [ 46,  61,  68]],

       ...,

       [[ 31,  77, 101],
        [ 36,  82, 106],
        [ 36,  81, 104],
        ...,
        [ 20,  21,  23],
        [ 15,  19,  20],
        [ 16,  21,  21]],

       [[ 29,  77,  99],
        [ 36,  82, 105],
        [ 37,  82, 105],
        ...,
        [ 23,  27,  28],
        [ 24,  30,  30],
        [ 21,  27,  27]],

       [[ 32,  80, 102],
        [ 35,  81, 104],
        [ 34,  80, 103],
        ...,
        [ 32,  38,  36],
        [ 35,  44,  41],
        [ 30,  41,  37]]], dtype=uint8)]"
Image_679.jpg,72,113,75,49,350,219,147,162,75,daskShared_local/images/Image_679.jpg,679,"[array([[[  6, 130, 181],
        [  6, 130, 181],
        [  7, 131, 182],
        ...,
        [ 13, 140, 195],
        [ 12, 139, 194],
        [ 12, 140, 195]],

       [[  6, 130, 181],
        [  5, 129, 180],
        [  6, 130, 181],
        ...,
        [ 12, 139, 194],
        [ 11, 138, 193],
        [ 12, 139, 194]],

       [[  7, 131, 182],
        [  7, 131, 182],
        [  7, 131, 182],
        ...,
        [ 13, 140, 196],
        [ 13, 140, 195],
        [ 13, 140, 195]],

       ...,

       [[  0, 112, 183],
        [  0, 112, 182],
        [  0, 112, 184],
        ...,
        [ 57,  90,  94],
        [ 52,  85,  90],
        [ 55,  88,  92]],

       [[  0, 107, 181],
        [  0, 107, 180],
        [  0, 108, 181],
        ...,
        [ 51,  86,  89],
        [ 46,  81,  85],
        [ 49,  84,  88]],

       [[  0, 110, 182],
        [  0, 110, 181],
        [  0, 111, 183],
        ...,
        [ 55,  89,  92],
        [ 50,  84,  88],
        [ 53,  87,  91]]], dtype=uint8)]"
Image_68.jpg,1285,636,190,168,2304,1536,1475,804,190,daskShared_local/images/Image_68.jpg,68,"[array([[[  0, 107, 162],
        [  0, 109, 163],
        [  0, 110, 164],
        ...,
        [  0, 107, 146],
        [  0, 105, 144],
        [  1, 105, 144]],

       [[  0, 121, 174],
        [  0, 121, 174],
        [  0, 124, 177],
        ...,
        [  0, 108, 146],
        [  0, 106, 145],
        [  1, 105, 144]],

       [[ 11, 139, 194],
        [ 10, 138, 193],
        [ 15, 142, 196],
        ...,
        [  0, 108, 146],
        [  0, 108, 146],
        [  0, 105, 144]],

       ...,

       [[131, 166, 158],
        [160, 193, 186],
        [165, 200, 194],
        ...,
        [ 25,  23,  44],
        [ 23,  21,  42],
        [ 20,  18,  39]],

       [[176, 213, 201],
        [172, 208, 204],
        [125, 164, 165],
        ...,
        [ 22,  20,  41],
        [ 22,  20,  41],
        [ 22,  20,  41]],

       [[162, 206, 205],
        [126, 168, 183],
        [ 82, 128, 147],
        ...,
        [ 19,  20,  40],
        [ 20,  21,  41],
        [ 20,  21,  41]]], dtype=uint8)]"
Image_680.jpg,108,109,405,295,800,533,513,404,405,daskShared_local/images/Image_680.jpg,680,"[array([[[  4,  11,  57],
        [  4,  11,  57],
        [  8,  16,  60],
        ...,
        [  7,  19,  72],
        [  7,  18,  72],
        [  7,  17,  71]],

       [[  3,  11,  55],
        [  3,  11,  54],
        [  8,  15,  59],
        ...,
        [  5,  18,  71],
        [  6,  19,  71],
        [  3,  18,  71]],

       [[  5,  12,  56],
        [  4,  11,  56],
        [  7,  12,  57],
        ...,
        [  6,  18,  71],
        [  8,  20,  74],
        [  8,  22,  75]],

       ...,

       [[  7,  14,  58],
        [  8,  15,  59],
        [  6,  14,  57],
        ...,
        [ 82,  64,  21],
        [118,  98,  58],
        [144, 122,  87]],

       [[  8,  13,  58],
        [  7,  13,  58],
        [  6,  14,  57],
        ...,
        [ 81,  66,  21],
        [ 95,  82,  42],
        [136, 123,  90]],

       [[  8,  14,  58],
        [  7,  14,  59],
        [  5,  12,  56],
        ...,
        [ 94,  88,  43],
        [ 89,  85,  45],
        [ 98,  93,  60]]], dtype=uint8)]"
Image_681.jpg,135,38,135,144,425,282,270,182,144,daskShared_local/images/Image_681.jpg,681,"[array([[[  0,  80, 128],
        [  0,  81, 128],
        [  0,  80, 128],
        ...,
        [  0, 125, 171],
        [  0, 128, 173],
        [  0, 131, 175]],

       [[  0,  79, 128],
        [  0,  79, 128],
        [  1,  80, 128],
        ...,
        [  0, 123, 169],
        [  0, 125, 171],
        [  0, 127, 172]],

       [[  0,  78, 128],
        [  1,  78, 128],
        [  1,  79, 127],
        ...,
        [  0, 120, 167],
        [  0, 122, 168],
        [  0, 123, 169]],

       ...,

       [[ 27,  17,   7],
        [ 29,  20,   8],
        [ 30,  22,   9],
        ...,
        [120, 142, 134],
        [101, 132, 127],
        [ 86, 124, 123]],

       [[ 31,  20,   7],
        [ 33,  22,   8],
        [ 33,  23,   8],
        ...,
        [ 60, 112, 116],
        [ 41,  98, 104],
        [ 29,  91,  98]],

       [[ 34,  22,   7],
        [ 35,  23,   8],
        [ 34,  23,   8],
        ...,
        [ 26,  95, 105],
        [ 13,  84,  92],
        [  8,  80,  86]]], dtype=uint8)]"
Image_682.jpg,660,189,525,516,1366,917,1185,705,525,daskShared_local/images/Image_682.jpg,682,"[array([[[ 70,  62,  47],
        [ 69,  62,  52],
        [ 47,  41,  36],
        ...,
        [ 28,  29,  33],
        [ 28,  28,  32],
        [ 25,  26,  30]],

       [[ 75,  69,  54],
        [ 62,  57,  46],
        [ 54,  49,  44],
        ...,
        [ 29,  31,  34],
        [ 30,  30,  35],
        [ 28,  29,  34]],

       [[ 74,  69,  54],
        [ 67,  62,  50],
        [ 65,  61,  52],
        ...,
        [ 26,  27,  30],
        [ 30,  30,  33],
        [ 30,  31,  34]],

       ...,

       [[  5, 163, 241],
        [  6, 164, 242],
        [  6, 164, 243],
        ...,
        [  5, 143, 233],
        [  4, 143, 235],
        [  4, 144, 236]],

       [[  4, 166, 241],
        [  5, 167, 242],
        [  5, 166, 242],
        ...,
        [  7, 147, 235],
        [  7, 145, 236],
        [  6, 146, 235]],

       [[  5, 167, 242],
        [  6, 168, 243],
        [  5, 167, 242],
        ...,
        [  8, 149, 237],
        [  8, 148, 236],
        [  7, 148, 236]]], dtype=uint8)]"
Image_683.jpg,112,131,106,95,800,544,218,226,106,daskShared_local/images/Image_683.jpg,683,"[array([[[ 28,  25,  34],
        [ 27,  25,  34],
        [ 22,  21,  29],
        ...,
        [  4,  31,  61],
        [  5,  32,  61],
        [  5,  32,  61]],

       [[ 29,  26,  35],
        [ 28,  25,  34],
        [ 22,  21,  30],
        ...,
        [  4,  31,  61],
        [  5,  32,  61],
        [  5,  32,  61]],

       [[ 32,  28,  37],
        [ 31,  27,  37],
        [ 25,  23,  32],
        ...,
        [  2,  29,  59],
        [  3,  30,  60],
        [  3,  30,  60]],

       ...,

       [[ 17,  15,  10],
        [ 17,  15,  10],
        [ 16,  14,  10],
        ...,
        [ 95, 170, 152],
        [ 96, 171, 152],
        [ 96, 171, 152]],

       [[ 18,  15,  11],
        [ 18,  15,  11],
        [ 16,  15,  11],
        ...,
        [101, 177, 159],
        [ 99, 173, 156],
        [ 98, 173, 155]],

       [[ 18,  16,  11],
        [ 18,  15,  11],
        [ 16,  15,  11],
        ...,
        [101, 177, 160],
        [ 99, 174, 156],
        [ 99, 173, 156]]], dtype=uint8)]"
Image_684.jpg,370,183,472,355,1280,854,842,538,472,daskShared_local/images/Image_684.jpg,684,"[array([[[125, 139, 160],
        [127, 139, 161],
        [125, 136, 158],
        ...,
        [ 18, 210, 246],
        [ 18, 210, 246],
        [ 19, 211, 247]],

       [[129, 141, 162],
        [127, 138, 159],
        [126, 135, 157],
        ...,
        [ 17, 209, 245],
        [ 17, 209, 245],
        [ 20, 212, 248]],

       [[129, 141, 164],
        [129, 141, 164],
        [127, 138, 161],
        ...,
        [ 17, 209, 245],
        [ 17, 209, 245],
        [ 19, 211, 247]],

       ...,

       [[ 52, 165, 201],
        [ 59, 173, 208],
        [ 59, 172, 206],
        ...,
        [ 13, 167, 226],
        [ 12, 161, 221],
        [ 15, 162, 221]],

       [[ 44, 165, 200],
        [ 58, 172, 206],
        [ 61, 171, 204],
        ...,
        [ 12, 177, 225],
        [  8, 167, 219],
        [ 13, 170, 224]],

       [[ 35, 157, 192],
        [ 52, 170, 204],
        [ 59, 173, 207],
        ...,
        [ 12, 178, 227],
        [ 11, 173, 224],
        [ 13, 175, 228]]], dtype=uint8)]"
Image_685.jpg,576,54,174,158,930,500,750,212,174,daskShared_local/images/Image_685.jpg,685,"[array([[[  6, 144, 207],
        [  9, 147, 210],
        [ 10, 148, 211],
        ...,
        [  9, 147, 209],
        [  8, 146, 208],
        [  8, 146, 208]],

       [[  9, 147, 210],
        [ 10, 148, 211],
        [ 10, 148, 211],
        ...,
        [  7, 145, 207],
        [  5, 143, 205],
        [  5, 143, 205]],

       [[ 11, 149, 210],
        [ 12, 150, 210],
        [ 11, 150, 210],
        ...,
        [  7, 144, 203],
        [  8, 144, 204],
        [  8, 144, 203]],

       ...,

       [[225, 221, 220],
        [217, 213, 212],
        [207, 203, 202],
        ...,
        [  6, 134, 199],
        [  6, 134, 199],
        [  6, 134, 199]],

       [[204, 201, 199],
        [200, 196, 195],
        [210, 207, 206],
        ...,
        [  6, 134, 199],
        [  6, 134, 199],
        [  6, 134, 199]],

       [[218, 217, 215],
        [212, 211, 209],
        [230, 229, 227],
        ...,
        [  6, 134, 199],
        [  6, 134, 199],
        [  5, 133, 198]]], dtype=uint8)]"
Image_686.jpg,389,32,1184,985,1920,1080,1573,1017,1184,daskShared_local/images/Image_686.jpg,686,"[array([[[  0, 125, 157],
        [  0, 125, 157],
        [  0, 124, 156],
        ...,
        [ 10,  78,  87],
        [  7,  86,  88],
        [  2,  86,  93]],

       [[  0, 125, 157],
        [  0, 125, 157],
        [  0, 124, 157],
        ...,
        [  4,  92,  94],
        [  3,  99,  98],
        [  2,  92,  99]],

       [[  0, 126, 156],
        [  0, 126, 157],
        [  0, 125, 156],
        ...,
        [  2, 101, 105],
        [  1,  93, 107],
        [  1,  78, 103]],

       ...,

       [[ 72,  74,  38],
        [ 70,  68,  35],
        [ 74,  70,  33],
        ...,
        [ 16,  22,  23],
        [ 15,  21,  23],
        [ 13,  20,  22]],

       [[ 81,  78,  38],
        [ 83,  77,  39],
        [ 92,  84,  43],
        ...,
        [ 22,  24,  21],
        [ 21,  23,  22],
        [ 18,  22,  20]],

       [[ 97,  89,  47],
        [102,  92,  54],
        [109,  99,  58],
        ...,
        [ 28,  28,  22],
        [ 29,  28,  24],
        [ 29,  30,  21]]], dtype=uint8)]"
Image_687.jpg,160,176,170,137,728,500,330,313,170,daskShared_local/images/Image_687.jpg,687,"[array([[[  1,  71, 221],
        [  1,  71, 221],
        [  2,  71, 220],
        ...,
        [  1,  80, 225],
        [  0,  81, 225],
        [  0,  81, 225]],

       [[  1,  69, 219],
        [  1,  69, 219],
        [  1,  69, 218],
        ...,
        [  1,  80, 225],
        [  0,  81, 224],
        [  0,  81, 224]],

       [[  1,  68, 218],
        [  0,  67, 217],
        [  1,  68, 217],
        ...,
        [  1,  80, 225],
        [  0,  81, 224],
        [  0,  81, 224]],

       ...,

       [[ 13, 126, 148],
        [ 23, 136, 157],
        [ 41, 152, 162],
        ...,
        [252, 246, 206],
        [249, 236, 191],
        [233, 210, 164]],

       [[ 16, 133, 150],
        [ 19, 135, 154],
        [ 28, 141, 158],
        ...,
        [254, 254, 240],
        [250, 248, 224],
        [234, 224, 184]],

       [[ 12, 130, 144],
        [ 10, 126, 144],
        [ 18, 134, 149],
        ...,
        [251, 254, 239],
        [250, 251, 232],
        [240, 236, 202]]], dtype=uint8)]"
Image_688.jpg,534,235,167,190,990,681,701,425,190,daskShared_local/images/Image_688.jpg,688,"[array([[[ 40,  36,  24],
        [ 40,  37,  22],
        [ 39,  36,  21],
        ...,
        [ 35,  33,  20],
        [ 36,  30,  16],
        [ 35,  28,  12]],

       [[ 36,  32,  20],
        [ 37,  34,  19],
        [ 37,  34,  19],
        ...,
        [ 37,  34,  17],
        [ 41,  36,  17],
        [ 37,  31,   9]],

       [[ 34,  28,  16],
        [ 35,  29,  15],
        [ 37,  31,  17],
        ...,
        [ 36,  34,  13],
        [ 44,  38,  17],
        [ 42,  34,  11]],

       ...,

       [[131, 123,  87],
        [126, 118,  81],
        [130, 122,  83],
        ...,
        [ 48,  54,  41],
        [ 49,  55,  41],
        [ 49,  55,  40]],

       [[121, 115,  79],
        [124, 119,  81],
        [131, 126,  86],
        ...,
        [ 41,  47,  35],
        [ 44,  50,  36],
        [ 44,  51,  35]],

       [[174, 168, 134],
        [170, 165, 127],
        [133, 128,  88],
        ...,
        [ 32,  38,  26],
        [ 38,  44,  30],
        [ 41,  48,  32]]], dtype=uint8)]"
Image_689.jpg,109,90,74,68,500,461,183,158,74,daskShared_local/images/Image_689.jpg,689,"[array([[[ 32, 115, 110],
        [ 35, 116, 112],
        [ 30, 114, 110],
        ...,
        [ 20,  90,  97],
        [ 18,  89,  96],
        [ 19,  89,  97]],

       [[ 34, 118, 113],
        [ 37, 120, 116],
        [ 32, 116, 112],
        ...,
        [ 19,  90,  97],
        [ 17,  90,  97],
        [ 19,  90,  97]],

       [[ 31, 113, 109],
        [ 33, 114, 111],
        [ 30, 113, 109],
        ...,
        [ 20,  89,  97],
        [ 18,  89,  96],
        [ 19,  89,  96]],

       ...,

       [[ 29,  86,  88],
        [ 30,  86,  88],
        [ 29,  86,  88],
        ...,
        [ 60,  31,  27],
        [ 53,  23,  19],
        [ 58,  28,  24]],

       [[ 27,  85,  87],
        [ 27,  85,  87],
        [ 27,  85,  87],
        ...,
        [ 54,  26,  27],
        [ 49,  20,  21],
        [ 52,  24,  25]],

       [[ 29,  86,  88],
        [ 29,  86,  88],
        [ 29,  85,  87],
        ...,
        [ 58,  29,  27],
        [ 52,  22,  20],
        [ 56,  27,  25]]], dtype=uint8)]"
Image_69.jpg,184,103,382,306,1024,670,566,409,382,daskShared_local/images/Image_69.jpg,69,"[array([[[ 25,  38,  49],
        [ 18,  32,  45],
        [ 14,  30,  46],
        ...,
        [ 65, 162, 176],
        [ 29, 129, 143],
        [ 10, 107, 123]],

       [[ 17,  31,  45],
        [ 23,  38,  54],
        [ 28,  44,  61],
        ...,
        [ 32, 124, 111],
        [ 14, 112, 115],
        [ 57, 161, 182]],

       [[ 36,  53,  66],
        [ 31,  47,  62],
        [ 30,  46,  63],
        ...,
        [ 10,  84,  75],
        [ 17, 110, 110],
        [ 96, 216, 221]],

       ...,

       [[ 94, 174, 173],
        [ 86, 149, 156],
        [ 57, 124, 140],
        ...,
        [180, 163, 122],
        [147, 140, 108],
        [ 66,  78,  62]],

       [[ 89, 169, 169],
        [ 93, 154, 160],
        [ 79, 143, 154],
        ...,
        [141, 134, 111],
        [162, 158, 136],
        [134, 139, 126]],

       [[ 78, 154, 158],
        [ 87, 140, 148],
        [ 91, 142, 154],
        ...,
        [ 84, 103, 118],
        [106, 113, 119],
        [ 79,  78,  78]]], dtype=uint8)]"
Image_690.jpg,336,129,265,221,845,563,601,350,265,daskShared_local/images/Image_690.jpg,690,"[array([[[106, 199, 201],
        [115, 205, 208],
        [120, 208, 212],
        ...,
        [ 92, 198, 194],
        [ 88, 198, 194],
        [ 81, 193, 189]],

       [[115, 202, 204],
        [119, 204, 207],
        [120, 204, 208],
        ...,
        [ 85, 195, 191],
        [ 84, 195, 191],
        [ 81, 194, 190]],

       [[131, 215, 218],
        [129, 211, 215],
        [122, 203, 207],
        ...,
        [ 86, 196, 193],
        [ 85, 198, 194],
        [ 85, 198, 194]],

       ...,

       [[ 88, 134,  66],
        [ 73, 121,  52],
        [ 55, 105,  33],
        ...,
        [ 10, 176, 176],
        [ 16, 179, 179],
        [ 23, 183, 183]],

       [[ 85, 125,  61],
        [ 70, 113,  46],
        [ 55, 100,  31],
        ...,
        [ 18, 182, 179],
        [ 24, 185, 183],
        [ 32, 191, 189]],

       [[ 58,  91,  30],
        [ 55,  91,  28],
        [ 53,  93,  26],
        ...,
        [ 30, 191, 185],
        [ 34, 195, 188],
        [ 38, 198, 191]]], dtype=uint8)]"
Image_691.jpg,314,157,173,181,1200,735,487,338,181,daskShared_local/images/Image_691.jpg,691,"[array([[[112, 188, 202],
        [107, 183, 197],
        [106, 182, 196],
        ...,
        [ 13,  49,  78],
        [ 13,  51,  79],
        [ 18,  58,  84]],

       [[114, 190, 204],
        [112, 188, 202],
        [111, 187, 201],
        ...,
        [  4,  44,  67],
        [  5,  46,  71],
        [ 16,  57,  82]],

       [[115, 191, 205],
        [115, 191, 205],
        [116, 192, 206],
        ...,
        [  0,  39,  59],
        [  2,  41,  61],
        [  9,  53,  74]],

       ...,

       [[145, 187, 180],
        [151, 192, 188],
        [151, 194, 190],
        ...,
        [ 10,   3,   2],
        [ 24,  12,   7],
        [ 24,   7,   3]],

       [[138, 184, 176],
        [138, 183, 178],
        [140, 185, 182],
        ...,
        [ 17,   1,   0],
        [ 12,   0,   0],
        [ 11,   0,   4]],

       [[141, 186, 179],
        [143, 185, 182],
        [141, 182, 181],
        ...,
        [ 27,   7,   3],
        [ 15,   0,   0],
        [ 12,   2,   3]]], dtype=uint8)]"
Image_692.jpg,637,281,112,94,900,678,749,375,112,daskShared_local/images/Image_692.jpg,692,"[array([[[  8, 156, 207],
        [  8, 156, 207],
        [  8, 158, 208],
        ...,
        [  0, 136, 189],
        [  0, 136, 189],
        [  0, 135, 188]],

       [[  9, 157, 207],
        [  9, 157, 208],
        [  9, 159, 209],
        ...,
        [  0, 137, 190],
        [  0, 136, 189],
        [  0, 136, 189]],

       [[ 11, 159, 210],
        [ 12, 160, 210],
        [ 13, 163, 213],
        ...,
        [  0, 138, 191],
        [  0, 137, 190],
        [  0, 136, 189]],

       ...,

       [[111, 192, 241],
        [111, 193, 241],
        [114, 195, 243],
        ...,
        [ 59, 181, 230],
        [ 55, 179, 228],
        [ 54, 179, 227]],

       [[111, 190, 238],
        [111, 190, 239],
        [114, 192, 242],
        ...,
        [ 62, 184, 233],
        [ 57, 181, 229],
        [ 56, 180, 228]],

       [[110, 189, 238],
        [111, 189, 239],
        [114, 192, 241],
        ...,
        [ 62, 184, 233],
        [ 57, 181, 229],
        [ 56, 180, 228]]], dtype=uint8)]"
Image_693.jpg,353,97,157,211,728,486,510,308,211,daskShared_local/images/Image_693.jpg,693,"[array([[[  1,  67, 251],
        [  1,  64, 253],
        [  1,  64, 253],
        ...,
        [  0, 110, 254],
        [  2, 108, 254],
        [  0, 107, 252]],

       [[  1,  62, 251],
        [  2,  60, 254],
        [  1,  63, 253],
        ...,
        [  0, 110, 255],
        [  1, 110, 253],
        [  0, 109, 254]],

       [[  2,  62, 254],
        [  2,  60, 254],
        [  1,  60, 251],
        ...,
        [  0, 107, 253],
        [  2, 108, 254],
        [  1, 107, 255]],

       ...,

       [[202, 159, 125],
        [183, 145, 117],
        [169, 134,  94],
        ...,
        [135, 132,  64],
        [150, 142,  63],
        [158, 147,  59]],

       [[144,  96,  79],
        [156, 111,  94],
        [160, 121, 100],
        ...,
        [ 13,  31,  18],
        [ 15,  37,  19],
        [ 21,  46,  22]],

       [[200, 150, 125],
        [205, 159, 133],
        [210, 174, 154],
        ...,
        [  0,  29,  15],
        [  0,  27,  18],
        [  0,  27,  18]]], dtype=uint8)]"
Image_694.png,227,54,189,191,449,252,416,245,191,daskShared_local/images/Image_694.png,694,"[array([[[ 22,  99, 100],
        [ 48, 113,  96],
        [ 50, 114,  96],
        ...,
        [  0, 118, 175],
        [  0, 118, 175],
        [  0, 118, 175]],

       [[ 21, 112, 101],
        [ 34, 114,  95],
        [ 35, 114,  95],
        ...,
        [  0, 118, 175],
        [  0, 118, 175],
        [  0, 118, 175]],

       [[ 21, 113, 101],
        [ 22, 113, 100],
        [ 16, 109,  90],
        ...,
        [  0, 118, 175],
        [  0, 118, 175],
        [  0, 118, 175]],

       ...,

       [[  0,   0,   1],
        [  0,   0,   1],
        [  0,   0,   1],
        ...,
        [  5,  32,  12],
        [  4,  33,  27],
        [ 18,  62,  28]],

       [[  0,   0,   1],
        [  0,   0,   1],
        [  0,   0,   1],
        ...,
        [  5,  32,  11],
        [  5,  34,  13],
        [  3,  48,  31]],

       [[  0,   0,   1],
        [  0,   0,   1],
        [  0,   0,   1],
        ...,
        [  5,  33,  13],
        [  3,  48,  31],
        [  3,  32,  29]]], dtype=uint8)]"
Image_695.jpg,650,235,353,315,2121,1063,1003,550,353,daskShared_local/images/Image_695.jpg,695,"[array([[[ 94, 142, 156],
        [ 92, 140, 154],
        [ 84, 131, 145],
        ...,
        [146, 169, 181],
        [145, 167, 180],
        [139, 161, 174]],

       [[106, 155, 169],
        [107, 156, 170],
        [102, 151, 165],
        ...,
        [143, 165, 173],
        [143, 164, 175],
        [142, 163, 174]],

       [[ 95, 145, 159],
        [101, 153, 166],
        [100, 152, 165],
        ...,
        [138, 159, 164],
        [133, 153, 160],
        [130, 150, 157]],

       ...,

       [[ 54, 105, 124],
        [ 52, 103, 122],
        [ 54, 105, 124],
        ...,
        [170, 170, 162],
        [168, 168, 158],
        [167, 167, 155]],

       [[ 55, 106, 125],
        [ 54, 105, 124],
        [ 57, 108, 127],
        ...,
        [169, 169, 161],
        [169, 169, 159],
        [168, 168, 156]],

       [[ 54, 105, 124],
        [ 53, 104, 123],
        [ 53, 104, 123],
        ...,
        [163, 163, 155],
        [168, 168, 159],
        [168, 168, 158]]], dtype=uint8)]"
Image_696.jpg,489,298,141,138,1024,670,630,436,141,daskShared_local/images/Image_696.jpg,696,"[array([[[192, 199, 148],
        [211, 221, 170],
        [231, 244, 193],
        ...,
        [  3, 101,  88],
        [  3, 101,  88],
        [  3, 101,  88]],

       [[170, 176, 123],
        [185, 192, 140],
        [208, 219, 168],
        ...,
        [  3, 101,  88],
        [  3, 101,  88],
        [  3, 101,  88]],

       [[164, 167, 111],
        [172, 177, 123],
        [180, 186, 135],
        ...,
        [  3, 101,  87],
        [  3, 101,  88],
        [  3, 101,  88]],

       ...,

       [[  4, 142, 104],
        [  4, 142, 104],
        [  5, 143, 104],
        ...,
        [  1, 145, 117],
        [  1, 145, 117],
        [  1, 145, 117]],

       [[  3, 142, 104],
        [  3, 142, 102],
        [  3, 142, 101],
        ...,
        [  1, 146, 118],
        [  1, 146, 117],
        [  1, 146, 117]],

       [[  1, 140, 103],
        [  1, 140, 101],
        [  1, 139,  98],
        ...,
        [  2, 147, 118],
        [  2, 147, 118],
        [  2, 147, 118]]], dtype=uint8)]"
Image_697.jpg,487,120,141,126,800,600,628,246,141,daskShared_local/images/Image_697.jpg,697,"[array([[[  0, 148, 166],
        [  2, 149, 167],
        [  3, 150, 168],
        ...,
        [ 55, 173, 178],
        [ 57, 175, 180],
        [ 58, 177, 182]],

       [[  1, 149, 166],
        [  2, 150, 168],
        [  4, 151, 169],
        ...,
        [ 56, 174, 180],
        [ 58, 176, 181],
        [ 59, 177, 183]],

       [[  1, 150, 167],
        [  3, 151, 169],
        [  5, 152, 170],
        ...,
        [ 56, 172, 179],
        [ 57, 174, 181],
        [ 58, 174, 181]],

       ...,

       [[ 26,  20,   0],
        [ 31,  26,   2],
        [ 43,  38,   9],
        ...,
        [  0, 140, 160],
        [  0, 140, 160],
        [  0, 140, 160]],

       [[ 24,  19,   1],
        [ 34,  29,   5],
        [ 50,  45,  16],
        ...,
        [  0, 140, 160],
        [  0, 140, 160],
        [  0, 140, 160]],

       [[ 22,  17,   2],
        [ 35,  30,   8],
        [ 56,  51,  22],
        ...,
        [  0, 140, 160],
        [  0, 140, 160],
        [  0, 140, 160]]], dtype=uint8)]"
Image_698.jpg,113,373,262,202,1200,800,375,575,262,daskShared_local/images/Image_698.jpg,698,"[array([[[  1,  91,  97],
        [  0,  89,  94],
        [  0,  91,  95],
        ...,
        [ 27, 118, 133],
        [ 14, 116, 128],
        [ 10, 105, 118]],

       [[  5,  98, 102],
        [  2,  95,  99],
        [  0,  91,  95],
        ...,
        [  6,  98, 117],
        [  1,  99, 114],
        [  8, 105, 120]],

       [[  7, 101, 103],
        [  2,  96,  98],
        [  0,  92,  94],
        ...,
        [  0,  92, 109],
        [  0,  91, 108],
        [  2,  98, 114]],

       ...,

       [[176, 222, 183],
        [194, 240, 190],
        [201, 247, 185],
        ...,
        [  2,  61,  59],
        [  3,  63,  61],
        [  3,  65,  62]],

       [[169, 214, 184],
        [189, 236, 189],
        [200, 250, 186],
        ...,
        [  4,  60,  57],
        [  6,  66,  62],
        [  6,  68,  63]],

       [[163, 206, 176],
        [183, 230, 179],
        [196, 248, 177],
        ...,
        [  7,  64,  60],
        [  8,  69,  64],
        [  4,  66,  61]]], dtype=uint8)]"
Image_699.jpg,2235,269,612,522,3033,1757,2847,791,612,daskShared_local/images/Image_699.jpg,699,"[array([[[  0,  53, 217],
        [  0,  53, 217],
        [  0,  53, 217],
        ...,
        [  0,  53, 217],
        [  0,  53, 217],
        [  0,  53, 217]],

       [[  0,  53, 217],
        [  0,  53, 217],
        [  0,  53, 217],
        ...,
        [  0,  53, 217],
        [  0,  53, 217],
        [  0,  53, 217]],

       [[  0,  53, 217],
        [  0,  53, 217],
        [  0,  53, 217],
        ...,
        [  0,  53, 217],
        [  0,  53, 217],
        [  0,  53, 217]],

       ...,

       [[ 88,  95,  54],
        [ 82,  88,  52],
        [ 70,  77,  44],
        ...,
        [  0,  53, 217],
        [  0,  53, 217],
        [  0,  53, 217]],

       [[ 74,  81,  45],
        [ 76,  83,  48],
        [ 68,  75,  42],
        ...,
        [  0,  53, 217],
        [  0,  53, 217],
        [  0,  53, 217]],

       [[ 52,  61,  32],
        [ 59,  67,  37],
        [ 57,  64,  35],
        ...,
        [  0,  53, 217],
        [  0,  53, 217],
        [  0,  53, 217]]], dtype=uint8)]"
Image_7.jpg,1449,1117,388,394,2522,3332,1837,1511,394,daskShared_local/images/Image_7.jpg,7,"[array([[[214, 204, 184],
        [222, 213, 194],
        [228, 218, 201],
        ...,
        [  2, 133, 144],
        [  3, 135, 147],
        [  5, 147, 156]],

       [[223, 211, 188],
        [233, 221, 202],
        [236, 222, 207],
        ...,
        [ 16, 167, 177],
        [ 11, 173, 179],
        [  6, 175, 179]],

       [[217, 203, 183],
        [229, 218, 201],
        [220, 209, 197],
        ...,
        [  2, 164, 174],
        [  1, 166, 175],
        [  0, 168, 176]],

       ...,

       [[ 37,  68,  61],
        [ 45,  84,  77],
        [ 42,  92,  91],
        ...,
        [  1, 125, 199],
        [  0, 124, 198],
        [  1, 125, 199]],

       [[ 41,  71,  66],
        [ 36,  72,  68],
        [ 36,  82,  82],
        ...,
        [  2, 126, 200],
        [  1, 125, 199],
        [  1, 125, 199]],

       [[ 45,  74,  70],
        [ 40,  73,  71],
        [ 42,  84,  84],
        ...,
        [  1, 125, 199],
        [  0, 124, 198],
        [  1, 125, 199]]], dtype=uint8)]"
Image_70.jpg,249,218,134,137,775,518,383,355,137,daskShared_local/images/Image_70.jpg,70,"[array([[[172, 147, 137],
        [172, 146, 136],
        [172, 145, 135],
        ...,
        [ 91,  61,  41],
        [ 93,  61,  34],
        [103,  70,  37]],

       [[172, 145, 135],
        [176, 149, 139],
        [181, 153, 143],
        ...,
        [114,  84,  65],
        [107,  75,  49],
        [107,  74,  40]],

       [[175, 147, 136],
        [184, 155, 144],
        [190, 162, 151],
        ...,
        [141, 113,  95],
        [128,  97,  70],
        [116,  83,  49]],

       ...,

       [[162, 135,  88],
        [167, 140,  93],
        [176, 149, 102],
        ...,
        [203, 161, 123],
        [195, 156, 115],
        [188, 153, 109]],

       [[155, 128,  81],
        [158, 131,  84],
        [167, 140,  93],
        ...,
        [207, 165, 127],
        [200, 161, 120],
        [195, 160, 116]],

       [[152, 125,  78],
        [154, 127,  80],
        [161, 134,  88],
        ...,
        [211, 169, 131],
        [204, 166, 125],
        [200, 165, 121]]], dtype=uint8)]"
Image_700.jpg,276,744,67,57,1280,960,343,801,67,daskShared_local/images/Image_700.jpg,700,"[array([[[ 28, 123, 254],
        [ 28, 123, 254],
        [ 28, 123, 254],
        ...,
        [ 25, 122, 255],
        [ 25, 122, 255],
        [ 25, 122, 255]],

       [[ 30, 124, 255],
        [ 30, 124, 255],
        [ 30, 124, 255],
        ...,
        [ 25, 122, 255],
        [ 25, 122, 255],
        [ 25, 122, 255]],

       [[ 28, 123, 254],
        [ 28, 123, 254],
        [ 28, 123, 254],
        ...,
        [ 25, 122, 255],
        [ 25, 122, 255],
        [ 25, 122, 255]],

       ...,

       [[  0,   0,   0],
        [  0,   0,   0],
        [  0,   0,   0],
        ...,
        [ 19, 106, 230],
        [ 18, 106, 230],
        [ 19, 106, 230]],

       [[  0,   0,   0],
        [  0,   0,   0],
        [  0,   0,   0],
        ...,
        [ 19, 106, 229],
        [ 18, 106, 229],
        [ 19, 106, 229]],

       [[  0,   0,   0],
        [  0,   0,   0],
        [  0,   0,   0],
        ...,
        [ 19, 106, 230],
        [ 18, 106, 230],
        [ 19, 106, 230]]], dtype=uint8)]"
Image_701.jpg,408,5,421,528,1280,720,829,533,528,daskShared_local/images/Image_701.jpg,701,"[array([[[164, 231, 240],
        [161, 229, 238],
        [160, 229, 240],
        ...,
        [ 45, 180, 209],
        [ 65, 185, 215],
        [ 72, 185, 214]],

       [[167, 234, 242],
        [162, 230, 239],
        [159, 229, 239],
        ...,
        [ 80, 189, 216],
        [ 86, 191, 221],
        [ 81, 189, 217]],

       [[164, 232, 241],
        [159, 228, 238],
        [155, 227, 239],
        ...,
        [ 81, 189, 212],
        [ 84, 193, 215],
        [ 73, 190, 214]],

       ...,

       [[ 66,  50,  14],
        [ 49,  43,  23],
        [ 76,  66,  38],
        ...,
        [  3,  67,  92],
        [  3,  68,  92],
        [  3,  69,  95]],

       [[ 41,  25,   2],
        [ 26,  22,  15],
        [ 39,  39,  26],
        ...,
        [  1,  66,  92],
        [  2,  67,  93],
        [  4,  67,  93]],

       [[ 45,  29,   4],
        [ 18,  14,   7],
        [ 17,  19,  12],
        ...,
        [  3,  65,  89],
        [  3,  66,  92],
        [  2,  66,  93]]], dtype=uint8)]"
Image_702.jpg,315,291,142,98,1280,720,457,389,142,daskShared_local/images/Image_702.jpg,702,"[array([[[  0,  60, 133],
        [  0,  60, 133],
        [  0,  60, 133],
        ...,
        [  0,  62, 139],
        [  0,  62, 139],
        [  0,  62, 139]],

       [[  0,  60, 133],
        [  0,  60, 133],
        [  0,  60, 133],
        ...,
        [  0,  62, 139],
        [  0,  62, 139],
        [  0,  62, 139]],

       [[  0,  60, 133],
        [  0,  60, 133],
        [  0,  60, 133],
        ...,
        [  0,  62, 139],
        [  0,  62, 139],
        [  0,  62, 139]],

       ...,

       [[ 31, 105, 131],
        [ 31, 105, 131],
        [ 31, 105, 131],
        ...,
        [ 17,  95, 132],
        [ 17,  95, 132],
        [ 17,  95, 132]],

       [[ 31, 105, 130],
        [ 31, 105, 130],
        [ 31, 105, 130],
        ...,
        [ 18,  96, 132],
        [ 17,  95, 131],
        [ 17,  95, 131]],

       [[ 31, 105, 130],
        [ 31, 105, 130],
        [ 31, 105, 130],
        ...,
        [ 18,  96, 132],
        [ 18,  96, 132],
        [ 18,  96, 132]]], dtype=uint8)]"
Image_703.jpg,320,272,99,75,800,600,419,347,99,daskShared_local/images/Image_703.jpg,703,"[array([[[  1, 159, 255],
        [  1, 159, 255],
        [  1, 159, 255],
        ...,
        [  0, 162, 253],
        [  0, 163, 254],
        [  0, 163, 254]],

       [[  1, 159, 255],
        [  1, 159, 255],
        [  1, 159, 255],
        ...,
        [  0, 162, 253],
        [  0, 163, 254],
        [  0, 163, 254]],

       [[  1, 159, 255],
        [  1, 159, 255],
        [  0, 158, 255],
        ...,
        [  1, 162, 253],
        [  0, 163, 254],
        [  0, 163, 254]],

       ...,

       [[ 97, 155, 131],
        [ 97, 155, 131],
        [112, 168, 153],
        ...,
        [ 14,  18,  19],
        [ 17,  21,  21],
        [ 17,  21,  21]],

       [[122, 174, 161],
        [122, 174, 161],
        [112, 164, 157],
        ...,
        [ 16,  20,  21],
        [ 18,  22,  23],
        [ 18,  22,  23]],

       [[122, 174, 161],
        [122, 174, 161],
        [112, 164, 157],
        ...,
        [ 16,  20,  21],
        [ 18,  22,  23],
        [ 18,  22,  23]]], dtype=uint8)]"
Image_704.jpg,194,339,286,198,1024,768,480,537,286,daskShared_local/images/Image_704.jpg,704,"[array([[[100, 156, 176],
        [ 71, 125, 145],
        [ 46,  99, 117],
        ...,
        [106, 122, 141],
        [ 67,  85, 103],
        [ 82, 101, 118]],

       [[148, 205, 228],
        [118, 175, 195],
        [ 92, 149, 167],
        ...,
        [ 35,  47,  69],
        [ 17,  31,  52],
        [ 57,  72,  93]],

       [[149, 206, 235],
        [129, 186, 210],
        [109, 166, 185],
        ...,
        [ 23,  30,  54],
        [ 24,  34,  59],
        [ 23,  34,  58]],

       ...,

       [[ 11,  26,  36],
        [ 17,  41,  78],
        [ 47,  84, 136],
        ...,
        [ 17,   3,   3],
        [ 16,   2,   2],
        [ 13,   0,   0]],

       [[  2,  18,  25],
        [ 32,  62,  92],
        [ 58,  99, 140],
        ...,
        [ 17,   3,   3],
        [ 18,   4,   4],
        [ 23,   9,   9]],

       [[ 12,  41,  44],
        [ 37,  74,  94],
        [ 68, 114, 139],
        ...,
        [ 15,   1,   1],
        [ 18,   4,   4],
        [ 27,  13,  13]]], dtype=uint8)]"
Image_705.jpg,672,291,294,319,1600,900,966,610,319,daskShared_local/images/Image_705.jpg,705,"[array([[[  0, 116, 199],
        [  0, 116, 199],
        [  0, 116, 199],
        ...,
        [  1, 117, 203],
        [  1, 117, 202],
        [  1, 117, 202]],

       [[  0, 116, 199],
        [  0, 116, 199],
        [  0, 116, 199],
        ...,
        [  1, 117, 202],
        [  0, 116, 201],
        [  1, 117, 202]],

       [[  0, 116, 199],
        [  0, 116, 199],
        [  0, 116, 199],
        ...,
        [  1, 117, 202],
        [  0, 116, 201],
        [  0, 116, 201]],

       ...,

       [[182, 173, 137],
        [197, 189, 153],
        [189, 181, 146],
        ...,
        [ 79,  90,  70],
        [ 68,  89,  74],
        [ 72,  83,  66]],

       [[200, 192, 158],
        [216, 208, 174],
        [207, 198, 165],
        ...,
        [127, 140, 129],
        [ 79, 100,  86],
        [ 60,  70,  55]],

       [[198, 194, 156],
        [204, 200, 162],
        [176, 173, 137],
        ...,
        [131, 133, 117],
        [123, 141, 102],
        [ 97, 111,  75]]], dtype=uint8)]"
Image_706.jpg,781,537,1243,1492,3072,2304,2024,2029,1492,daskShared_local/images/Image_706.jpg,706,"[array([[[108, 108,  99],
        [ 88,  84,  71],
        [ 77,  68,  58],
        ...,
        [156, 132, 141],
        [160, 141, 147],
        [147, 121, 135]],

       [[102,  98,  86],
        [ 87,  82,  70],
        [ 80,  72,  62],
        ...,
        [137, 118, 127],
        [172, 155, 159],
        [177, 155, 164]],

       [[ 97,  92,  81],
        [ 83,  77,  67],
        [ 80,  71,  65],
        ...,
        [ 96,  77,  88],
        [137, 114, 124],
        [169, 144, 157]],

       ...,

       [[  7, 110, 122],
        [  7, 111, 122],
        [  5, 112, 122],
        ...,
        [ 24, 115, 131],
        [ 33, 120, 139],
        [ 37, 124, 143]],

       [[  6, 109, 123],
        [  6, 110, 121],
        [  5, 112, 121],
        ...,
        [ 25, 116, 133],
        [ 33, 120, 139],
        [ 36, 122, 141]],

       [[  5, 110, 116],
        [  6, 110, 118],
        [  6, 110, 122],
        ...,
        [ 26, 112, 134],
        [ 34, 116, 141],
        [ 36, 119, 141]]], dtype=uint8)]"
Image_707.jpg,493,482,114,89,750,1000,607,571,114,daskShared_local/images/Image_707.jpg,707,"[array([[[  1,  72, 116],
        [  2,  72, 116],
        [  3,  74, 118],
        ...,
        [  2,  69, 114],
        [  2,  69, 114],
        [  1,  68, 113]],

       [[  1,  71, 115],
        [  1,  72, 116],
        [  3,  73, 117],
        ...,
        [  2,  69, 114],
        [  2,  69, 114],
        [  1,  68, 113]],

       [[  0,  70, 114],
        [  1,  71, 115],
        [  2,  73, 117],
        ...,
        [  0,  67, 112],
        [  1,  68, 113],
        [  2,  69, 114]],

       ...,

       [[ 40,  78,  63],
        [ 43,  82,  68],
        [ 53,  99,  88],
        ...,
        [  2,  61, 101],
        [  2,  61, 101],
        [  2,  61, 101]],

       [[ 22,  72,  63],
        [ 24,  75,  67],
        [ 30,  88,  83],
        ...,
        [  3,  62, 102],
        [  2,  61, 101],
        [  2,  61, 101]],

       [[ 17,  70,  63],
        [ 19,  73,  67],
        [ 24,  85,  82],
        ...,
        [  3,  62, 102],
        [  3,  62, 102],
        [  2,  61, 101]]], dtype=uint8)]"
Image_708.jpg,63,136,121,111,525,340,184,247,121,daskShared_local/images/Image_708.jpg,708,"[array([[[ 48,  99, 117],
        [ 51, 102, 119],
        [ 58, 110, 124],
        ...,
        [113, 145, 118],
        [139, 169, 140],
        [149, 178, 149]],

       [[ 46,  98, 116],
        [ 49, 101, 118],
        [ 57, 109, 124],
        ...,
        [137, 169, 141],
        [151, 181, 152],
        [156, 185, 155]],

       [[ 42,  93, 113],
        [ 45,  97, 116],
        [ 54, 107, 123],
        ...,
        [199, 229, 201],
        [182, 210, 181],
        [174, 202, 172]],

       ...,

       [[ 52,  59,  45],
        [ 57,  63,  52],
        [ 70,  71,  66],
        ...,
        [  1,  10,   1],
        [ 18,  34,  19],
        [ 25,  43,  27]],

       [[ 32,  36,  25],
        [ 36,  41,  31],
        [ 46,  52,  46],
        ...,
        [ 18,  32,  19],
        [ 20,  37,  22],
        [ 21,  39,  23]],

       [[ 24,  27,  17],
        [ 28,  32,  23],
        [ 37,  45,  38],
        ...,
        [ 25,  41,  26],
        [ 20,  38,  22],
        [ 19,  37,  21]]], dtype=uint8)]"
Image_709.jpg,820,191,218,210,1200,900,1038,401,218,daskShared_local/images/Image_709.jpg,709,"[array([[[187, 203, 216],
        [185, 201, 214],
        [185, 201, 214],
        ...,
        [190, 204, 217],
        [189, 203, 216],
        [189, 203, 216]],

       [[185, 201, 214],
        [186, 202, 215],
        [185, 201, 214],
        ...,
        [190, 204, 217],
        [190, 204, 217],
        [187, 203, 216]],

       [[185, 201, 214],
        [185, 201, 214],
        [185, 201, 214],
        ...,
        [190, 204, 217],
        [190, 204, 217],
        [188, 204, 217]],

       ...,

       [[185, 147, 119],
        [182, 143, 113],
        [177, 135, 102],
        ...,
        [ 76, 117, 156],
        [ 75, 114, 153],
        [ 74, 113, 152]],

       [[190, 151, 122],
        [188, 150, 123],
        [183, 142, 114],
        ...,
        [ 75, 116, 154],
        [ 74, 114, 154],
        [ 73, 112, 153]],

       [[187, 148, 119],
        [194, 158, 133],
        [196, 162, 138],
        ...,
        [ 77, 115, 154],
        [ 75, 114, 155],
        [ 74, 113, 154]]], dtype=uint8)]"
Image_71.jpg,310,301,167,137,966,642,477,438,167,daskShared_local/images/Image_71.jpg,71,"[array([[[ 18,  75,  48],
        [ 20,  83,  57],
        [ 17,  85,  74],
        ...,
        [157, 183, 174],
        [140, 159, 159],
        [142, 163, 165]],

       [[ 13,  77,  52],
        [ 12,  82,  58],
        [ 10,  85,  67],
        ...,
        [141, 163, 154],
        [155, 167, 162],
        [149, 175, 168]],

       [[  6,  81,  64],
        [  6,  85,  68],
        [  6,  90,  75],
        ...,
        [145, 163, 149],
        [150, 172, 159],
        [137, 170, 156]],

       ...,

       [[ 26, 195, 208],
        [ 23, 194, 207],
        [ 18, 196, 206],
        ...,
        [ 65, 228, 238],
        [ 66, 231, 241],
        [ 66, 232, 243]],

       [[ 26, 196, 209],
        [ 24, 197, 208],
        [ 23, 199, 209],
        ...,
        [ 72, 231, 242],
        [ 72, 234, 245],
        [ 71, 234, 244]],

       [[ 29, 201, 213],
        [ 27, 201, 212],
        [ 24, 199, 210],
        ...,
        [ 75, 234, 246],
        [ 75, 235, 247],
        [ 73, 233, 245]]], dtype=uint8)]"
Image_710.jpg,279,131,158,127,800,505,437,258,158,daskShared_local/images/Image_710.jpg,710,"[array([[[ 88, 102, 101],
        [ 74,  89,  87],
        [ 63,  79,  74],
        ...,
        [  7,  29,  42],
        [  6,  28,  41],
        [  5,  27,  38]],

       [[104, 119, 119],
        [ 89, 105, 103],
        [ 72,  88,  84],
        ...,
        [  6,  28,  42],
        [  6,  28,  41],
        [  5,  27,  39]],

       [[117, 135, 133],
        [101, 119, 116],
        [ 79,  96,  93],
        ...,
        [  6,  26,  40],
        [  5,  26,  39],
        [  4,  25,  38]],

       ...,

       [[ 87,  87,  54],
        [ 90,  87,  54],
        [ 96,  94,  58],
        ...,
        [ 75,  75,  58],
        [ 82,  81,  63],
        [ 86,  85,  66]],

       [[ 73,  72,  42],
        [ 83,  81,  49],
        [ 95,  93,  58],
        ...,
        [ 68,  68,  53],
        [ 72,  73,  56],
        [ 75,  76,  58]],

       [[ 66,  65,  34],
        [ 80,  79,  46],
        [ 96,  95,  59],
        ...,
        [ 62,  61,  45],
        [ 61,  62,  43],
        [ 61,  62,  42]]], dtype=uint8)]"
Image_711.jpg,1785,2539,511,472,2720,4080,2296,3011,511,daskShared_local/images/Image_711.jpg,711,"[array([[[165, 152, 128],
        [157, 152, 133],
        [154, 155, 140],
        ...,
        [  3, 123, 192],
        [  1, 120, 189],
        [  2, 122, 191]],

       [[125, 112,  93],
        [ 93,  85,  70],
        [ 76,  73,  59],
        ...,
        [  7, 124, 196],
        [  6, 123, 195],
        [  3, 119, 191]],

       [[100,  86,  70],
        [ 88,  75,  62],
        [ 77,  66,  51],
        ...,
        [  9, 125, 198],
        [  6, 121, 194],
        [  7, 123, 196]],

       ...,

       [[  2, 112, 186],
        [  5, 117, 191],
        [  2, 112, 186],
        ...,
        [  8, 118, 193],
        [  3, 113, 188],
        [  3, 111, 186]],

       [[  3, 115, 189],
        [  4, 116, 190],
        [  6, 118, 192],
        ...,
        [  3, 113, 188],
        [  4, 113, 188],
        [  6, 116, 191]],

       [[  1, 111, 185],
        [  3, 115, 189],
        [  4, 116, 190],
        ...,
        [  2, 112, 187],
        [  3, 113, 188],
        [  3, 111, 186]]], dtype=uint8)]"
Image_712.jpg,750,230,116,112,1024,516,866,342,116,daskShared_local/images/Image_712.jpg,712,"[array([[[198, 206, 209],
        [199, 206, 208],
        [201, 208, 208],
        ...,
        [  0, 144, 177],
        [  0, 142, 176],
        [  0, 142, 176]],

       [[193, 202, 205],
        [194, 202, 204],
        [195, 203, 203],
        ...,
        [  0, 144, 176],
        [  0, 143, 176],
        [  0, 142, 176]],

       [[178, 187, 191],
        [177, 187, 190],
        [175, 185, 186],
        ...,
        [  0, 143, 174],
        [  1, 144, 175],
        [  1, 144, 176]],

       ...,

       [[  0,  82, 107],
        [  1,  82, 107],
        [  2,  82, 109],
        ...,
        [  0,  53,  77],
        [  0,  52,  78],
        [  0,  51,  78]],

       [[  0,  82, 108],
        [  0,  82, 109],
        [  1,  82, 111],
        ...,
        [  1,  53,  77],
        [  1,  52,  77],
        [  1,  51,  77]],

       [[  0,  83, 109],
        [  0,  82, 110],
        [  0,  82, 111],
        ...,
        [  1,  53,  77],
        [  1,  52,  77],
        [  1,  51,  77]]], dtype=uint8)]"
Image_713.jpg,557,183,103,78,1000,700,660,261,103,daskShared_local/images/Image_713.jpg,713,"[array([[[  2, 159, 230],
        [  2, 159, 230],
        [  2, 159, 230],
        ...,
        [  0, 157, 228],
        [  0, 156, 229],
        [  0, 156, 230]],

       [[  2, 159, 230],
        [  2, 159, 230],
        [  2, 159, 230],
        ...,
        [  0, 157, 228],
        [  0, 156, 229],
        [  0, 156, 230]],

       [[  2, 158, 229],
        [  2, 158, 229],
        [  2, 158, 229],
        ...,
        [  0, 157, 228],
        [  0, 157, 229],
        [  0, 157, 230]],

       ...,

       [[121, 167, 184],
        [120, 166, 183],
        [103, 151, 171],
        ...,
        [  0, 150, 221],
        [  0, 149, 220],
        [  0, 149, 220]],

       [[100, 152, 168],
        [ 98, 150, 166],
        [ 70, 126, 144],
        ...,
        [  1, 149, 221],
        [  0, 148, 220],
        [  0, 148, 220]],

       [[ 99, 151, 166],
        [ 97, 149, 165],
        [ 67, 124, 142],
        ...,
        [  1, 149, 221],
        [  0, 148, 220],
        [  0, 148, 220]]], dtype=uint8)]"
Image_714.jpg,812,179,176,172,1120,922,988,351,176,daskShared_local/images/Image_714.jpg,714,"[array([[[  0, 157, 202],
        [  0, 146, 190],
        [  0, 141, 184],
        ...,
        [  0, 157, 181],
        [  0, 159, 181],
        [  1, 163, 186]],

       [[  1, 151, 194],
        [  0, 149, 191],
        [  0, 146, 186],
        ...,
        [  0, 164, 186],
        [  0, 165, 185],
        [  0, 165, 184]],

       [[  0, 148, 191],
        [  0, 153, 195],
        [  0, 152, 192],
        ...,
        [  0, 172, 192],
        [  0, 170, 188],
        [  0, 166, 183]],

       ...,

       [[194, 114,  32],
        [193, 123,  36],
        [189, 128,  37],
        ...,
        [  0, 152, 189],
        [  0, 149, 182],
        [  0, 148, 181]],

       [[201, 118,  45],
        [192, 115,  26],
        [182, 112,   9],
        ...,
        [  0, 151, 188],
        [  0, 151, 185],
        [  0, 152, 183]],

       [[191, 103,  17],
        [189, 108,  20],
        [186, 113,  17],
        ...,
        [  0, 153, 190],
        [  0, 153, 188],
        [  0, 156, 187]]], dtype=uint8)]"
Image_715.jpg,164,9,103,101,498,272,267,110,103,daskShared_local/images/Image_715.jpg,715,"[array([[[  2,  37,  74],
        [  2,  37,  74],
        [  3,  38,  75],
        ...,
        [  2,  29,  53],
        [  2,  30,  54],
        [  2,  30,  54]],

       [[  2,  37,  74],
        [  2,  37,  74],
        [  3,  38,  75],
        ...,
        [  2,  29,  53],
        [  2,  30,  54],
        [  2,  30,  54]],

       [[  1,  39,  76],
        [  1,  39,  76],
        [  2,  39,  76],
        ...,
        [  3,  29,  53],
        [  3,  30,  54],
        [  3,  30,  54]],

       ...,

       [[103, 104,  86],
        [102, 103,  86],
        [ 91,  95,  88],
        ...,
        [152, 165, 153],
        [165, 178, 168],
        [166, 179, 169]],

       [[101, 103,  96],
        [101, 103,  97],
        [ 99, 103, 104],
        ...,
        [166, 179, 166],
        [181, 195, 183],
        [183, 196, 185]],

       [[101, 102,  97],
        [101, 103,  97],
        [100, 104, 105],
        ...,
        [167, 180, 167],
        [183, 196, 185],
        [184, 197, 186]]], dtype=uint8)]"
Image_716.jpg,294,166,221,201,1000,664,515,367,221,daskShared_local/images/Image_716.jpg,716,"[array([[[  1,  80, 149],
        [  1,  80, 147],
        [  0,  79, 147],
        ...,
        [  1,  99, 169],
        [  0,  98, 169],
        [  1, 102, 170]],

       [[  1,  80, 147],
        [  0,  80, 147],
        [  0,  79, 146],
        ...,
        [  0,  99, 168],
        [  0, 100, 168],
        [  0, 100, 168]],

       [[  0,  79, 147],
        [  1,  79, 146],
        [  1,  80, 147],
        ...,
        [  0,  99, 167],
        [  0,  99, 168],
        [  0,  98, 169]],

       ...,

       [[ 69,  74,  48],
        [ 52,  52,  34],
        [ 44,  46,  38],
        ...,
        [209, 190, 157],
        [203, 182, 130],
        [212, 196, 156]],

       [[ 41,  50,  36],
        [ 36,  40,  34],
        [ 38,  41,  36],
        ...,
        [211, 199, 178],
        [198, 182, 143],
        [206, 195, 163]],

       [[ 37,  52,  41],
        [ 32,  43,  34],
        [ 32,  37,  32],
        ...,
        [205, 196, 182],
        [190, 173, 143],
        [199, 186, 161]]], dtype=uint8)]"
Image_717.jpg,418,139,233,235,1024,686,651,374,235,daskShared_local/images/Image_717.jpg,717,"[array([[[ 31, 187, 238],
        [ 31, 187, 238],
        [ 30, 186, 237],
        ...,
        [  0, 156, 217],
        [  0, 156, 217],
        [  1, 157, 218]],

       [[ 30, 186, 237],
        [ 30, 186, 237],
        [ 30, 186, 237],
        ...,
        [  0, 156, 217],
        [  0, 156, 217],
        [  1, 157, 218]],

       [[ 30, 186, 237],
        [ 30, 186, 237],
        [ 30, 186, 237],
        ...,
        [  0, 156, 217],
        [  0, 156, 217],
        [  1, 157, 218]],

       ...,

       [[200, 179, 173],
        [213, 195, 189],
        [228, 215, 211],
        ...,
        [  2, 115, 181],
        [  3, 116, 182],
        [  3, 116, 182]],

       [[211, 193, 188],
        [216, 201, 196],
        [226, 214, 208],
        ...,
        [  2, 115, 181],
        [  3, 116, 182],
        [  5, 118, 184]],

       [[233, 219, 216],
        [228, 214, 208],
        [231, 218, 211],
        ...,
        [  3, 116, 182],
        [  4, 117, 183],
        [  4, 117, 183]]], dtype=uint8)]"
Image_718.jpg,398,139,211,199,869,574,609,338,211,daskShared_local/images/Image_718.jpg,718,"[array([[[  5, 135, 211],
        [  2, 133, 209],
        [  4, 140, 214],
        ...,
        [ 78, 165, 242],
        [ 78, 165, 242],
        [ 76, 166, 242]],

       [[  6, 141, 213],
        [  5, 139, 212],
        [  4, 136, 210],
        ...,
        [ 75, 165, 241],
        [ 74, 164, 240],
        [ 74, 164, 240]],

       [[  0, 138, 207],
        [  1, 136, 205],
        [  6, 139, 211],
        ...,
        [ 73, 163, 239],
        [ 72, 163, 239],
        [ 73, 164, 240]],

       ...,

       [[ 10,  51,  40],
        [  2,  38,  27],
        [  2,  27,  22],
        ...,
        [  0, 108, 181],
        [  0, 108, 181],
        [  0, 106, 180]],

       [[  7,  31,  27],
        [  2,  14,  14],
        [  2,  20,  19],
        ...,
        [  0, 108, 181],
        [  0, 108, 181],
        [  2, 105, 180]],

       [[  9,  23,  23],
        [  5,  11,  13],
        [  2,  14,  15],
        ...,
        [  0, 108, 181],
        [  0, 108, 181],
        [  2, 105, 180]]], dtype=uint8)]"
Image_719.jpg,1407,421,491,437,2500,1667,1898,858,491,daskShared_local/images/Image_719.jpg,719,"[array([[[ 85, 156, 172],
        [ 86, 154, 170],
        [ 91, 158, 175],
        ...,
        [192, 199, 215],
        [181, 184, 199],
        [177, 177, 190]],

       [[ 81, 157, 172],
        [ 84, 156, 170],
        [ 90, 161, 174],
        ...,
        [219, 223, 237],
        [210, 211, 225],
        [211, 211, 224]],

       [[ 84, 159, 175],
        [ 81, 157, 170],
        [ 84, 159, 171],
        ...,
        [232, 236, 247],
        [232, 235, 246],
        [233, 236, 246]],

       ...,

       [[175, 166, 108],
        [172, 162, 108],
        [149, 136,  92],
        ...,
        [  3, 132, 171],
        [  1, 129, 168],
        [  0, 125, 165]],

       [[171, 161, 112],
        [141, 129,  81],
        [125, 113,  69],
        ...,
        [  1, 140, 173],
        [  1, 138, 173],
        [  0, 134, 170]],

       [[138, 128,  77],
        [109, 100,  45],
        [111, 101,  48],
        ...,
        [  1, 140, 174],
        [  0, 138, 173],
        [  1, 133, 170]]], dtype=uint8)]"
Image_72.jpg,732,344,196,157,1600,1000,928,501,196,daskShared_local/images/Image_72.jpg,72,"[array([[[  2,  83, 165],
        [  2,  83, 165],
        [  2,  83, 165],
        ...,
        [  0,  81, 163],
        [  0,  81, 163],
        [  0,  81, 163]],

       [[  2,  83, 165],
        [  2,  83, 165],
        [  2,  83, 165],
        ...,
        [  0,  81, 163],
        [  0,  81, 163],
        [  0,  81, 163]],

       [[  2,  83, 165],
        [  2,  83, 165],
        [  2,  83, 165],
        ...,
        [  0,  81, 163],
        [  0,  81, 163],
        [  0,  81, 163]],

       ...,

       [[102, 114, 102],
        [134, 160, 151],
        [165, 199, 193],
        ...,
        [200, 191, 182],
        [198, 184, 171],
        [194, 176, 160]],

       [[156, 178, 165],
        [194, 228, 212],
        [176, 219, 202],
        ...,
        [214, 192, 181],
        [219, 191, 179],
        [215, 186, 170]],

       [[191, 213, 201],
        [182, 213, 198],
        [143, 180, 162],
        ...,
        [217, 191, 176],
        [214, 183, 165],
        [245, 210, 191]]], dtype=uint8)]"
Image_720.jpg,407,353,310,239,1536,1024,717,592,310,daskShared_local/images/Image_720.jpg,720,"[array([[[ 12, 137, 243],
        [ 14, 139, 245],
        [ 15, 140, 246],
        ...,
        [ 22, 189, 255],
        [ 16, 179, 250],
        [ 11, 172, 244]],

       [[  7, 136, 238],
        [  8, 139, 240],
        [  8, 139, 240],
        ...,
        [ 16, 179, 246],
        [ 14, 177, 245],
        [ 10, 171, 242]],

       [[ 12, 141, 242],
        [ 12, 143, 243],
        [ 11, 143, 243],
        ...,
        [ 15, 178, 245],
        [ 13, 176, 244],
        [  9, 171, 240]],

       ...,

       [[ 10,  62, 210],
        [  9,  61, 209],
        [ 10,  62, 210],
        ...,
        [ 13,  66,  55],
        [ 29,  89,  92],
        [ 21,  84,  86]],

       [[ 10,  62, 210],
        [ 10,  62, 210],
        [ 10,  62, 210],
        ...,
        [ 30,  55,  48],
        [ 24,  67,  57],
        [ 17,  55,  51]],

       [[  9,  61, 208],
        [  9,  61, 208],
        [  9,  61, 208],
        ...,
        [ 28,  50,  39],
        [ 17,  46,  36],
        [ 33,  58,  53]]], dtype=uint8)]"
Image_721.jpg,724,436,466,335,2119,1414,1190,771,466,daskShared_local/images/Image_721.jpg,721,"[array([[[109, 173, 200],
        [111, 175, 202],
        [107, 171, 198],
        ...,
        [ 75, 137, 168],
        [ 74, 137, 170],
        [ 79, 142, 173]],

       [[106, 167, 195],
        [101, 163, 191],
        [103, 164, 192],
        ...,
        [ 79, 143, 172],
        [ 71, 136, 166],
        [ 72, 137, 167]],

       [[105, 165, 193],
        [101, 160, 189],
        [102, 162, 190],
        ...,
        [ 82, 147, 177],
        [ 76, 141, 171],
        [ 72, 137, 167]],

       ...,

       [[ 81, 175, 200],
        [ 81, 175, 200],
        [ 81, 175, 200],
        ...,
        [152, 126,  94],
        [143, 119,  85],
        [139, 121,  91]],

       [[ 82, 176, 201],
        [ 81, 175, 200],
        [ 81, 175, 200],
        ...,
        [155, 128,  83],
        [146, 120,  79],
        [131, 122,  89]],

       [[ 82, 176, 201],
        [ 82, 176, 201],
        [ 82, 176, 201],
        ...,
        [177, 161, 131],
        [143, 134, 115],
        [111, 126, 109]]], dtype=uint8)]"
Image_722.jpg,596,212,312,276,924,924,908,488,312,daskShared_local/images/Image_722.jpg,722,"[array([[[ 86, 137, 167],
        [ 69, 140, 169],
        [ 48, 139, 168],
        ...,
        [  2, 133, 161],
        [  1, 132, 160],
        [  1, 132, 160]],

       [[119, 125, 159],
        [117, 135, 171],
        [115, 149, 186],
        ...,
        [  2, 133, 161],
        [  3, 134, 162],
        [  3, 134, 162]],

       [[143, 130, 169],
        [121, 109, 152],
        [107, 103, 149],
        ...,
        [  3, 134, 162],
        [  3, 134, 162],
        [  3, 134, 162]],

       ...,

       [[ 66,  61,  34],
        [ 83,  77,  52],
        [ 81,  75,  52],
        ...,
        [ 62,  52,  26],
        [ 64,  54,  26],
        [ 60,  50,  21]],

       [[ 48,  42,  18],
        [ 53,  47,  24],
        [ 51,  44,  24],
        ...,
        [ 64,  54,  32],
        [ 64,  54,  31],
        [ 54,  45,  20]],

       [[ 56,  50,  29],
        [ 62,  56,  36],
        [ 53,  46,  27],
        ...,
        [ 58,  50,  30],
        [ 63,  55,  33],
        [ 62,  54,  32]]], dtype=uint8)]"
Image_723.png,245,33,78,83,589,295,323,116,83,daskShared_local/images/Image_723.png,723,"[array([[[  0, 171, 186],
        [  0, 172, 187],
        [  0, 169, 184],
        ...,
        [  0, 169, 192],
        [  0, 170, 194],
        [  0, 170, 193]],

       [[  0, 171, 185],
        [  0, 172, 186],
        [  0, 170, 184],
        ...,
        [  0, 170, 193],
        [  0, 170, 196],
        [  0, 170, 195]],

       [[  0, 171, 187],
        [  0, 172, 188],
        [  0, 169, 184],
        ...,
        [  0, 169, 190],
        [  0, 169, 192],
        [  0, 169, 191]],

       ...,

       [[ 70,  29,  22],
        [ 69,  27,  20],
        [ 71,  31,  27],
        ...,
        [126,  76,  70],
        [118,  68,  63],
        [121,  71,  66]],

       [[ 71,  31,  26],
        [ 70,  30,  25],
        [ 71,  32,  29],
        ...,
        [167, 103,  94],
        [161, 101,  93],
        [163, 102,  93]],

       [[ 70,  30,  25],
        [ 70,  29,  23],
        [ 71,  32,  28],
        ...,
        [151,  93,  85],
        [145,  88,  81],
        [147,  90,  83]]], dtype=uint8)]"
Image_724.jpeg,649,146,247,234,1200,800,896,380,247,daskShared_local/images/Image_724.jpeg,724,"[array([[[168, 208, 220],
        [168, 208, 219],
        [175, 215, 225],
        ...,
        [181, 214, 231],
        [181, 214, 231],
        [182, 215, 232]],

       [[170, 207, 220],
        [174, 211, 222],
        [180, 217, 228],
        ...,
        [180, 213, 230],
        [180, 213, 230],
        [179, 212, 229]],

       [[175, 211, 225],
        [182, 217, 229],
        [185, 220, 232],
        ...,
        [179, 212, 229],
        [179, 212, 229],
        [177, 210, 227]],

       ...,

       [[ 81,  37,   1],
        [109,  67,  18],
        [102,  63,  20],
        ...,
        [192, 137, 130],
        [157,  90,  78],
        [152,  78,  61]],

       [[ 65,  24,   0],
        [ 95,  55,  12],
        [ 77,  39,  10],
        ...,
        [142,  99,  87],
        [141,  91,  63],
        [128,  74,  36]],

       [[ 89,  47,   2],
        [110,  68,  24],
        [ 86,  47,  12],
        ...,
        [186, 144, 135],
        [205, 156, 134],
        [184, 131,  99]]], dtype=uint8)]"
Image_725.jpg,336,135,265,223,845,563,601,358,265,daskShared_local/images/Image_725.jpg,725,"[array([[[180, 228, 236],
        [178, 229, 237],
        [169, 229, 235],
        ...,
        [ 83, 198, 195],
        [ 86, 198, 197],
        [ 88, 197, 197]],

       [[177, 228, 238],
        [174, 229, 237],
        [167, 228, 236],
        ...,
        [ 81, 198, 196],
        [ 82, 197, 196],
        [ 82, 196, 195]],

       [[165, 227, 235],
        [162, 226, 234],
        [158, 225, 233],
        ...,
        [ 77, 197, 196],
        [ 79, 196, 196],
        [ 79, 194, 194]],

       ...,

       [[ 55,  94,  31],
        [ 58,  98,  35],
        [ 59, 101,  37],
        ...,
        [ 28, 188, 180],
        [ 26, 188, 180],
        [ 32, 195, 185]],

       [[ 55, 102,  36],
        [ 64, 111,  46],
        [ 72, 120,  54],
        ...,
        [ 26, 185, 179],
        [ 22, 184, 178],
        [ 24, 188, 181]],

       [[ 61, 112,  43],
        [ 68, 119,  50],
        [ 74, 125,  57],
        ...,
        [ 32, 187, 183],
        [ 28, 186, 182],
        [ 28, 188, 183]]], dtype=uint8)]"
Image_726.jpg,3212,737,821,914,5616,2633,4033,1651,914,daskShared_local/images/Image_726.jpg,726,"[array([[[  0, 201, 247],
        [  0, 201, 247],
        [  0, 201, 247],
        ...,
        [  0, 211, 255],
        [  0, 211, 255],
        [  0, 212, 254]],

       [[  0, 201, 247],
        [  0, 200, 246],
        [  0, 199, 246],
        ...,
        [  0, 210, 255],
        [  0, 211, 255],
        [  0, 211, 255]],

       [[  0, 201, 247],
        [  0, 200, 246],
        [  0, 200, 246],
        ...,
        [  1, 209, 255],
        [  0, 210, 255],
        [  0, 211, 255]],

       ...,

       [[ 14, 152, 160],
        [  3, 123, 140],
        [  1, 129, 154],
        ...,
        [146, 122, 104],
        [152, 128, 112],
        [136, 107,  90]],

       [[ 73, 193, 188],
        [ 53, 171, 171],
        [ 17, 133, 142],
        ...,
        [108,  86,  72],
        [126,  97,  86],
        [160, 130, 123]],

       [[ 89, 202, 195],
        [115, 213, 200],
        [ 88, 197, 190],
        ...,
        [110,  81,  74],
        [131,  94,  91],
        [170, 140, 136]]], dtype=uint8)]"
Image_727.jpg,228,192,155,165,500,559,383,357,165,daskShared_local/images/Image_727.jpg,727,"[array([[[186, 197, 180],
        [165, 191, 181],
        [149, 183, 179],
        ...,
        [140, 220, 207],
        [139, 223, 209],
        [136, 223, 207]],

       [[213, 204, 171],
        [202, 205, 182],
        [191, 201, 185],
        ...,
        [133, 218, 208],
        [131, 220, 209],
        [128, 219, 207]],

       [[221, 195, 148],
        [220, 194, 156],
        [217, 194, 161],
        ...,
        [116, 214, 205],
        [115, 215, 204],
        [115, 215, 205]],

       ...,

       [[ 26,  15,   0],
        [ 19,   9,   0],
        [ 19,   9,   0],
        ...,
        [  0, 182, 188],
        [  0, 181, 183],
        [  1, 180, 178]],

       [[ 25,  14,   1],
        [ 20,   9,   2],
        [ 22,  11,   2],
        ...,
        [  1, 185, 195],
        [  1, 186, 192],
        [  2, 186, 190]],

       [[ 24,  11,   4],
        [ 31,  19,   6],
        [ 32,  20,   6],
        ...,
        [  3, 182, 191],
        [  3, 182, 189],
        [  4, 182, 187]]], dtype=uint8)]"
Image_728.jpg,450,231,161,161,900,586,611,392,161,daskShared_local/images/Image_728.jpg,728,"[array([[[  0, 174, 208],
        [  0, 174, 208],
        [  0, 174, 209],
        ...,
        [ 98, 203, 224],
        [ 99, 204, 225],
        [100, 205, 226]],

       [[  0, 171, 210],
        [  0, 173, 211],
        [  1, 175, 212],
        ...,
        [ 97, 203, 224],
        [ 99, 204, 225],
        [ 99, 204, 226]],

       [[ 36, 174, 207],
        [ 25, 171, 204],
        [ 15, 170, 202],
        ...,
        [ 96, 202, 224],
        [ 97, 203, 225],
        [ 98, 203, 225]],

       ...,

       [[  0,  47,  40],
        [  0,  39,  33],
        [  0,  32,  29],
        ...,
        [  1, 163, 209],
        [  1, 163, 209],
        [  1, 163, 209]],

       [[  1,  39,  32],
        [  2,  32,  28],
        [  4,  27,  25],
        ...,
        [  1, 163, 209],
        [  1, 163, 209],
        [  1, 163, 209]],

       [[  2,  45,  40],
        [  7,  44,  41],
        [ 11,  42,  42],
        ...,
        [  1, 163, 209],
        [  1, 163, 209],
        [  1, 163, 209]]], dtype=uint8)]"
Image_729.jpg,35,77,225,175,800,600,260,252,225,daskShared_local/images/Image_729.jpg,729,"[array([[[  4, 156, 206],
        [ 12, 164, 211],
        [ 17, 168, 216],
        ...,
        [ 13, 174, 220],
        [ 16, 174, 220],
        [ 20, 175, 223]],

       [[  3, 155, 205],
        [ 10, 161, 209],
        [ 20, 170, 219],
        ...,
        [ 13, 174, 220],
        [ 20, 178, 225],
        [ 22, 178, 226]],

       [[  1, 154, 204],
        [  6, 158, 207],
        [ 14, 163, 214],
        ...,
        [ 15, 175, 219],
        [ 20, 176, 224],
        [ 21, 176, 224]],

       ...,

       [[ 57, 123, 109],
        [ 57, 125, 107],
        [ 63, 128, 112],
        ...,
        [ 96,  66,  44],
        [ 95,  62,  42],
        [ 97,  65,  46]],

       [[ 52, 117, 101],
        [ 51, 115,  99],
        [ 62, 125, 108],
        ...,
        [ 97,  62,  42],
        [ 95,  57,  41],
        [102,  66,  48]],

       [[ 56, 120, 104],
        [ 55, 119, 102],
        [ 63, 126, 108],
        ...,
        [ 87,  48,  31],
        [ 86,  43,  29],
        [ 90,  48,  34]]], dtype=uint8)]"
Image_73.jpg,407,320,137,138,800,600,544,458,138,daskShared_local/images/Image_73.jpg,73,"[array([[[197, 173, 134],
        [203, 177, 139],
        [210, 185, 149],
        ...,
        [  2,  94, 105],
        [  3,  92, 103],
        [  3,  91, 101]],

       [[197, 170, 135],
        [201, 170, 135],
        [208, 176, 141],
        ...,
        [  4,  95, 106],
        [  4,  93, 104],
        [  3,  91, 101]],

       [[196, 165, 136],
        [197, 162, 130],
        [202, 165, 130],
        ...,
        [  6,  96, 107],
        [  5,  93, 104],
        [  3,  90, 100]],

       ...,

       [[ 29,  54,  53],
        [ 29,  54,  52],
        [ 29,  54,  50],
        ...,
        [ 33, 104,  62],
        [ 30, 104,  59],
        [ 30, 105,  60]],

       [[ 27,  54,  53],
        [ 28,  54,  52],
        [ 29,  54,  51],
        ...,
        [ 30,  98,  60],
        [ 33, 104,  62],
        [ 37, 111,  64]],

       [[ 24,  52,  50],
        [ 26,  53,  51],
        [ 28,  54,  51],
        ...,
        [ 33, 103,  69],
        [ 39, 110,  71],
        [ 45, 117,  73]]], dtype=uint8)]"
Image_730.jpg,695,272,466,512,1920,1080,1161,784,512,daskShared_local/images/Image_730.jpg,730,"[array([[[  0, 119, 203],
        [  0, 119, 203],
        [  0, 119, 203],
        ...,
        [  2, 117, 200],
        [  2, 117, 200],
        [  2, 117, 200]],

       [[  0, 119, 203],
        [  0, 119, 203],
        [  0, 119, 203],
        ...,
        [  2, 117, 200],
        [  2, 117, 200],
        [  2, 117, 200]],

       [[  0, 119, 203],
        [  0, 119, 203],
        [  0, 119, 203],
        ...,
        [  2, 117, 200],
        [  2, 117, 200],
        [  2, 117, 200]],

       ...,

       [[ 65,  71,  53],
        [ 75,  85,  65],
        [ 76,  88,  63],
        ...,
        [195, 182, 147],
        [200, 187, 152],
        [187, 176, 140]],

       [[ 70,  79,  61],
        [ 78,  91,  72],
        [113, 127, 105],
        ...,
        [201, 191, 158],
        [218, 210, 174],
        [202, 195, 159]],

       [[ 81,  94,  73],
        [105, 121, 100],
        [124, 142, 119],
        ...,
        [178, 171, 141],
        [199, 193, 161],
        [194, 189, 155]]], dtype=uint8)]"
Image_731.jpg,1721,535,1433,1606,4631,3087,3154,2141,1606,daskShared_local/images/Image_731.jpg,731,"[array([[[ 20,  94, 241],
        [ 20,  94, 240],
        [ 20,  93, 240],
        ...,
        [  1,  59, 196],
        [  1,  60, 196],
        [  0,  59, 195]],

       [[ 20,  93, 240],
        [ 20,  93, 240],
        [ 20,  93, 240],
        ...,
        [  1,  59, 195],
        [  1,  59, 195],
        [  1,  59, 194]],

       [[ 21,  92, 239],
        [ 21,  92, 239],
        [ 21,  92, 240],
        ...,
        [  0,  58, 194],
        [  1,  59, 193],
        [  1,  59, 193]],

       ...,

       [[ 33,  38,  47],
        [ 69,  68,  71],
        [121, 111,  93],
        ...,
        [ 29,  37,  17],
        [ 39,  47,  24],
        [ 55,  63,  37]],

       [[ 30,  37,  43],
        [ 59,  57,  57],
        [107,  94,  80],
        ...,
        [ 33,  41,  19],
        [ 44,  51,  27],
        [ 47,  54,  32]],

       [[ 28,  35,  40],
        [ 49,  46,  46],
        [ 91,  74,  65],
        ...,
        [ 37,  43,  22],
        [ 36,  43,  23],
        [ 30,  38,  20]]], dtype=uint8)]"
Image_732.jpg,451,287,164,162,850,567,615,449,164,daskShared_local/images/Image_732.jpg,732,"[array([[[163, 104, 100],
        [168, 108,  92],
        [193, 136, 110],
        ...,
        [169, 147, 129],
        [186, 170, 149],
        [163, 150, 148]],

       [[187, 134, 119],
        [209, 156, 128],
        [225, 172, 137],
        ...,
        [128, 113, 109],
        [182, 163, 142],
        [206, 185, 163]],

       [[218, 162, 134],
        [224, 170, 132],
        [221, 165, 124],
        ...,
        [ 84,  72,  82],
        [136, 116, 105],
        [195, 170, 144]],

       ...,

       [[  8, 123, 235],
        [  9, 124, 235],
        [  9, 124, 235],
        ...,
        [ 11, 129, 235],
        [ 11, 129, 235],
        [ 10, 128, 234]],

       [[  9, 125, 236],
        [  9, 125, 236],
        [  8, 124, 235],
        ...,
        [ 10, 128, 234],
        [ 11, 129, 235],
        [ 10, 128, 234]],

       [[ 10, 126, 237],
        [  9, 125, 236],
        [  8, 124, 235],
        ...,
        [  9, 127, 233],
        [ 10, 128, 234],
        [ 10, 128, 234]]], dtype=uint8)]"
Image_733.jpg,627,221,127,105,1000,667,754,326,127,daskShared_local/images/Image_733.jpg,733,"[array([[[ 76, 140, 140],
        [ 75, 139, 139],
        [ 74, 137, 136],
        ...,
        [  2,  86,  97],
        [  1,  88,  99],
        [  1,  88, 100]],

       [[ 77, 141, 141],
        [ 76, 140, 140],
        [ 75, 138, 138],
        ...,
        [  4,  88, 100],
        [  2,  89, 101],
        [  2,  89, 101]],

       [[ 79, 143, 143],
        [ 78, 142, 142],
        [ 77, 140, 140],
        ...,
        [  8,  92, 105],
        [  6,  91, 104],
        [  5,  91, 104]],

       ...,

       [[ 98, 103,  80],
        [103, 109,  87],
        [118, 126, 106],
        ...,
        [ 22, 106, 120],
        [ 33, 118, 131],
        [ 39, 124, 137]],

       [[ 91,  93,  66],
        [ 92,  94,  68],
        [ 98, 102,  76],
        ...,
        [ 43, 127, 140],
        [ 53, 137, 149],
        [ 57, 141, 153]],

       [[ 90,  90,  62],
        [ 90,  90,  61],
        [ 91,  92,  64],
        ...,
        [ 54, 137, 149],
        [ 63, 145, 157],
        [ 66, 149, 160]]], dtype=uint8)]"
Image_734.jpg,628,315,180,153,1400,933,808,468,180,daskShared_local/images/Image_734.jpg,734,"[array([[[  0, 175, 230],
        [  1, 176, 231],
        [  1, 176, 231],
        ...,
        [  2, 205, 245],
        [  2, 205, 245],
        [  2, 205, 245]],

       [[  0, 175, 230],
        [  0, 175, 230],
        [  0, 175, 230],
        ...,
        [  0, 202, 242],
        [  0, 202, 242],
        [  0, 202, 242]],

       [[  1, 174, 230],
        [  1, 174, 230],
        [  1, 174, 230],
        ...,
        [  0, 202, 242],
        [  0, 202, 242],
        [  0, 202, 242]],

       ...,

       [[156, 130, 111],
        [221, 196, 180],
        [250, 230, 216],
        ...,
        [  1, 185, 237],
        [  1, 185, 237],
        [  1, 185, 237]],

       [[144, 134, 121],
        [224, 211, 202],
        [249, 241, 234],
        ...,
        [  0, 184, 236],
        [  0, 184, 236],
        [  0, 184, 236]],

       [[158, 149, 133],
        [230, 220, 207],
        [236, 224, 215],
        ...,
        [  0, 184, 236],
        [  0, 184, 236],
        [  0, 184, 236]]], dtype=uint8)]"
Image_735.jpg,162,173,174,146,728,500,336,319,174,daskShared_local/images/Image_735.jpg,735,"[array([[[  0,  71, 221],
        [  1,  73, 220],
        [  1,  72, 219],
        ...,
        [  0,  78, 226],
        [  0,  78, 226],
        [  1,  76, 227]],

       [[  2,  72, 220],
        [  1,  71, 219],
        [  1,  71, 218],
        ...,
        [  0,  79, 224],
        [  0,  79, 225],
        [  1,  79, 225]],

       [[  1,  69, 218],
        [  1,  69, 217],
        [  1,  69, 217],
        ...,
        [  0,  79, 224],
        [  0,  79, 224],
        [  0,  79, 224]],

       ...,

       [[ 23, 137, 152],
        [ 22, 141, 148],
        [ 16, 134, 143],
        ...,
        [249, 251, 235],
        [248, 251, 232],
        [248, 252, 232]],

       [[ 19, 129, 141],
        [ 19, 131, 139],
        [ 18, 132, 140],
        ...,
        [248, 249, 231],
        [248, 250, 230],
        [248, 249, 231]],

       [[ 22, 124, 138],
        [ 23, 126, 138],
        [ 25, 132, 142],
        ...,
        [249, 252, 231],
        [247, 249, 228],
        [248, 249, 231]]], dtype=uint8)]"
Image_736.jpg,606,216,400,437,1600,1070,1006,653,437,daskShared_local/images/Image_736.jpg,736,"[array([[[ 22,  75, 145],
        [ 22,  75, 145],
        [ 24,  74, 145],
        ...,
        [ 28,  69, 133],
        [ 28,  69, 133],
        [ 29,  69, 133]],

       [[ 22,  75, 145],
        [ 22,  75, 145],
        [ 24,  74, 145],
        ...,
        [ 28,  69, 133],
        [ 28,  69, 133],
        [ 29,  69, 133]],

       [[ 22,  75, 145],
        [ 22,  75, 145],
        [ 24,  74, 145],
        ...,
        [ 28,  69, 133],
        [ 28,  69, 133],
        [ 29,  69, 133]],

       ...,

       [[153, 135, 102],
        [128, 110,  78],
        [116, 105,  80],
        ...,
        [173, 134,  78],
        [203, 166,  97],
        [247, 218, 169]],

       [[218, 187, 141],
        [181, 150, 102],
        [117,  98,  57],
        ...,
        [237, 191, 131],
        [245, 204, 136],
        [252, 221, 174]],

       [[225, 197, 152],
        [233, 203, 154],
        [184, 157, 110],
        ...,
        [252, 211, 152],
        [246, 208, 151],
        [247, 215, 173]]], dtype=uint8)]"
Image_737.jpg,512,241,326,229,1200,900,838,470,326,daskShared_local/images/Image_737.jpg,737,"[array([[[ 58, 179, 189],
        [ 46, 170, 173],
        [ 65, 171, 187],
        ...,
        [ 79, 187, 204],
        [ 84, 188, 203],
        [ 73, 185, 201]],

       [[ 59, 180, 196],
        [ 27, 170, 178],
        [ 56, 174, 183],
        ...,
        [ 70, 184, 199],
        [ 79, 188, 211],
        [ 77, 187, 209]],

       [[ 66, 179, 187],
        [ 25, 164, 170],
        [ 44, 171, 183],
        ...,
        [ 88, 189, 204],
        [ 95, 192, 204],
        [ 87, 190, 210]],

       ...,

       [[144, 170, 164],
        [158, 198, 202],
        [219, 237, 241],
        ...,
        [139, 206, 220],
        [150, 208, 223],
        [152, 210, 223]],

       [[157, 198, 190],
        [222, 238, 240],
        [222, 240, 244],
        ...,
        [125, 200, 217],
        [142, 205, 222],
        [134, 200, 215]],

       [[193, 223, 226],
        [208, 233, 234],
        [222, 238, 242],
        ...,
        [139, 203, 219],
        [142, 206, 216],
        [126, 198, 209]]], dtype=uint8)]"
Image_738.jpg,655,283,308,331,1600,1000,963,614,331,daskShared_local/images/Image_738.jpg,738,"[array([[[  0,  71, 163],
        [  0,  71, 163],
        [  0,  71, 163],
        ...,
        [  2,  69, 160],
        [  2,  69, 160],
        [  1,  68, 159]],

       [[  0,  71, 162],
        [  0,  71, 163],
        [  0,  71, 163],
        ...,
        [  2,  69, 160],
        [  2,  69, 160],
        [  1,  68, 159]],

       [[  0,  71, 162],
        [  0,  71, 163],
        [  0,  71, 163],
        ...,
        [  2,  69, 160],
        [  2,  69, 160],
        [  1,  68, 159]],

       ...,

       [[ 39,  54,  27],
        [ 94, 109,  78],
        [ 87,  95,  57],
        ...,
        [118,  99,  55],
        [100,  86,  42],
        [ 76,  67,  24]],

       [[ 42,  56,  35],
        [ 39,  54,  30],
        [ 76,  82,  52],
        ...,
        [105,  89,  56],
        [101,  86,  57],
        [ 95,  81,  54]],

       [[ 37,  52,  34],
        [ 26,  40,  24],
        [ 55,  59,  40],
        ...,
        [141, 127,  94],
        [121, 107,  76],
        [127, 111,  83]]], dtype=uint8)]"
Image_739.jpg,108,78,93,63,475,264,201,141,93,daskShared_local/images/Image_739.jpg,739,"[array([[[ 22,  43,  62],
        [ 22,  43,  62],
        [ 20,  41,  60],
        ...,
        [ 41,  69,  99],
        [ 37,  65,  94],
        [ 37,  65,  94]],

       [[ 22,  43,  62],
        [ 22,  43,  62],
        [ 20,  41,  60],
        ...,
        [ 40,  69,  98],
        [ 36,  64,  93],
        [ 37,  65,  94]],

       [[ 21,  43,  62],
        [ 21,  44,  62],
        [ 21,  42,  60],
        ...,
        [ 44,  73, 102],
        [ 40,  69,  98],
        [ 41,  70,  98]],

       ...,

       [[ 11,  20,  29],
        [ 11,  20,  29],
        [ 12,  21,  30],
        ...,
        [ 32,  45,  50],
        [ 36,  49,  53],
        [ 36,  48,  52]],

       [[ 11,  20,  29],
        [ 11,  20,  29],
        [ 12,  21,  30],
        ...,
        [ 36,  51,  55],
        [ 38,  52,  55],
        [ 38,  52,  55]],

       [[ 11,  20,  29],
        [ 11,  20,  29],
        [ 12,  21,  30],
        ...,
        [ 36,  50,  54],
        [ 38,  51,  55],
        [ 38,  51,  55]]], dtype=uint8)]"
Image_74.jpg,679,301,530,487,1920,1080,1209,788,530,daskShared_local/images/Image_74.jpg,74,"[array([[[ 14,  35,  43],
        [ 19,  40,  42],
        [ 31,  51,  49],
        ...,
        [ 70,  85,  83],
        [ 75,  90,  87],
        [ 66,  81,  78]],

       [[  8,  26,  43],
        [ 15,  36,  46],
        [ 25,  48,  50],
        ...,
        [ 74,  86,  82],
        [ 77,  88,  82],
        [ 75,  83,  78]],

       [[ 45,  71,  96],
        [  9,  32,  50],
        [ 18,  48,  55],
        ...,
        [ 47,  66,  60],
        [ 54,  71,  63],
        [ 60,  69,  62]],

       ...,

       [[ 27,  93, 143],
        [ 28,  94, 144],
        [ 28,  94, 144],
        ...,
        [ 24,  42,  40],
        [ 26,  42,  39],
        [ 27,  43,  40]],

       [[ 26,  92, 142],
        [ 29,  95, 145],
        [ 28,  94, 144],
        ...,
        [ 26,  45,  43],
        [ 28,  45,  43],
        [ 28,  44,  41]],

       [[ 25,  91, 141],
        [ 26,  92, 142],
        [ 29,  95, 145],
        ...,
        [ 25,  45,  43],
        [ 26,  44,  42],
        [ 26,  44,  41]]], dtype=uint8)]"
Image_740.jpg,357,100,152,193,728,486,509,293,193,daskShared_local/images/Image_740.jpg,740,"[array([[[  3,  63, 255],
        [  1,  64, 253],
        [  3,  64, 253],
        ...,
        [  0, 106, 250],
        [  0, 104, 255],
        [  0, 106, 254]],

       [[  1,  64, 253],
        [  1,  64, 253],
        [  1,  64, 253],
        ...,
        [  1, 105, 254],
        [  2, 103, 255],
        [  1, 105, 255]],

       [[  2,  62, 254],
        [  1,  64, 255],
        [  0,  63, 252],
        ...,
        [  0, 103, 254],
        [  1, 100, 253],
        [  1, 102, 254]],

       ...,

       [[194, 136, 105],
        [197, 143, 110],
        [184, 135, 103],
        ...,
        [192, 203, 191],
        [189, 193, 177],
        [174, 179, 157]],

       [[177, 138, 113],
        [169, 122,  93],
        [156, 106,  77],
        ...,
        [113, 141, 112],
        [172, 187, 183],
        [197, 202, 188]],

       [[ 87,  68,  54],
        [ 73,  54,  44],
        [ 93,  71,  51],
        ...,
        [ 74,  81,  41],
        [ 92, 102,  69],
        [132, 156, 142]]], dtype=uint8)]"
Image_741.jpg,277,169,181,166,800,533,458,335,181,daskShared_local/images/Image_741.jpg,741,"[array([[[208, 188, 155],
        [208, 189, 156],
        [210, 190, 157],
        ...,
        [ 81,  79,  97],
        [ 99,  99, 107],
        [ 68,  68,  78]],

       [[227, 203, 172],
        [229, 204, 174],
        [228, 203, 173],
        ...,
        [ 49,  48,  64],
        [ 66,  66,  75],
        [ 70,  70,  80]],

       [[236, 211, 187],
        [236, 211, 187],
        [233, 206, 183],
        ...,
        [ 35,  34,  49],
        [ 45,  45,  54],
        [ 78,  78,  88]],

       ...,

       [[154, 119,  99],
        [161, 126, 106],
        [179, 144, 124],
        ...,
        [130, 116, 107],
        [122, 108,  99],
        [117, 103,  94]],

       [[189, 154, 134],
        [185, 150, 130],
        [181, 146, 126],
        ...,
        [123, 109, 100],
        [108,  94,  85],
        [107,  93,  84]],

       [[207, 172, 150],
        [202, 167, 145],
        [193, 158, 136],
        ...,
        [101,  87,  78],
        [ 87,  73,  64],
        [ 94,  80,  71]]], dtype=uint8)]"
Image_742.jpg,1447,1117,404,366,2522,3332,1851,1483,404,daskShared_local/images/Image_742.jpg,742,"[array([[[227, 206, 187],
        [223, 204, 184],
        [200, 183, 163],
        ...,
        [  2, 151, 179],
        [  1, 150, 177],
        [  0, 148, 174]],

       [[235, 213, 192],
        [219, 198, 178],
        [183, 163, 146],
        ...,
        [  2, 153, 176],
        [  6, 159, 180],
        [  3, 156, 176]],

       [[241, 218, 195],
        [218, 195, 177],
        [168, 146, 134],
        ...,
        [  4, 159, 177],
        [  2, 156, 172],
        [  1, 156, 170]],

       ...,

       [[ 42,  73,  73],
        [ 38,  83,  84],
        [ 31,  94,  96],
        ...,
        [  1, 125, 202],
        [  0, 125, 201],
        [  0, 126, 202]],

       [[ 43,  73,  68],
        [ 35,  75,  72],
        [ 33,  87,  87],
        ...,
        [  0, 125, 201],
        [  0, 126, 202],
        [  0, 126, 202]],

       [[ 42,  76,  69],
        [ 34,  77,  73],
        [ 30,  86,  86],
        ...,
        [  0, 125, 201],
        [  0, 124, 200],
        [  0, 125, 201]]], dtype=uint8)]"
Image_743.jpg,309,210,197,212,1000,600,506,422,212,daskShared_local/images/Image_743.jpg,743,"[array([[[  1, 146, 193],
        [  1, 146, 193],
        [  1, 146, 193],
        ...,
        [  1, 158, 201],
        [  2, 159, 202],
        [  2, 159, 202]],

       [[  1, 146, 193],
        [  1, 146, 193],
        [  1, 146, 193],
        ...,
        [  1, 158, 201],
        [  2, 159, 202],
        [  2, 159, 202]],

       [[  1, 146, 193],
        [  1, 146, 193],
        [  1, 146, 193],
        ...,
        [  1, 158, 201],
        [  2, 159, 202],
        [  2, 159, 202]],

       ...,

       [[154, 121,  22],
        [103,  72,  15],
        [ 45,  38,  20],
        ...,
        [237, 208, 149],
        [231, 209, 146],
        [230, 209, 145]],

       [[111,  80,  12],
        [ 59,  33,  27],
        [ 33,  33,  32],
        ...,
        [238, 209, 147],
        [232, 208, 142],
        [231, 207, 143]],

       [[ 94,  64,  20],
        [ 38,  21,  42],
        [ 28,  27,  31],
        ...,
        [236, 210, 149],
        [232, 207, 144],
        [232, 206, 145]]], dtype=uint8)]"
Image_744.jpg,423,5,405,515,1280,720,828,520,515,daskShared_local/images/Image_744.jpg,744,"[array([[[158, 226, 237],
        [158, 228, 238],
        [155, 228, 237],
        ...,
        [ 46, 181, 209],
        [ 65, 185, 215],
        [ 72, 185, 214]],

       [[161, 226, 240],
        [160, 227, 240],
        [158, 227, 239],
        ...,
        [ 80, 189, 217],
        [ 86, 190, 221],
        [ 81, 189, 217]],

       [[155, 226, 238],
        [159, 227, 240],
        [161, 226, 241],
        ...,
        [ 83, 190, 213],
        [ 86, 193, 216],
        [ 74, 190, 214]],

       ...,

       [[101,  80,  45],
        [ 69,  53,  25],
        [ 30,  26,   9],
        ...,
        [  1,  71,  96],
        [  1,  71,  96],
        [  2,  72,  97]],

       [[122,  94,  55],
        [103,  78,  41],
        [ 57,  41,  12],
        ...,
        [  1,  71,  96],
        [  1,  70,  95],
        [  3,  70,  96]],

       [[119,  91,  52],
        [114,  87,  46],
        [ 91,  71,  32],
        ...,
        [  0,  70,  95],
        [  0,  70,  95],
        [  3,  69,  95]]], dtype=uint8)]"
Image_745.jpg,466,128,279,306,1600,1019,745,434,306,daskShared_local/images/Image_745.jpg,745,"[array([[[ 26, 109, 213],
        [ 26, 109, 213],
        [ 26, 109, 213],
        ...,
        [ 28, 116, 213],
        [ 28, 116, 213],
        [ 28, 116, 213]],

       [[ 26, 109, 213],
        [ 26, 109, 213],
        [ 26, 109, 213],
        ...,
        [ 28, 116, 213],
        [ 28, 116, 213],
        [ 28, 116, 213]],

       [[ 26, 109, 213],
        [ 26, 109, 213],
        [ 26, 109, 213],
        ...,
        [ 28, 116, 213],
        [ 28, 116, 213],
        [ 28, 116, 213]],

       ...,

       [[218, 220, 213],
        [198, 197, 191],
        [172, 170, 166],
        ...,
        [ 63,  16,  18],
        [ 61,  31,  28],
        [ 51,  60,  45]],

       [[184, 188, 180],
        [171, 172, 166],
        [216, 217, 213],
        ...,
        [ 51,   6,   6],
        [ 49,  20,  16],
        [ 50,  56,  40]],

       [[185, 188, 171],
        [226, 228, 215],
        [207, 208, 199],
        ...,
        [ 44,  13,   0],
        [ 32,  10,   1],
        [ 54,  43,  26]]], dtype=uint8)]"
Image_746.png,374,59,182,148,600,600,556,207,182,daskShared_local/images/Image_746.png,746,"[array([[[  2, 104, 249],
        [  1, 103, 248],
        [  0, 104, 249],
        ...,
        [  2, 120, 254],
        [  2, 120, 254],
        [  2, 120, 254]],

       [[  3, 105, 250],
        [  3, 105, 250],
        [  1, 102, 249],
        ...,
        [  1, 119, 253],
        [  1, 119, 253],
        [  1, 119, 253]],

       [[  1, 103, 248],
        [  1, 102, 248],
        [  1, 100, 248],
        ...,
        [  0, 118, 254],
        [  0, 118, 254],
        [  1, 119, 255]],

       ...,

       [[205, 162, 100],
        [208, 189, 126],
        [210, 212, 191],
        ...,
        [244, 251, 207],
        [247, 250, 202],
        [247, 249, 200]],

       [[234, 220, 223],
        [200, 182, 126],
        [215, 217, 165],
        ...,
        [244, 250, 199],
        [246, 251, 197],
        [247, 249, 199]],

       [[221, 236, 239],
        [192, 166, 155],
        [204, 188, 155],
        ...,
        [246, 251, 193],
        [247, 250, 194],
        [248, 247, 199]]], dtype=uint8)]"
Image_747.jpg,688,664,370,230,2793,2090,1058,894,370,daskShared_local/images/Image_747.jpg,747,"[array([[[  5,  69, 192],
        [  5,  69, 192],
        [  5,  69, 192],
        ...,
        [  3,  68, 186],
        [  3,  68, 186],
        [  3,  68, 186]],

       [[  5,  69, 192],
        [  5,  69, 192],
        [  5,  69, 192],
        ...,
        [  3,  68, 186],
        [  3,  68, 186],
        [  3,  68, 186]],

       [[  5,  69, 192],
        [  5,  69, 192],
        [  5,  69, 192],
        ...,
        [  3,  68, 186],
        [  3,  68, 186],
        [  3,  68, 186]],

       ...,

       [[  3,  50, 154],
        [  3,  50, 154],
        [  3,  50, 154],
        ...,
        [ 46,  46,  36],
        [ 53,  53,  47],
        [ 48,  56,  31]],

       [[  5,  52, 156],
        [  5,  52, 156],
        [  5,  52, 156],
        ...,
        [ 58,  60,  26],
        [ 63,  64,  30],
        [ 56,  62,  14]],

       [[  5,  52, 156],
        [  5,  52, 156],
        [  5,  52, 156],
        ...,
        [ 60,  63,  30],
        [ 63,  65,  31],
        [ 64,  70,  28]]], dtype=uint8)]"
Image_748.jpg,711,186,173,144,1000,600,884,330,173,daskShared_local/images/Image_748.jpg,748,"[array([[[ 25, 170, 215],
        [ 21, 166, 211],
        [ 19, 164, 209],
        ...,
        [  2, 152, 205],
        [  2, 152, 205],
        [  3, 153, 206]],

       [[ 33, 176, 220],
        [ 26, 170, 214],
        [ 23, 166, 211],
        ...,
        [  1, 151, 203],
        [  2, 152, 204],
        [  3, 153, 204]],

       [[ 35, 176, 220],
        [ 33, 174, 218],
        [ 30, 172, 215],
        ...,
        [  1, 151, 202],
        [  2, 152, 203],
        [  3, 153, 204]],

       ...,

       [[184, 170,  11],
        [177, 160,  23],
        [183, 163,  49],
        ...,
        [144, 161,  34],
        [132, 152,  14],
        [137, 157,  23]],

       [[197, 181,  34],
        [179, 159,  38],
        [171, 148,  53],
        ...,
        [138, 159,  12],
        [133, 152,  25],
        [158, 172,  71]],

       [[205, 185,  58],
        [183, 159,  62],
        [186, 157,  91],
        ...,
        [139, 158,  20],
        [163, 177,  79],
        [206, 215, 152]]], dtype=uint8)]"
Image_749.png,213,5,364,432,860,460,577,437,432,daskShared_local/images/Image_749.png,749,"[array([[[ 53,  58,  53],
        [ 62,  67,  62],
        [ 80,  84,  63],
        ...,
        [ 13, 219, 217],
        [  7, 198, 207],
        [ 13, 182, 187]],

       [[ 55,  60,  54],
        [ 57,  61,  55],
        [ 74,  78,  56],
        ...,
        [ 10, 206, 204],
        [ 19, 180, 186],
        [ 17, 181, 185]],

       [[ 52,  58,  52],
        [ 55,  60,  54],
        [ 58,  60,  54],
        ...,
        [ 16, 180, 189],
        [ 32, 159, 178],
        [ 24, 169, 181]],

       ...,

       [[ 66, 119, 123],
        [ 67, 120, 125],
        [ 65, 119, 123],
        ...,
        [108, 201, 192],
        [121, 242, 206],
        [ 37, 235, 235]],

       [[ 63, 117, 123],
        [ 66, 121, 126],
        [ 66, 122, 125],
        ...,
        [ 87, 182, 188],
        [ 97, 239, 211],
        [  4, 208, 236]],

       [[ 64, 117, 123],
        [ 62, 116, 121],
        [ 66, 121, 124],
        ...,
        [ 92, 182, 186],
        [ 93, 239, 209],
        [  3, 196, 233]]], dtype=uint8)]"
Image_75.jpg,164,178,181,138,728,500,345,316,181,daskShared_local/images/Image_75.jpg,75,"[array([[[  1,  71, 219],
        [  1,  71, 218],
        [  0,  70, 217],
        ...,
        [  1,  82, 226],
        [  0,  81, 225],
        [  1,  80, 225]],

       [[  2,  72, 219],
        [  2,  72, 219],
        [  1,  71, 219],
        ...,
        [  2,  81, 225],
        [  1,  82, 225],
        [  1,  80, 225]],

       [[  1,  71, 218],
        [  1,  71, 218],
        [  2,  70, 219],
        ...,
        [  1,  80, 224],
        [  2,  81, 225],
        [  2,  81, 226]],

       ...,

       [[ 13, 126, 139],
        [ 21, 141, 150],
        [ 28, 145, 153],
        ...,
        [240, 205, 140],
        [237, 201, 148],
        [237, 211, 189]],

       [[ 20, 134, 144],
        [ 23, 141, 152],
        [ 26, 144, 155],
        ...,
        [242, 216, 140],
        [246, 221, 142],
        [245, 221, 146]],

       [[ 31, 141, 155],
        [ 32, 129, 157],
        [ 48, 136, 162],
        ...,
        [234, 212, 149],
        [239, 225, 170],
        [248, 242, 198]]], dtype=uint8)]"
Image_750.jpg,362,22,152,144,550,380,514,166,152,daskShared_local/images/Image_750.jpg,750,"[array([[[ 76,  95, 151],
        [ 76,  95, 151],
        [ 76,  95, 151],
        ...,
        [ 70,  85, 144],
        [ 71,  86, 145],
        [ 71,  86, 145]],

       [[ 76,  95, 151],
        [ 76,  95, 151],
        [ 76,  95, 151],
        ...,
        [ 70,  85, 144],
        [ 71,  86, 145],
        [ 70,  85, 144]],

       [[ 76,  95, 151],
        [ 76,  95, 151],
        [ 76,  95, 151],
        ...,
        [ 70,  85, 144],
        [ 70,  85, 144],
        [ 70,  85, 144]],

       ...,

       [[121, 100,  70],
        [136, 113,  87],
        [155, 130, 108],
        ...,
        [ 65,  79, 139],
        [ 64,  77, 138],
        [ 64,  77, 138]],

       [[109,  87,  60],
        [116,  91,  65],
        [126,  99,  74],
        ...,
        [ 65,  80, 140],
        [ 63,  79, 139],
        [ 63,  78, 138]],

       [[ 99,  76,  52],
        [101,  76,  53],
        [111,  85,  61],
        ...,
        [ 66,  80, 140],
        [ 64,  79, 140],
        [ 64,  78, 139]]], dtype=uint8)]"
Image_751.png,377,188,323,282,900,600,700,470,323,daskShared_local/images/Image_751.png,751,"[array([[[101,  86,  79],
        [111,  92,  93],
        [104,  93,  83],
        ...,
        [ 26, 149, 179],
        [ 21, 150, 180],
        [ 18, 151, 181]],

       [[ 79,  71,  88],
        [ 82,  78,  90],
        [ 84,  85,  90],
        ...,
        [ 13, 151, 181],
        [ 22, 149, 181],
        [ 25, 149, 181]],

       [[ 76,  80,  79],
        [ 93,  89,  90],
        [ 92,  89,  87],
        ...,
        [ 23, 153, 184],
        [ 20, 148, 183],
        [ 19, 152, 181]],

       ...,

       [[ 24,  70,  66],
        [ 24,  67,  68],
        [ 25,  66,  65],
        ...,
        [ 92, 149, 145],
        [ 88, 153, 147],
        [ 96, 153, 151]],

       [[ 23,  71,  61],
        [ 27,  71,  63],
        [ 28,  63,  62],
        ...,
        [ 91, 146, 151],
        [ 90, 153, 149],
        [ 92, 153, 152]],

       [[ 22,  69,  65],
        [ 19,  69,  67],
        [ 23,  67,  64],
        ...,
        [ 92, 146, 142],
        [ 89, 147, 138],
        [ 88, 149, 147]]], dtype=uint8)]"
Image_752.jpg,212,34,213,184,900,521,425,218,213,daskShared_local/images/Image_752.jpg,752,"[array([[[ 16,  58, 170],
        [ 17,  59, 171],
        [ 17,  59, 171],
        ...,
        [ 32,  69, 184],
        [ 32,  69, 184],
        [ 33,  68, 184]],

       [[ 16,  58, 170],
        [ 17,  59, 171],
        [ 17,  59, 171],
        ...,
        [ 32,  69, 184],
        [ 32,  69, 184],
        [ 33,  68, 184]],

       [[ 16,  58, 170],
        [ 17,  59, 171],
        [ 17,  59, 171],
        ...,
        [ 32,  69, 184],
        [ 32,  69, 184],
        [ 32,  67, 183]],

       ...,

       [[  0,  54, 140],
        [  0,  54, 140],
        [  0,  54, 140],
        ...,
        [194, 210, 209],
        [203, 219, 218],
        [213, 231, 231]],

       [[  0,  54, 140],
        [  0,  54, 140],
        [  0,  54, 140],
        ...,
        [181, 197, 196],
        [193, 209, 208],
        [211, 229, 228]],

       [[  0,  56, 137],
        [  0,  55, 140],
        [  0,  54, 145],
        ...,
        [186, 203, 198],
        [197, 214, 208],
        [203, 223, 222]]], dtype=uint8)]"
Image_753.jpg,509,81,153,198,1200,630,662,279,198,daskShared_local/images/Image_753.jpg,753,"[array([[[  4, 157, 224],
        [  3, 156, 223],
        [  3, 156, 223],
        ...,
        [  3, 155, 222],
        [  3, 155, 222],
        [  3, 155, 222]],

       [[  4, 157, 224],
        [  2, 155, 222],
        [  2, 155, 222],
        ...,
        [  3, 155, 222],
        [  3, 155, 222],
        [  3, 155, 222]],

       [[  3, 156, 223],
        [  2, 155, 222],
        [  2, 155, 222],
        ...,
        [  3, 155, 222],
        [  3, 155, 222],
        [  3, 155, 222]],

       ...,

       [[ 15,   0,   5],
        [ 14,   0,   4],
        [ 25,  12,  19],
        ...,
        [  2,  84, 121],
        [  1,  83, 120],
        [  0,  82, 119]],

       [[ 34,  19,  24],
        [ 10,   0,   2],
        [ 29,  16,  23],
        ...,
        [  4,  84, 121],
        [  0,  82, 119],
        [  0,  80, 117]],

       [[ 35,  23,  27],
        [ 26,  14,  18],
        [ 36,  25,  31],
        ...,
        [  3,  83, 120],
        [  1,  81, 118],
        [  0,  80, 117]]], dtype=uint8)]"
Image_754.jpg,401,993,839,617,4601,3200,1240,1610,839,daskShared_local/images/Image_754.jpg,754,"[array([[[ 32, 157, 241],
        [ 36, 170, 245],
        [ 34, 166, 241],
        ...,
        [ 51, 158, 233],
        [ 50, 157, 232],
        [ 50, 157, 227]],

       [[ 36, 153, 236],
        [ 42, 166, 240],
        [ 37, 164, 239],
        ...,
        [ 49, 157, 226],
        [ 48, 160, 224],
        [ 48, 160, 221]],

       [[ 36, 161, 238],
        [ 35, 162, 241],
        [ 33, 157, 229],
        ...,
        [ 50, 164, 234],
        [ 47, 165, 229],
        [ 46, 163, 229]],

       ...,

       [[ 21, 159, 224],
        [ 21, 154, 218],
        [ 23, 153, 222],
        ...,
        [ 37, 145, 202],
        [ 42, 152, 209],
        [ 43, 154, 214]],

       [[ 35, 161, 226],
        [ 28, 154, 215],
        [ 22, 149, 210],
        ...,
        [ 45, 154, 210],
        [ 45, 150, 207],
        [ 50, 150, 213]],

       [[ 21, 153, 219],
        [ 22, 152, 218],
        [ 20, 151, 218],
        ...,
        [ 49, 158, 213],
        [ 45, 152, 206],
        [ 50, 154, 217]]], dtype=uint8)]"
Image_755.jpg,97,258,153,120,900,600,250,378,153,daskShared_local/images/Image_755.jpg,755,"[array([[[  0,  73,  82],
        [  0,  69,  83],
        [  0,  69,  86],
        ...,
        [  8,  94, 106],
        [  1,  88, 101],
        [  0,  88, 100]],

       [[  2,  76,  84],
        [  1,  70,  83],
        [  1,  68,  85],
        ...,
        [  5,  91, 102],
        [  1,  87, 100],
        [  0,  87,  99]],

       [[  5,  78,  85],
        [  2,  71,  83],
        [  1,  68,  83],
        ...,
        [  2,  88,  99],
        [  1,  87, 100],
        [  0,  86,  99]],

       ...,

       [[  1,  65,  75],
        [  1,  65,  75],
        [  1,  65,  75],
        ...,
        [ 16,  43,  37],
        [ 15,  43,  33],
        [ 16,  43,  34]],

       [[  1,  65,  75],
        [  1,  65,  75],
        [  0,  66,  75],
        ...,
        [ 18,  44,  38],
        [ 18,  45,  36],
        [ 18,  45,  36]],

       [[  0,  66,  75],
        [  0,  66,  75],
        [  0,  66,  75],
        ...,
        [ 19,  45,  39],
        [ 21,  47,  38],
        [ 21,  47,  38]]], dtype=uint8)]"
Image_756.jpg,907,443,713,555,3008,2000,1620,998,713,daskShared_local/images/Image_756.jpg,756,"[array([[[148, 187, 194],
        [148, 187, 194],
        [148, 187, 194],
        ...,
        [135, 177, 189],
        [134, 177, 190],
        [131, 179, 192]],

       [[148, 187, 194],
        [148, 187, 194],
        [148, 187, 194],
        ...,
        [135, 177, 189],
        [134, 177, 189],
        [129, 176, 187]],

       [[148, 187, 194],
        [148, 187, 194],
        [148, 187, 194],
        ...,
        [135, 177, 189],
        [134, 177, 189],
        [128, 176, 186]],

       ...,

       [[109, 168, 174],
        [113, 168, 175],
        [115, 168, 176],
        ...,
        [ 54,  73,  77],
        [ 54,  73,  77],
        [ 57,  70,  76]],

       [[110, 168, 176],
        [113, 168, 176],
        [115, 168, 176],
        ...,
        [ 56,  78,  81],
        [ 57,  76,  80],
        [ 57,  69,  75]],

       [[111, 169, 180],
        [113, 168, 177],
        [115, 168, 176],
        ...,
        [ 52,  75,  77],
        [ 51,  68,  72],
        [ 48,  58,  65]]], dtype=uint8)]"
Image_757.jpg,394,7,83,60,530,180,477,67,83,daskShared_local/images/Image_757.jpg,757,"[array([[[ 12,  40,  85],
        [ 15,  43,  87],
        [  9,  36,  80],
        ...,
        [ 55,  75,  85],
        [ 69,  86, 104],
        [ 63,  82,  97]],

       [[ 15,  48,  91],
        [ 18,  52,  95],
        [ 11,  43,  86],
        ...,
        [ 53,  74,  83],
        [ 69,  88, 103],
        [ 63,  83,  95]],

       [[ 10,  33,  78],
        [ 11,  35,  80],
        [  7,  30,  75],
        ...,
        [ 56,  75,  87],
        [ 68,  85, 106],
        [ 64,  81,  98]],

       ...,

       [[157, 155, 133],
        [164, 159, 136],
        [147, 149, 127],
        ...,
        [ 35,  29,  54],
        [ 25,  18,  41],
        [ 29,  22,  46]],

       [[205, 204, 167],
        [202, 201, 168],
        [209, 210, 165],
        ...,
        [ 36,  30,  55],
        [ 20,  12,  36],
        [ 26,  19,  43]],

       [[181, 179, 150],
        [183, 180, 152],
        [177, 179, 146],
        ...,
        [ 36,  29,  55],
        [ 22,  15,  39],
        [ 27,  21,  45]]], dtype=uint8)]"
Image_758.jpg,248,212,142,147,775,518,390,359,147,daskShared_local/images/Image_758.jpg,758,"[array([[[ 37,  29,  13],
        [ 29,  19,  11],
        [ 50,  38,  32],
        ...,
        [125,  99,  82],
        [130, 104,  89],
        [136, 110,  95]],

       [[ 33,  26,  11],
        [ 52,  42,  32],
        [ 99,  86,  76],
        ...,
        [138, 111,  93],
        [140, 114,  97],
        [140, 113,  97]],

       [[ 56,  47,  35],
        [106,  95,  83],
        [169, 155, 143],
        ...,
        [150, 123, 103],
        [145, 119,  99],
        [133, 107,  88]],

       ...,

       [[158, 127,  80],
        [162, 133,  86],
        [159, 131,  85],
        ...,
        [202, 159, 117],
        [197, 153, 111],
        [185, 140,  98]],

       [[159, 128,  81],
        [167, 138,  91],
        [165, 137,  91],
        ...,
        [200, 157, 115],
        [193, 150, 108],
        [183, 138,  96]],

       [[165, 135,  88],
        [173, 144,  97],
        [172, 143,  97],
        ...,
        [194, 151, 110],
        [186, 142, 100],
        [177, 133,  91]]], dtype=uint8)]"
Image_759.jpg,352,122,208,192,1280,720,560,314,208,daskShared_local/images/Image_759.jpg,759,"[array([[[  8, 102, 190],
        [ 11, 105, 193],
        [ 17, 111, 199],
        ...,
        [ 22, 133, 215],
        [ 23, 134, 216],
        [ 22, 133, 215]],

       [[ 14, 108, 196],
        [ 16, 110, 198],
        [ 18, 112, 200],
        ...,
        [ 19, 130, 212],
        [ 20, 131, 213],
        [ 21, 132, 214]],

       [[ 14, 105, 194],
        [ 15, 106, 195],
        [ 13, 107, 195],
        ...,
        [ 19, 130, 212],
        [ 19, 130, 212],
        [ 19, 130, 212]],

       ...,

       [[ 11,  81, 169],
        [ 12,  82, 170],
        [ 13,  83, 171],
        ...,
        [ 31,  32,  18],
        [ 67,  68,  52],
        [ 82,  83,  67]],

       [[  9,  75, 166],
        [ 12,  78, 169],
        [ 16,  81, 173],
        ...,
        [ 34,  35,  26],
        [ 31,  33,  21],
        [ 16,  18,   7]],

       [[  4,  69, 161],
        [  6,  71, 163],
        [  9,  74, 166],
        ...,
        [ 24,  26,  18],
        [ 11,  13,   2],
        [ 16,  18,   7]]], dtype=uint8)]"
Image_76.jpg,799,337,159,118,1536,1024,958,455,159,daskShared_local/images/Image_76.jpg,76,"[array([[[ 17,  54,  84],
        [ 16,  66, 108],
        [ 12,  86, 143],
        ...,
        [ 46, 123, 213],
        [ 46, 123, 213],
        [ 47, 124, 214]],

       [[ 15,  56,  90],
        [ 18,  75, 125],
        [ 20,  97, 163],
        ...,
        [ 45, 122, 212],
        [ 46, 123, 213],
        [ 46, 123, 213]],

       [[ 13,  58,  95],
        [ 20,  86, 144],
        [ 28, 108, 185],
        ...,
        [ 44, 121, 211],
        [ 45, 122, 212],
        [ 45, 122, 212]],

       ...,

       [[ 15, 115, 201],
        [ 14, 116, 203],
        [ 15, 117, 204],
        ...,
        [ 12, 113, 203],
        [ 11, 112, 204],
        [ 11, 112, 204]],

       [[ 16, 116, 201],
        [ 15, 116, 203],
        [ 16, 116, 203],
        ...,
        [ 13, 113, 204],
        [ 12, 113, 204],
        [ 12, 113, 205]],

       [[ 17, 118, 203],
        [ 16, 117, 202],
        [ 16, 116, 202],
        ...,
        [ 13, 113, 204],
        [ 12, 113, 203],
        [ 11, 115, 204]]], dtype=uint8)]"
Image_760.jpg,388,324,292,231,1904,803,680,555,292,daskShared_local/images/Image_760.jpg,760,"[array([[[  2,  51, 107],
        [  4,  53, 109],
        [  4,  53, 109],
        ...,
        [205, 235, 222],
        [235, 254, 239],
        [203, 236, 208]],

       [[  2,  51, 107],
        [  2,  51, 107],
        [  2,  51, 107],
        ...,
        [195, 226, 212],
        [238, 254, 242],
        [208, 239, 212]],

       [[  2,  51, 107],
        [  2,  51, 107],
        [  2,  51, 107],
        ...,
        [210, 235, 224],
        [241, 255, 242],
        [213, 240, 214]],

       ...,

       [[  2,   2,  10],
        [  2,   3,   8],
        [  2,   3,   7],
        ...,
        [ 10,  79, 105],
        [ 16,  87, 111],
        [ 21,  91, 115]],

       [[  0,   2,  10],
        [  0,   2,  10],
        [  0,   2,  10],
        ...,
        [ 37, 129, 158],
        [ 49, 141, 170],
        [ 55, 147, 176]],

       [[  0,   1,  10],
        [  0,   1,  12],
        [  0,   1,  12],
        ...,
        [ 43, 155, 191],
        [ 37, 151, 187],
        [ 38, 149, 187]]], dtype=uint8)]"
Image_761.jpg,413,129,117,95,759,422,530,224,117,daskShared_local/images/Image_761.jpg,761,"[array([[[105, 175, 175],
        [108, 178, 178],
        [120, 190, 190],
        ...,
        [  3, 134, 152],
        [  1, 132, 150],
        [  1, 132, 150]],

       [[111, 181, 181],
        [115, 185, 185],
        [126, 196, 196],
        ...,
        [  2, 133, 151],
        [  1, 133, 151],
        [  1, 133, 151]],

       [[132, 202, 202],
        [135, 205, 205],
        [146, 216, 216],
        ...,
        [  0, 131, 149],
        [  0, 135, 153],
        [  0, 136, 154]],

       ...,

       [[  0, 155, 185],
        [  0, 155, 185],
        [  0, 155, 185],
        ...,
        [  2, 141, 164],
        [  1, 140, 163],
        [  1, 140, 163]],

       [[  0, 155, 186],
        [  0, 155, 186],
        [  0, 155, 186],
        ...,
        [  3, 140, 162],
        [  2, 140, 162],
        [  2, 139, 162]],

       [[  0, 155, 186],
        [  0, 155, 186],
        [  0, 155, 186],
        ...,
        [  3, 139, 162],
        [  3, 139, 161],
        [  3, 139, 161]]], dtype=uint8)]"
Image_762.jpg,63,82,205,165,640,427,268,247,205,daskShared_local/images/Image_762.jpg,762,"[array([[[180, 233, 225],
        [179, 232, 222],
        [179, 232, 224],
        ...,
        [169, 231, 226],
        [167, 232, 226],
        [167, 232, 226]],

       [[180, 233, 225],
        [180, 231, 222],
        [179, 232, 222],
        ...,
        [160, 230, 222],
        [159, 228, 223],
        [157, 228, 222]],

       [[180, 232, 220],
        [179, 233, 220],
        [177, 233, 220],
        ...,
        [151, 226, 221],
        [149, 226, 220],
        [147, 225, 219]],

       ...,

       [[ 87, 171, 182],
        [ 91, 174, 188],
        [ 93, 177, 190],
        ...,
        [ 80, 109, 117],
        [ 86, 118, 128],
        [ 86, 120, 129]],

       [[ 90, 172, 184],
        [ 92, 174, 188],
        [ 94, 176, 188],
        ...,
        [ 79, 108, 116],
        [ 88, 118, 129],
        [ 84, 118, 127]],

       [[ 94, 173, 186],
        [ 95, 174, 187],
        [ 97, 177, 188],
        ...,
        [ 78, 108, 116],
        [ 86, 116, 125],
        [ 84, 114, 124]]], dtype=uint8)]"
Image_763.jpg,215,212,141,155,800,600,356,367,155,daskShared_local/images/Image_763.jpg,763,"[array([[[ 67, 186, 208],
        [ 68, 187, 209],
        [ 70, 187, 210],
        ...,
        [ 29, 166, 195],
        [ 27, 165, 194],
        [ 25, 164, 193]],

       [[ 66, 187, 208],
        [ 67, 187, 209],
        [ 68, 188, 209],
        ...,
        [ 27, 165, 194],
        [ 26, 164, 194],
        [ 25, 163, 194]],

       [[ 65, 187, 208],
        [ 66, 187, 208],
        [ 67, 187, 209],
        ...,
        [ 24, 164, 193],
        [ 23, 163, 193],
        [ 22, 163, 193]],

       ...,

       [[ 34, 128, 115],
        [ 32, 126, 112],
        [ 33, 127, 112],
        ...,
        [233, 202, 139],
        [232, 203, 142],
        [227, 198, 133]],

       [[ 32, 124, 110],
        [ 30, 122, 107],
        [ 31, 123, 107],
        ...,
        [231, 200, 134],
        [232, 201, 146],
        [227, 198, 137]],

       [[ 30, 121, 106],
        [ 28, 119, 103],
        [ 30, 121, 104],
        ...,
        [228, 196, 131],
        [230, 199, 146],
        [228, 198, 143]]], dtype=uint8)]"
Image_764.jpg,1882,604,1227,1190,4752,3168,3109,1794,1227,daskShared_local/images/Image_764.jpg,764,"[array([[[ 68,  66,  48],
        [ 71,  70,  47],
        [ 72,  71,  45],
        ...,
        [ 55, 127, 151],
        [ 53, 125, 150],
        [ 51, 122, 150]],

       [[ 69,  63,  42],
        [ 69,  64,  42],
        [ 69,  66,  41],
        ...,
        [ 55, 127, 150],
        [ 53, 127, 150],
        [ 52, 124, 149]],

       [[ 70,  64,  38],
        [ 71,  66,  40],
        [ 73,  71,  42],
        ...,
        [ 54, 125, 148],
        [ 53, 125, 148],
        [ 53, 123, 149]],

       ...,

       [[ 15,  99, 141],
        [ 17,  99, 141],
        [ 17, 100, 142],
        ...,
        [105,  85,  60],
        [162, 150,  99],
        [189, 189, 147]],

       [[ 27, 109, 142],
        [ 30, 109, 143],
        [ 31, 111, 145],
        ...,
        [161, 149, 100],
        [197, 198, 148],
        [188, 196, 171]],

       [[ 42, 126, 150],
        [ 46, 129, 152],
        [ 47, 131, 153],
        ...,
        [198, 196, 152],
        [199, 205, 178],
        [170, 176, 173]]], dtype=uint8)]"
Image_765.jpg,536,230,164,198,990,681,700,428,198,daskShared_local/images/Image_765.jpg,765,"[array([[[ 30,  28,  13],
        [ 26,  24,   9],
        [ 24,  22,   7],
        ...,
        [ 23,  10,   4],
        [ 26,  12,   3],
        [ 32,  14,   2]],

       [[ 33,  31,  16],
        [ 31,  29,  14],
        [ 29,  27,  12],
        ...,
        [ 22,   9,   1],
        [ 28,  11,   1],
        [ 33,  15,   1]],

       [[ 33,  31,  18],
        [ 34,  32,  19],
        [ 35,  33,  20],
        ...,
        [ 23,   9,   0],
        [ 30,  14,   1],
        [ 39,  20,   3]],

       ...,

       [[114, 109,  80],
        [110, 105,  76],
        [104,  99,  69],
        ...,
        [ 53,  60,  42],
        [ 51,  59,  38],
        [ 50,  58,  37]],

       [[118, 113,  84],
        [ 96,  91,  62],
        [ 77,  70,  41],
        ...,
        [ 52,  59,  41],
        [ 51,  59,  38],
        [ 53,  61,  40]],

       [[136, 129, 101],
        [ 97,  90,  61],
        [ 71,  62,  31],
        ...,
        [ 50,  57,  39],
        [ 50,  58,  37],
        [ 52,  60,  37]]], dtype=uint8)]"
Image_766.jpg,988,138,258,337,1686,1216,1246,475,337,daskShared_local/images/Image_766.jpg,766,"[array([[[127, 184, 214],
        [128, 185, 215],
        [127, 184, 214],
        ...,
        [162, 202, 227],
        [162, 202, 227],
        [162, 202, 227]],

       [[127, 184, 214],
        [127, 184, 214],
        [125, 182, 212],
        ...,
        [162, 202, 227],
        [162, 202, 227],
        [162, 202, 227]],

       [[124, 181, 211],
        [124, 181, 211],
        [123, 180, 210],
        ...,
        [161, 201, 226],
        [161, 201, 226],
        [161, 201, 226]],

       ...,

       [[ 80, 104,  78],
        [112, 137, 108],
        [134, 162, 134],
        ...,
        [ 84, 162, 200],
        [ 84, 162, 200],
        [ 84, 162, 200]],

       [[ 70,  95,  72],
        [ 96, 122,  97],
        [133, 162, 134],
        ...,
        [ 84, 164, 201],
        [ 85, 165, 202],
        [ 84, 164, 201]],

       [[ 78, 101,  79],
        [124, 150, 125],
        [136, 165, 137],
        ...,
        [ 80, 161, 198],
        [ 82, 163, 200],
        [ 82, 164, 201]]], dtype=uint8)]"
Image_767.jpg,253,372,825,678,1512,1231,1078,1050,825,daskShared_local/images/Image_767.jpg,767,"[array([[[ 70,  83,  67],
        [ 71,  83,  68],
        [ 74,  88,  75],
        ...,
        [ 93, 115,  94],
        [101, 130, 105],
        [ 87, 120,  94]],

       [[ 69,  82,  70],
        [ 71,  84,  72],
        [ 74,  87,  76],
        ...,
        [ 99, 117,  97],
        [107, 132, 111],
        [ 89, 121,  97]],

       [[ 71,  83,  73],
        [ 71,  85,  73],
        [ 74,  88,  77],
        ...,
        [103, 121, 100],
        [112, 136, 117],
        [ 96, 127, 104]],

       ...,

       [[255, 241, 215],
        [255, 241, 215],
        [255, 241, 215],
        ...,
        [252, 239, 220],
        [254, 238, 219],
        [252, 237, 218]],

       [[255, 241, 215],
        [255, 241, 215],
        [255, 241, 215],
        ...,
        [250, 238, 222],
        [252, 240, 223],
        [252, 241, 225]],

       [[255, 240, 215],
        [255, 241, 215],
        [255, 241, 215],
        ...,
        [244, 232, 215],
        [248, 237, 218],
        [249, 238, 219]]], dtype=uint8)]"
Image_768.jpg,755,269,361,309,1200,906,1116,578,361,daskShared_local/images/Image_768.jpg,768,"[array([[[ 80,  72,  83],
        [ 70,  63,  74],
        [ 74,  68,  80],
        ...,
        [ 17,  48,  71],
        [ 17,  49,  72],
        [ 15,  50,  72]],

       [[ 60,  52,  65],
        [ 63,  55,  68],
        [ 72,  66,  80],
        ...,
        [ 17,  52,  74],
        [ 16,  51,  72],
        [ 18,  52,  72]],

       [[ 61,  53,  67],
        [ 66,  58,  71],
        [ 64,  56,  69],
        ...,
        [ 17,  53,  75],
        [ 16,  51,  71],
        [ 26,  59,  79]],

       ...,

       [[ 49,  77,  93],
        [ 62,  92, 108],
        [ 68, 100, 117],
        ...,
        [ 19,  52,  71],
        [ 27,  51,  71],
        [ 39,  58,  78]],

       [[ 60,  89, 105],
        [ 70,  99, 115],
        [ 77, 104, 121],
        ...,
        [ 17,  50,  68],
        [ 23,  48,  66],
        [ 31,  51,  69]],

       [[ 70,  99, 114],
        [ 80, 108, 124],
        [ 80, 106, 123],
        ...,
        [ 21,  54,  71],
        [ 29,  54,  72],
        [ 37,  58,  76]]], dtype=uint8)]"
Image_769.jpg,2409,897,634,571,3840,2160,3043,1468,634,daskShared_local/images/Image_769.jpg,769,"[array([[[168, 146, 127],
        [156, 133, 115],
        [141, 119, 104],
        ...,
        [  0, 131, 175],
        [  1, 131, 175],
        [  1, 133, 177]],

       [[139, 117,  96],
        [130, 107,  88],
        [161, 139, 123],
        ...,
        [  1, 132, 177],
        [  0, 131, 176],
        [  2, 135, 178]],

       [[142, 119,  98],
        [154, 132, 112],
        [192, 171, 153],
        ...,
        [  0, 131, 177],
        [  0, 131, 177],
        [  2, 134, 178]],

       ...,

       [[  3, 141, 167],
        [  1, 139, 167],
        [  3, 137, 166],
        ...,
        [  0, 121, 166],
        [  0, 121, 166],
        [  2, 121, 164]],

       [[  1, 141, 166],
        [  0, 140, 167],
        [  2, 138, 166],
        ...,
        [  0, 121, 166],
        [  0, 121, 166],
        [  2, 121, 164]],

       [[  0, 142, 166],
        [  0, 142, 168],
        [  1, 140, 168],
        ...,
        [  0, 121, 166],
        [  0, 121, 166],
        [  2, 121, 163]]], dtype=uint8)]"
Image_77.jpg,1792,2554,525,439,2720,4080,2317,2993,525,daskShared_local/images/Image_77.jpg,77,"[array([[[ 97,  85,  66],
        [ 61,  56,  44],
        [ 43,  47,  42],
        ...,
        [  6, 139, 201],
        [  6, 135, 198],
        [  7, 139, 201]],

       [[144, 124, 103],
        [119, 105,  91],
        [ 99,  91,  85],
        ...,
        [  6, 133, 198],
        [  3, 131, 196],
        [  6, 134, 199]],

       [[108,  91,  82],
        [ 89,  73,  66],
        [ 91,  72,  66],
        ...,
        [  5, 129, 196],
        [  7, 130, 197],
        [  2, 125, 192]],

       ...,

       [[  5, 116, 190],
        [  6, 117, 191],
        [  3, 112, 186],
        ...,
        [  4, 115, 189],
        [  4, 115, 189],
        [  7, 119, 193]],

       [[  5, 116, 190],
        [  4, 112, 186],
        [  5, 115, 189],
        ...,
        [  4, 116, 190],
        [  3, 114, 188],
        [  5, 116, 190]],

       [[  3, 114, 188],
        [  8, 119, 193],
        [  4, 114, 188],
        ...,
        [  4, 115, 189],
        [  2, 112, 186],
        [  5, 117, 191]]], dtype=uint8)]"
Image_770.jpg,475,149,232,287,981,650,707,436,287,daskShared_local/images/Image_770.jpg,770,"[array([[[245, 245, 245],
        [245, 245, 245],
        [245, 245, 245],
        ...,
        [243, 243, 243],
        [243, 243, 243],
        [243, 243, 243]],

       [[244, 244, 244],
        [244, 244, 244],
        [244, 244, 244],
        ...,
        [243, 243, 243],
        [243, 243, 243],
        [243, 243, 243]],

       [[244, 244, 244],
        [244, 244, 244],
        [244, 244, 244],
        ...,
        [243, 243, 243],
        [243, 243, 243],
        [243, 243, 243]],

       ...,

       [[ 22,  91, 171],
        [ 20,  91, 172],
        [ 20,  90, 172],
        ...,
        [ 21,  90, 165],
        [ 24,  93, 166],
        [ 28,  98, 170]],

       [[ 23,  94, 176],
        [ 21,  92, 174],
        [ 19,  90, 172],
        ...,
        [ 36, 105, 181],
        [ 37, 107, 179],
        [ 37, 107, 179]],

       [[ 20,  91, 173],
        [ 19,  90, 172],
        [ 19,  90, 172],
        ...,
        [ 33, 102, 179],
        [ 30,  99, 175],
        [ 27,  96, 172]]], dtype=uint8)]"
Image_771.jpg,502,162,93,83,660,438,595,245,93,daskShared_local/images/Image_771.jpg,771,"[array([[[  3,  24,  62],
        [  3,  24,  62],
        [  2,  22,  60],
        ...,
        [  8,  32,  71],
        [  9,  32,  72],
        [  9,  32,  72]],

       [[  3,  24,  62],
        [  3,  24,  63],
        [  2,  22,  60],
        ...,
        [  8,  32,  72],
        [  8,  32,  72],
        [  8,  32,  72]],

       [[  4,  24,  62],
        [  4,  25,  62],
        [  2,  23,  59],
        ...,
        [  8,  33,  70],
        [  9,  33,  72],
        [  9,  33,  72]],

       ...,

       [[211, 161, 114],
        [210, 159, 112],
        [217, 173, 130],
        ...,
        [ 36,  31,  59],
        [ 42,  35,  64],
        [ 41,  35,  63]],

       [[162, 100,  68],
        [161,  98,  66],
        [169, 111,  80],
        ...,
        [ 38,  32,  57],
        [ 41,  34,  59],
        [ 41,  33,  59]],

       [[168, 107,  74],
        [167, 106,  72],
        [175, 119,  86],
        ...,
        [ 38,  32,  57],
        [ 41,  34,  59],
        [ 41,  34,  59]]], dtype=uint8)]"
Image_772.jpg,736,339,166,129,1600,1000,902,468,166,daskShared_local/images/Image_772.jpg,772,"[array([[[  2,  83, 165],
        [  2,  83, 165],
        [  2,  83, 165],
        ...,
        [  0,  81, 163],
        [  0,  81, 163],
        [  0,  81, 163]],

       [[  2,  83, 165],
        [  2,  83, 165],
        [  2,  83, 165],
        ...,
        [  0,  81, 163],
        [  0,  81, 163],
        [  0,  81, 163]],

       [[  2,  83, 165],
        [  2,  83, 165],
        [  2,  83, 165],
        ...,
        [  0,  81, 163],
        [  0,  81, 163],
        [  0,  81, 163]],

       ...,

       [[  4,  62, 147],
        [  3,  62, 146],
        [  3,  62, 145],
        ...,
        [208, 187, 166],
        [194, 169, 151],
        [193, 166, 150]],

       [[  3,  63, 141],
        [  2,  63, 141],
        [  2,  64, 140],
        ...,
        [197, 174, 153],
        [182, 156, 136],
        [177, 150, 131]],

       [[  2,  65, 135],
        [  2,  65, 135],
        [  2,  65, 135],
        ...,
        [196, 171, 148],
        [181, 154, 132],
        [172, 144, 123]]], dtype=uint8)]"
Image_773.jpg,317,290,130,106,1280,720,447,396,130,daskShared_local/images/Image_773.jpg,773,"[array([[[  1,  61, 134],
        [  1,  61, 134],
        [  1,  61, 134],
        ...,
        [  0,  62, 137],
        [  0,  62, 137],
        [  0,  62, 137]],

       [[  1,  61, 134],
        [  1,  61, 134],
        [  1,  61, 134],
        ...,
        [  0,  62, 137],
        [  0,  62, 137],
        [  0,  62, 137]],

       [[  1,  61, 134],
        [  1,  61, 134],
        [  1,  61, 134],
        ...,
        [  0,  62, 137],
        [  0,  62, 137],
        [  0,  62, 137]],

       ...,

       [[ 30, 104, 133],
        [ 30, 104, 133],
        [ 30, 104, 133],
        ...,
        [ 22,  94, 132],
        [ 22,  94, 132],
        [ 22,  94, 132]],

       [[ 31, 105, 134],
        [ 31, 105, 134],
        [ 31, 105, 134],
        ...,
        [ 22,  94, 132],
        [ 22,  94, 132],
        [ 22,  94, 132]],

       [[ 32, 106, 135],
        [ 31, 105, 134],
        [ 31, 105, 134],
        ...,
        [ 22,  94, 132],
        [ 22,  94, 132],
        [ 23,  95, 133]]], dtype=uint8)]"
Image_774.jpg,279,149,220,205,900,600,499,354,220,daskShared_local/images/Image_774.jpg,774,"[array([[[ 79, 176, 208],
        [ 78, 177, 208],
        [ 78, 177, 208],
        ...,
        [ 78, 167, 211],
        [ 78, 167, 211],
        [ 78, 167, 211]],

       [[ 79, 176, 208],
        [ 79, 178, 210],
        [ 79, 178, 209],
        ...,
        [ 78, 167, 211],
        [ 78, 167, 211],
        [ 78, 167, 211]],

       [[ 82, 175, 209],
        [ 80, 177, 212],
        [ 80, 177, 212],
        ...,
        [ 78, 167, 211],
        [ 78, 167, 211],
        [ 78, 167, 211]],

       ...,

       [[ 52, 111, 141],
        [ 53, 117, 145],
        [ 55, 120, 148],
        ...,
        [ 51, 112,  89],
        [ 40,  93,  70],
        [ 12,  60,  41]],

       [[ 50, 111, 139],
        [ 50, 115, 143],
        [ 52, 117, 145],
        ...,
        [ 49, 101,  76],
        [ 13,  56,  33],
        [  0,  45,  26]],

       [[ 50, 111, 139],
        [ 48, 113, 141],
        [ 51, 116, 144],
        ...,
        [ 13,  62,  41],
        [ 35,  84,  61],
        [ 50, 101,  82]]], dtype=uint8)]"
Image_775.jpg,443,215,191,195,1200,630,634,410,195,daskShared_local/images/Image_775.jpg,775,"[array([[[ 30, 102, 174],
        [ 31, 104, 173],
        [ 32, 105, 174],
        ...,
        [ 58,  86,  87],
        [ 53,  81,  82],
        [ 50,  79,  77]],

       [[ 30, 102, 174],
        [ 31, 104, 173],
        [ 32, 105, 174],
        ...,
        [ 52,  77,  81],
        [ 63,  89,  90],
        [ 71,  98,  96]],

       [[ 31, 103, 175],
        [ 33, 106, 175],
        [ 33, 106, 175],
        ...,
        [ 31,  55,  59],
        [ 33,  58,  59],
        [ 47,  71,  71]],

       ...,

       [[ 33,  79, 103],
        [ 34,  78, 103],
        [ 32,  77, 100],
        ...,
        [ 29,  33,  34],
        [ 19,  23,  24],
        [  9,  13,  14]],

       [[ 31,  77, 101],
        [ 36,  82, 106],
        [ 36,  81, 104],
        ...,
        [ 37,  43,  43],
        [ 23,  29,  29],
        [ 23,  27,  28]],

       [[ 29,  77,  99],
        [ 36,  82, 105],
        [ 37,  82, 105],
        ...,
        [ 29,  38,  37],
        [ 27,  33,  33],
        [ 16,  20,  21]]], dtype=uint8)]"
Image_776.jpg,199,434,192,201,2015,1510,391,635,201,daskShared_local/images/Image_776.jpg,776,"[array([[[ 71,  65,  49],
        [ 62,  56,  40],
        [ 34,  28,  14],
        ...,
        [ 11,   5,   5],
        [ 11,   5,   5],
        [ 14,   8,   8]],

       [[ 59,  56,  39],
        [ 52,  49,  34],
        [ 37,  34,  19],
        ...,
        [  4,   0,   0],
        [  5,   0,   0],
        [ 10,   4,   4]],

       [[ 45,  42,  27],
        [ 42,  39,  24],
        [ 44,  40,  28],
        ...,
        [  4,   0,   0],
        [  6,   0,   0],
        [ 12,   6,   6]],

       ...,

       [[149, 137, 125],
        [173, 161, 147],
        [181, 167, 154],
        ...,
        [136, 141, 144],
        [139, 144, 147],
        [135, 139, 142]],

       [[164, 152, 138],
        [185, 171, 158],
        [192, 179, 163],
        ...,
        [138, 143, 146],
        [145, 150, 153],
        [147, 151, 154]],

       [[163, 151, 137],
        [170, 157, 141],
        [185, 172, 156],
        ...,
        [136, 141, 144],
        [145, 150, 153],
        [154, 158, 161]]], dtype=uint8)]"
Image_777.jpg,122,382,414,310,1715,1286,536,692,414,daskShared_local/images/Image_777.jpg,777,"[array([[[144, 161, 155],
        [143, 159, 152],
        [145, 157, 151],
        ...,
        [105, 146, 166],
        [ 78, 108, 164],
        [ 72,  68, 144]],

       [[145, 160, 155],
        [144, 160, 152],
        [145, 161, 152],
        ...,
        [ 67,  75, 155],
        [ 71,  47, 125],
        [ 77,  42,  94]],

       [[148, 161, 157],
        [146, 162, 155],
        [149, 163, 155],
        ...,
        [103,  56,  93],
        [102,  70,  69],
        [109,  85,  67]],

       ...,

       [[180, 190, 188],
        [181, 193, 188],
        [186, 201, 178],
        ...,
        [211, 213, 217],
        [215, 216, 220],
        [218, 217, 222]],

       [[180, 190, 191],
        [182, 192, 190],
        [185, 198, 183],
        ...,
        [210, 215, 219],
        [211, 219, 222],
        [216, 220, 223]],

       [[186, 192, 192],
        [181, 190, 192],
        [183, 196, 194],
        ...,
        [212, 211, 223],
        [209, 213, 224],
        [208, 223, 224]]], dtype=uint8)]"
Image_778.jpg,411,152,821,667,1500,1000,1232,819,821,daskShared_local/images/Image_778.jpg,778,"[array([[[  4,  57,  65],
        [  3,  58,  65],
        [  3,  58,  65],
        ...,
        [181, 170, 173],
        [185, 176, 180],
        [180, 170, 184]],

       [[  4,  58,  64],
        [  3,  58,  65],
        [  3,  57,  65],
        ...,
        [183, 172, 178],
        [180, 173, 179],
        [157, 152, 171]],

       [[  2,  60,  64],
        [  3,  58,  65],
        [  2,  57,  65],
        ...,
        [182, 173, 182],
        [175, 168, 180],
        [135, 134, 158]],

       ...,

       [[146, 166, 192],
        [181, 193, 205],
        [201, 204, 207],
        ...,
        [ 46,  72,  45],
        [ 56,  82,  55],
        [ 58,  85,  55]],

       [[109, 133, 176],
        [152, 170, 198],
        [197, 202, 207],
        ...,
        [ 48,  74,  47],
        [ 57,  83,  54],
        [ 59,  86,  56]],

       [[ 93, 117, 162],
        [124, 145, 183],
        [179, 188, 203],
        ...,
        [ 51,  77,  49],
        [ 58,  84,  55],
        [ 60,  86,  57]]], dtype=uint8)]"
Image_779.jpg,598,79,213,175,1068,601,811,254,213,daskShared_local/images/Image_779.jpg,779,"[array([[[  1,  76, 255],
        [  1,  76, 255],
        [  1,  76, 255],
        ...,
        [  0,  88, 255],
        [  0,  88, 255],
        [  0,  88, 255]],

       [[  0,  75, 255],
        [  0,  75, 255],
        [  1,  76, 255],
        ...,
        [  0,  88, 255],
        [  0,  88, 255],
        [  0,  88, 255]],

       [[  1,  76, 255],
        [  1,  76, 255],
        [  1,  76, 255],
        ...,
        [  0,  88, 255],
        [  0,  88, 255],
        [  0,  88, 255]],

       ...,

       [[208, 193, 184],
        [181, 168, 149],
        [178, 168, 135],
        ...,
        [214, 219, 226],
        [208, 213, 218],
        [212, 220, 227]],

       [[160, 145, 150],
        [ 95,  85,  72],
        [150, 143, 109],
        ...,
        [213, 220, 229],
        [220, 224, 236],
        [213, 218, 229]],

       [[ 58,  63,  59],
        [169, 173, 167],
        [163, 165, 154],
        ...,
        [207, 226, 220],
        [208, 223, 226],
        [209, 221, 233]]], dtype=uint8)]"
Image_78.jpg,76,88,121,131,637,450,197,219,131,daskShared_local/images/Image_78.jpg,78,"[array([[[  1, 170, 253],
        [  1, 170, 253],
        [  1, 170, 253],
        ...,
        [  1, 167, 253],
        [  0, 166, 254],
        [  0, 165, 254]],

       [[  1, 170, 254],
        [  1, 170, 254],
        [  1, 170, 254],
        ...,
        [  1, 167, 253],
        [  0, 166, 254],
        [  0, 165, 254]],

       [[  1, 170, 255],
        [  1, 170, 255],
        [  1, 170, 255],
        ...,
        [  1, 167, 253],
        [  0, 166, 253],
        [  0, 165, 254]],

       ...,

       [[  0, 143, 245],
        [  0, 145, 246],
        [  0, 148, 247],
        ...,
        [  7, 106,  96],
        [ 11, 108,  97],
        [ 13, 109,  98]],

       [[  1, 145, 246],
        [  2, 147, 248],
        [  3, 151, 250],
        ...,
        [  8, 107,  98],
        [  9, 105,  97],
        [  9, 103,  95]],

       [[  1, 145, 247],
        [  2, 148, 249],
        [  4, 153, 252],
        ...,
        [  9, 107,  99],
        [  8, 103,  97],
        [  7, 100,  94]]], dtype=uint8)]"
Image_780.jpg,827,175,145,111,1080,522,972,286,145,daskShared_local/images/Image_780.jpg,780,"[array([[[ 18,  54, 165],
        [ 18,  54, 165],
        [ 18,  54, 165],
        ...,
        [ 14,  38, 136],
        [ 14,  38, 136],
        [ 14,  38, 136]],

       [[ 17,  56, 168],
        [ 17,  55, 167],
        [ 17,  55, 167],
        ...,
        [ 14,  38, 136],
        [ 14,  38, 136],
        [ 14,  38, 136]],

       [[ 18,  56, 172],
        [ 17,  56, 172],
        [ 17,  55, 172],
        ...,
        [ 14,  38, 137],
        [ 14,  38, 137],
        [ 14,  38, 137]],

       ...,

       [[125,  89,  87],
        [131,  93,  89],
        [164, 118, 101],
        ...,
        [ 15,  64, 167],
        [ 15,  64, 167],
        [ 15,  64, 167]],

       [[157, 110,  92],
        [166, 118,  97],
        [195, 143, 114],
        ...,
        [ 16,  65, 167],
        [ 15,  64, 167],
        [ 15,  64, 167]],

       [[187, 133, 102],
        [196, 141, 108],
        [219, 163, 126],
        ...,
        [ 16,  65, 167],
        [ 16,  65, 167],
        [ 15,  64, 166]]], dtype=uint8)]"
Image_781.jpg,282,123,105,124,775,518,387,247,124,daskShared_local/images/Image_781.jpg,781,"[array([[[ 86, 157, 175],
        [ 86, 158, 176],
        [ 87, 160, 177],
        ...,
        [ 83, 155, 172],
        [ 84, 156, 173],
        [ 84, 157, 174]],

       [[ 84, 155, 173],
        [ 84, 156, 173],
        [ 84, 156, 174],
        ...,
        [ 84, 156, 174],
        [ 86, 158, 175],
        [ 87, 159, 176]],

       [[ 81, 152, 170],
        [ 80, 151, 169],
        [ 77, 148, 166],
        ...,
        [ 87, 158, 176],
        [ 90, 161, 179],
        [ 92, 163, 181]],

       ...,

       [[135,  93,  69],
        [144, 102,  78],
        [163, 121,  97],
        ...,
        [132, 106,  91],
        [ 80,  54,  47],
        [ 56,  30,  26]],

       [[133,  90,  66],
        [137,  94,  70],
        [147, 105,  81],
        ...,
        [129, 104,  86],
        [ 83,  57,  50],
        [ 62,  36,  34]],

       [[133,  89,  66],
        [134,  91,  67],
        [141,  99,  75],
        ...,
        [130, 105,  85],
        [ 86,  60,  53],
        [ 65,  39,  38]]], dtype=uint8)]"
Image_782.jpg,108,106,426,304,800,533,534,410,426,daskShared_local/images/Image_782.jpg,782,"[array([[[  5,  10,  56],
        [  4,   9,  55],
        [  3,  11,  56],
        ...,
        [  9,  22,  74],
        [  6,  19,  72],
        [  6,  19,  73]],

       [[ 14,  23,  75],
        [  3,   9,  62],
        [  4,  13,  60],
        ...,
        [  9,  19,  71],
        [  7,  18,  70],
        [  6,  19,  71]],

       [[ 25,  35,  88],
        [ 24,  34,  89],
        [  3,  15,  63],
        ...,
        [  8,  18,  69],
        [  8,  18,  72],
        [ 10,  20,  75]],

       ...,

       [[  6,  15,  58],
        [  6,  13,  57],
        [  8,  16,  59],
        ...,
        [198, 165, 118],
        [200, 165, 128],
        [198, 165, 131]],

       [[  6,  15,  58],
        [  5,  12,  57],
        [  4,  15,  58],
        ...,
        [182, 160, 137],
        [174, 151, 135],
        [171, 153, 139]],

       [[  4,  11,  56],
        [  4,  10,  57],
        [  3,  14,  58],
        ...,
        [131, 122, 110],
        [109, 100,  86],
        [ 92,  88,  73]]], dtype=uint8)]"
Image_783.jpg,624,309,155,142,1440,960,779,451,155,daskShared_local/images/Image_783.jpg,783,"[array([[[  1, 146, 209],
        [  1, 146, 209],
        [  1, 146, 209],
        ...,
        [  0, 144, 212],
        [  0, 144, 211],
        [  0, 144, 211]],

       [[  2, 147, 208],
        [  1, 147, 208],
        [  1, 147, 208],
        ...,
        [  1, 144, 212],
        [  1, 144, 212],
        [  2, 145, 213]],

       [[  1, 147, 207],
        [  1, 147, 207],
        [  1, 147, 207],
        ...,
        [  1, 144, 212],
        [  2, 145, 213],
        [  2, 145, 213]],

       ...,

       [[ 58,  58,  39],
        [ 60,  60,  41],
        [ 63,  63,  45],
        ...,
        [  0,  75, 114],
        [  1,  77, 115],
        [  1,  77, 116]],

       [[ 36,  43,  26],
        [ 28,  35,  19],
        [ 40,  46,  30],
        ...,
        [  0,  76, 114],
        [  0,  77, 115],
        [  0,  78, 116]],

       [[ 32,  39,  24],
        [ 29,  36,  21],
        [ 43,  49,  34],
        ...,
        [  1,  79, 117],
        [  1,  79, 117],
        [  1,  79, 117]]], dtype=uint8)]"
Image_784.jpg,1132,136,2480,2628,4608,3072,3612,2764,2628,daskShared_local/images/Image_784.jpg,784,"[array([[[ 29,  29,  27],
        [ 29,  30,  28],
        [ 29,  29,  27],
        ...,
        [169, 163, 119],
        [168, 162, 119],
        [169, 163, 119]],

       [[ 29,  29,  27],
        [ 29,  30,  28],
        [ 36,  36,  36],
        ...,
        [167, 162, 117],
        [167, 162, 119],
        [168, 162, 119]],

       [[ 32,  32,  30],
        [ 45,  45,  45],
        [ 66,  66,  67],
        ...,
        [167, 161, 117],
        [166, 161, 118],
        [167, 161, 118]],

       ...,

       [[ 97,  80,  54],
        [ 96,  80,  53],
        [ 96,  79,  51],
        ...,
        [151, 130,  86],
        [155, 134,  87],
        [159, 140,  92]],

       [[ 94,  76,  49],
        [ 94,  77,  52],
        [ 93,  76,  49],
        ...,
        [156, 132,  78],
        [161, 138,  87],
        [171, 148, 100]],

       [[ 91,  74,  46],
        [ 92,  75,  49],
        [ 91,  74,  44],
        ...,
        [172, 146,  83],
        [175, 152,  98],
        [174, 153, 104]]], dtype=uint8)]"
Image_785.jpg,1255,1041,416,405,2592,1944,1671,1446,416,daskShared_local/images/Image_785.jpg,785,"[array([[[136, 107,  82],
        [195, 170, 150],
        [215, 198, 180],
        ...,
        [ 44, 116, 168],
        [ 42, 114, 171],
        [ 41, 113, 173]],

       [[206, 178, 151],
        [225, 203, 184],
        [218, 202, 189],
        ...,
        [ 46, 117, 170],
        [ 45, 115, 172],
        [ 43, 114, 174]],

       [[238, 214, 194],
        [241, 222, 208],
        [236, 223, 216],
        ...,
        [ 45, 114, 169],
        [ 48, 118, 172],
        [ 44, 116, 170]],

       ...,

       [[ 39, 117, 163],
        [ 38, 116, 162],
        [ 38, 116, 162],
        ...,
        [ 38, 120, 166],
        [ 38, 120, 166],
        [ 37, 119, 165]],

       [[ 40, 118, 164],
        [ 40, 118, 164],
        [ 41, 119, 165],
        ...,
        [ 38, 121, 165],
        [ 36, 119, 163],
        [ 36, 119, 163]],

       [[ 39, 117, 165],
        [ 40, 118, 166],
        [ 42, 120, 169],
        ...,
        [ 39, 121, 166],
        [ 39, 121, 166],
        [ 38, 120, 165]]], dtype=uint8)]"
Image_786.jpg,638,353,290,290,2361,1176,928,643,290,daskShared_local/images/Image_786.jpg,786,"[array([[[  8, 145, 197],
        [  6, 147, 199],
        [  6, 147, 200],
        ...,
        [ 48, 172, 210],
        [ 46, 171, 209],
        [ 44, 170, 208]],

       [[  9, 146, 198],
        [  5, 148, 199],
        [  4, 148, 200],
        ...,
        [ 47, 170, 210],
        [ 46, 169, 209],
        [ 44, 168, 209]],

       [[ 10, 147, 199],
        [  7, 149, 201],
        [  5, 149, 201],
        ...,
        [ 47, 170, 211],
        [ 47, 170, 211],
        [ 45, 168, 210]],

       ...,

       [[ 10, 173, 240],
        [  8, 174, 238],
        [  7, 175, 238],
        ...,
        [ 62,  98,  92],
        [ 36,  77,  73],
        [ 30,  74,  71]],

       [[ 10, 174, 238],
        [  9, 174, 238],
        [  8, 173, 237],
        ...,
        [ 43,  84,  84],
        [ 30,  70,  71],
        [ 28,  68,  70]],

       [[ 10, 175, 239],
        [ 10, 175, 239],
        [  8, 173, 237],
        ...,
        [ 34,  78,  75],
        [ 28,  71,  70],
        [ 23,  64,  64]]], dtype=uint8)]"
Image_787.jpg,1847,2571,472,409,2720,4080,2319,2980,472,daskShared_local/images/Image_787.jpg,787,"[array([[[ 11, 138, 196],
        [  2, 124, 183],
        [  2, 129, 192],
        ...,
        [  3, 120, 194],
        [  4, 121, 195],
        [  3, 120, 194]],

       [[  5, 130, 187],
        [  3, 129, 188],
        [  3, 130, 193],
        ...,
        [  2, 116, 191],
        [  2, 115, 191],
        [  8, 124, 200]],

       [[  4, 130, 188],
        [  3, 128, 186],
        [  1, 124, 184],
        ...,
        [  5, 121, 198],
        [  5, 119, 199],
        [  3, 117, 198]],

       ...,

       [[  8, 119, 193],
        [  5, 117, 191],
        [  7, 117, 191],
        ...,
        [  4, 113, 189],
        [  5, 115, 191],
        [  6, 117, 193]],

       [[  4, 115, 189],
        [  7, 118, 192],
        [  4, 114, 188],
        ...,
        [  4, 112, 189],
        [  3, 113, 190],
        [  2, 107, 183]],

       [[  5, 117, 191],
        [  6, 118, 192],
        [  6, 118, 192],
        ...,
        [  4, 113, 190],
        [  3, 112, 189],
        [  6, 116, 193]]], dtype=uint8)]"
Image_788.jpg,762,155,239,193,1050,700,1001,348,239,daskShared_local/images/Image_788.jpg,788,"[array([[[ 15, 112, 118],
        [ 18, 133, 130],
        [  8, 150, 130],
        ...,
        [ 29,  47,  54],
        [ 32,  44,  52],
        [ 27,  38,  42]],

       [[ 62, 157, 158],
        [  3, 108, 106],
        [  0, 133, 118],
        ...,
        [ 25,  45,  53],
        [ 27,  39,  49],
        [ 23,  34,  40]],

       [[ 51, 172, 168],
        [ 14, 132, 133],
        [  2, 137, 133],
        ...,
        [ 30,  52,  66],
        [ 32,  47,  64],
        [ 23,  37,  45]],

       ...,

       [[ 33,  47,  49],
        [ 40,  53,  55],
        [ 34,  46,  49],
        ...,
        [ 39,  40,  45],
        [ 31,  38,  45],
        [ 27,  32,  37]],

       [[ 37,  51,  54],
        [ 43,  57,  60],
        [ 39,  53,  56],
        ...,
        [ 73,  64,  73],
        [ 65,  55,  70],
        [ 50,  42,  51]],

       [[ 30,  44,  47],
        [ 31,  45,  48],
        [ 33,  47,  50],
        ...,
        [101,  89, 102],
        [115,  83, 106],
        [117,  95, 113]]], dtype=uint8)]"
Image_789.jpg,496,75,161,138,1024,335,657,213,161,daskShared_local/images/Image_789.jpg,789,"[array([[[  1, 205, 226],
        [  4, 208, 231],
        [  6, 210, 235],
        ...,
        [  2, 177, 220],
        [  2, 178, 221],
        [  1, 178, 220]],

       [[  3, 206, 228],
        [  4, 207, 231],
        [  4, 208, 232],
        ...,
        [  2, 177, 220],
        [  2, 177, 220],
        [  0, 177, 219]],

       [[  5, 207, 229],
        [  4, 207, 230],
        [  2, 206, 230],
        ...,
        [  2, 177, 220],
        [  1, 177, 220],
        [  0, 176, 219]],

       ...,

       [[  2,  43,  52],
        [ 18,  52,  54],
        [ 46,  66,  55],
        ...,
        [203, 203, 157],
        [202, 202, 157],
        [208, 205, 161]],

       [[ 20,  53,  46],
        [ 42,  69,  55],
        [ 75,  90,  65],
        ...,
        [204, 202, 152],
        [201, 201, 151],
        [201, 200, 153]],

       [[ 58,  66,  32],
        [ 97, 103,  64],
        [122, 127,  78],
        ...,
        [207, 198, 147],
        [205, 199, 146],
        [201, 201, 143]]], dtype=uint8)]"
Image_79.jpg,281,127,103,123,775,518,384,250,123,daskShared_local/images/Image_79.jpg,79,"[array([[[ 81, 154, 171],
        [ 82, 154, 171],
        [ 83, 155, 173],
        ...,
        [ 87, 156, 171],
        [ 92, 160, 176],
        [ 94, 163, 178]],

       [[ 83, 156, 174],
        [ 83, 156, 175],
        [ 83, 157, 176],
        ...,
        [ 90, 158, 175],
        [ 93, 161, 178],
        [ 94, 163, 179]],

       [[ 88, 161, 183],
        [ 87, 161, 183],
        [ 85, 162, 182],
        ...,
        [ 98, 165, 184],
        [ 96, 164, 183],
        [ 95, 163, 182]],

       ...,

       [[146, 105,  76],
        [153, 110,  83],
        [170, 125, 102],
        ...,
        [131,  85,  82],
        [114,  74,  60],
        [108,  70,  52]],

       [[161, 119,  88],
        [163, 120,  91],
        [167, 123,  99],
        ...,
        [118,  73,  68],
        [100,  59,  45],
        [ 93,  54,  35]],

       [[168, 125,  94],
        [167, 124,  95],
        [165, 123,  98],
        ...,
        [113,  68,  62],
        [ 94,  53,  38],
        [ 87,  48,  29]]], dtype=uint8)]"
Image_790.jpg,291,372,178,146,1024,683,469,518,178,daskShared_local/images/Image_790.jpg,790,"[array([[[168, 188, 189],
        [188, 207, 206],
        [196, 214, 208],
        ...,
        [ 57,  61,  57],
        [ 68,  67,  63],
        [ 80,  75,  71]],

       [[158, 179, 179],
        [173, 192, 191],
        [187, 202, 195],
        ...,
        [ 61,  63,  61],
        [ 74,  72,  68],
        [ 84,  76,  73]],

       [[156, 177, 177],
        [167, 185, 181],
        [184, 198, 188],
        ...,
        [ 61,  59,  59],
        [ 67,  63,  59],
        [ 73,  67,  62]],

       ...,

       [[  0, 104, 131],
        [  0, 104, 131],
        [  0, 104, 131],
        ...,
        [  0, 113, 139],
        [  0, 113, 139],
        [  0, 113, 139]],

       [[  0, 104, 131],
        [  0, 104, 131],
        [  0, 104, 131],
        ...,
        [  0, 112, 138],
        [  0, 112, 138],
        [  0, 112, 138]],

       [[  0, 104, 131],
        [  0, 104, 131],
        [  0, 104, 131],
        ...,
        [  0, 112, 138],
        [  0, 112, 138],
        [  0, 112, 138]]], dtype=uint8)]"
Image_791.jpg,433,198,207,213,900,600,640,411,213,daskShared_local/images/Image_791.jpg,791,"[array([[[  2, 130, 237],
        [  3, 131, 238],
        [  4, 133, 237],
        ...,
        [  1,  92, 209],
        [  1,  92, 209],
        [  0,  91, 208]],

       [[  2, 130, 237],
        [  3, 131, 238],
        [  3, 132, 239],
        ...,
        [  1,  91, 209],
        [  1,  92, 209],
        [  0,  91, 208]],

       [[  0, 128, 237],
        [  1, 129, 238],
        [  1, 132, 238],
        ...,
        [  1,  91, 209],
        [  1,  92, 209],
        [  1,  92, 209]],

       ...,

       [[169, 165, 103],
        [166, 161,  98],
        [182, 172, 100],
        ...,
        [  1,  52, 165],
        [  1,  53, 165],
        [  1,  52, 165]],

       [[182, 181, 112],
        [178, 176, 108],
        [195, 187, 123],
        ...,
        [  2,  52, 165],
        [  1,  53, 165],
        [  1,  53, 165]],

       [[201, 200, 135],
        [207, 205, 142],
        [214, 207, 155],
        ...,
        [  1,  52, 163],
        [  0,  52, 164],
        [  0,  52, 164]]], dtype=uint8)]"
Image_792.jpg,400,186,89,59,800,600,489,245,89,daskShared_local/images/Image_792.jpg,792,"[array([[[115, 131, 126],
        [114, 130, 126],
        [116, 132, 127],
        ...,
        [ 58, 121, 176],
        [ 58, 119, 174],
        [ 58, 120, 175]],

       [[113, 131, 128],
        [112, 130, 127],
        [114, 132, 129],
        ...,
        [ 59, 121, 177],
        [ 58, 119, 176],
        [ 58, 120, 177]],

       [[121, 131, 120],
        [121, 130, 120],
        [124, 133, 121],
        ...,
        [ 58, 122, 171],
        [ 58, 120, 168],
        [ 58, 121, 169]],

       ...,

       [[112, 117, 154],
        [112, 117, 153],
        [112, 117, 157],
        ...,
        [ 16, 132, 240],
        [ 14, 131, 236],
        [ 14, 132, 237]],

       [[114, 118, 157],
        [114, 118, 157],
        [114, 117, 159],
        ...,
        [ 16, 133, 241],
        [ 14, 131, 236],
        [ 15, 132, 237]],

       [[113, 118, 157],
        [113, 118, 156],
        [113, 117, 159],
        ...,
        [ 16, 133, 240],
        [ 14, 131, 236],
        [ 15, 132, 237]]], dtype=uint8)]"
Image_793.jpg,800,329,158,130,1536,1024,958,459,158,daskShared_local/images/Image_793.jpg,793,"[array([[[  0,  40,  68],
        [  0,  47,  88],
        [  3,  68, 128],
        ...,
        [ 46, 123, 213],
        [ 46, 123, 213],
        [ 46, 123, 213]],

       [[  3,  48,  82],
        [  1,  60, 106],
        [  6,  83, 147],
        ...,
        [ 47, 124, 214],
        [ 47, 124, 214],
        [ 47, 124, 214]],

       [[  9,  62, 104],
        [  5,  78, 132],
        [ 13, 100, 170],
        ...,
        [ 47, 124, 214],
        [ 47, 124, 214],
        [ 47, 124, 214]],

       ...,

       [[ 19, 116, 201],
        [ 19, 115, 201],
        [ 19, 115, 201],
        ...,
        [ 13, 113, 201],
        [ 13, 113, 202],
        [ 11, 112, 202]],

       [[ 15, 115, 200],
        [ 17, 115, 201],
        [ 20, 116, 203],
        ...,
        [ 11, 113, 201],
        [ 11, 112, 202],
        [ 10, 112, 202]],

       [[ 11, 114, 201],
        [ 15, 115, 203],
        [ 19, 116, 205],
        ...,
        [  8, 113, 202],
        [  7, 112, 203],
        [  7, 111, 202]]], dtype=uint8)]"
Image_794.jpg,377,161,121,112,900,600,498,273,121,daskShared_local/images/Image_794.jpg,794,"[array([[[180, 151, 175],
        [181, 152, 176],
        [183, 156, 179],
        ...,
        [ 93, 130, 144],
        [ 96, 131, 147],
        [ 97, 131, 148]],

       [[179, 150, 174],
        [179, 151, 175],
        [181, 155, 179],
        ...,
        [101, 132, 143],
        [104, 133, 146],
        [105, 133, 147]],

       [[175, 148, 173],
        [175, 149, 174],
        [177, 154, 178],
        ...,
        [125, 138, 141],
        [126, 139, 145],
        [126, 139, 146]],

       ...,

       [[  0, 118, 185],
        [  0, 117, 185],
        [  1, 113, 184],
        ...,
        [121,  89, 112],
        [117,  86, 110],
        [115,  85, 109]],

       [[  0, 102, 176],
        [  0, 101, 176],
        [  1,  98, 175],
        ...,
        [113,  82, 106],
        [108,  78, 102],
        [106,  77, 101]],

       [[  0,  96, 173],
        [  0,  95, 172],
        [  1,  93, 171],
        ...,
        [110,  80, 103],
        [104,  75,  99],
        [102,  73,  98]]], dtype=uint8)]"
Image_795.jpg,71,73,94,87,300,260,165,160,94,daskShared_local/images/Image_795.jpg,795,"[array([[[  0, 229, 253],
        [  0, 229, 253],
        [  0, 229, 253],
        ...,
        [  3, 195, 234],
        [  4, 194, 234],
        [  4, 195, 234]],

       [[  0, 230, 253],
        [  0, 230, 253],
        [  0, 230, 253],
        ...,
        [  2, 195, 235],
        [  4, 195, 235],
        [  4, 195, 235]],

       [[  1, 229, 253],
        [  1, 229, 253],
        [  0, 229, 253],
        ...,
        [  6, 191, 230],
        [ 11, 190, 231],
        [ 11, 190, 231]],

       ...,

       [[  0, 188, 238],
        [  0, 188, 238],
        [  0, 188, 239],
        ...,
        [ 39, 102,  75],
        [ 18,  80,  53],
        [ 21,  82,  56]],

       [[  0, 189, 238],
        [  0, 189, 238],
        [  0, 189, 239],
        ...,
        [ 93, 151, 120],
        [ 45, 102,  72],
        [ 50, 108,  77]],

       [[  0, 189, 238],
        [  0, 189, 238],
        [  0, 189, 239],
        ...,
        [ 88, 146, 115],
        [ 42, 100,  70],
        [ 47, 105,  74]]], dtype=uint8)]"
Image_796.jpg,276,171,264,222,1000,541,540,393,264,daskShared_local/images/Image_796.jpg,796,"[array([[[  2, 112, 143],
        [  2, 118, 152],
        [  3, 122, 157],
        ...,
        [  1,  98, 126],
        [  9,  93, 119],
        [ 23,  85, 105]],

       [[  6, 107, 138],
        [  3, 115, 144],
        [  2, 121, 151],
        ...,
        [  3,  94, 122],
        [ 10,  89, 115],
        [ 23,  84, 105]],

       [[  6, 106, 135],
        [  1, 114, 144],
        [  0, 123, 152],
        ...,
        [  2,  90, 114],
        [ 11,  86, 108],
        [ 22,  82, 101]],

       ...,

       [[  0, 108, 130],
        [  2, 101, 120],
        [  0,  91, 106],
        ...,
        [159, 184, 217],
        [ 98, 127, 157],
        [ 78, 111, 137]],

       [[  1, 100, 121],
        [  0,  93, 110],
        [  0,  83,  95],
        ...,
        [ 95, 129, 165],
        [ 80, 114, 148],
        [ 94, 128, 157]],

       [[  3,  86, 104],
        [  3,  79,  93],
        [  0,  68,  78],
        ...,
        [101, 141, 168],
        [ 72, 108, 136],
        [ 94, 126, 152]]], dtype=uint8)]"
Image_797.jpg,75,88,119,121,637,450,194,209,121,daskShared_local/images/Image_797.jpg,797,"[array([[[  1, 170, 253],
        [  1, 170, 253],
        [  1, 170, 253],
        ...,
        [  2, 175, 254],
        [  1, 174, 253],
        [  1, 174, 253]],

       [[  1, 170, 254],
        [  1, 170, 254],
        [  1, 170, 254],
        ...,
        [  2, 175, 254],
        [  1, 174, 253],
        [  1, 174, 253]],

       [[  1, 170, 255],
        [  1, 170, 255],
        [  1, 170, 255],
        ...,
        [  1, 174, 253],
        [  1, 174, 253],
        [  1, 174, 253]],

       ...,

       [[  1, 148, 250],
        [  1, 150, 251],
        [  3, 155, 254],
        ...,
        [129, 142, 112],
        [131, 140, 115],
        [132, 139, 115]],

       [[  0, 148, 246],
        [  1, 150, 247],
        [  1, 157, 250],
        ...,
        [129, 149, 118],
        [121, 138, 108],
        [118, 134, 105]],

       [[  0, 148, 244],
        [  0, 151, 245],
        [  1, 158, 248],
        ...,
        [129, 151, 120],
        [117, 138, 106],
        [112, 133, 101]]], dtype=uint8)]"
Image_798.jpg,444,147,145,116,1024,512,589,263,145,daskShared_local/images/Image_798.jpg,798,"[array([[[  2, 131, 188],
        [  2, 131, 188],
        [  2, 131, 188],
        ...,
        [  0, 171, 214],
        [  0, 171, 214],
        [  0, 171, 214]],

       [[  2, 131, 188],
        [  2, 131, 188],
        [  2, 131, 188],
        ...,
        [  1, 172, 215],
        [  1, 172, 215],
        [  1, 172, 215]],

       [[  3, 131, 188],
        [  3, 131, 188],
        [  2, 131, 188],
        ...,
        [  2, 173, 216],
        [  3, 174, 217],
        [  4, 175, 218]],

       ...,

       [[169, 162, 122],
        [145, 139, 101],
        [124, 120,  85],
        ...,
        [  1, 145, 198],
        [  1, 145, 198],
        [  0, 144, 197]],

       [[190, 185, 143],
        [159, 154, 115],
        [139, 136, 101],
        ...,
        [  1, 145, 198],
        [  0, 144, 197],
        [  0, 144, 197]],

       [[190, 185, 143],
        [157, 152, 113],
        [139, 136, 101],
        ...,
        [  0, 144, 197],
        [  0, 144, 197],
        [  0, 144, 197]]], dtype=uint8)]"
Image_799.jpg,231,19,227,224,980,500,458,243,227,daskShared_local/images/Image_799.jpg,799,"[array([[[120, 178, 251],
        [125, 178, 253],
        [137, 187, 246],
        ...,
        [ 42, 124, 196],
        [ 49, 104, 160],
        [ 90, 143, 201]],

       [[123, 181, 253],
        [125, 184, 253],
        [119, 175, 251],
        ...,
        [113, 178, 239],
        [ 40, 115, 186],
        [ 27, 101, 170]],

       [[126, 184, 255],
        [125, 185, 251],
        [119, 177, 255],
        ...,
        [125, 181, 249],
        [ 97, 169, 232],
        [ 73, 145, 202]],

       ...,

       [[ 52,  85,  87],
        [ 50,  79,  84],
        [ 55,  85,  89],
        ...,
        [ 53,  85,  92],
        [ 61,  96, 104],
        [ 67, 102, 109]],

       [[ 53,  87,  89],
        [ 54,  83,  89],
        [ 53,  84,  89],
        ...,
        [ 63, 100, 108],
        [ 67, 107, 118],
        [ 71, 110, 120]],

       [[ 50,  85,  87],
        [ 53,  86,  91],
        [ 55,  90,  94],
        ...,
        [ 69, 107, 118],
        [ 68, 108, 119],
        [ 69, 107, 120]]], dtype=uint8)]"
Image_8.jpg,296,173,230,196,1000,664,526,369,230,daskShared_local/images/Image_8.jpg,8,"[array([[[  0,  79, 148],
        [  0,  79, 146],
        [  0,  79, 146],
        ...,
        [  0,  99, 169],
        [  0,  99, 171],
        [  0, 100, 170]],

       [[  0,  79, 146],
        [  0,  79, 146],
        [  0,  79, 147],
        ...,
        [  0,  99, 168],
        [  0, 100, 171],
        [  0,  99, 170]],

       [[  1,  80, 147],
        [  0,  79, 146],
        [  0,  79, 148],
        ...,
        [  1,  99, 168],
        [  0,  98, 168],
        [  0, 101, 170]],

       ...,

       [[ 34,  43,  42],
        [ 33,  54,  49],
        [ 36,  55,  49],
        ...,
        [232, 220, 179],
        [234, 227, 181],
        [189, 176, 150]],

       [[ 24,  28,  26],
        [ 23,  34,  35],
        [ 29,  43,  38],
        ...,
        [218, 206, 162],
        [223, 212, 166],
        [188, 173, 141]],

       [[ 18,  18,  14],
        [ 14,  22,  25],
        [ 26,  36,  38],
        ...,
        [192, 172, 125],
        [202, 183, 137],
        [198, 183, 146]]], dtype=uint8)]"
Image_80.jpg,608,314,170,132,1440,960,778,446,170,daskShared_local/images/Image_80.jpg,80,"[array([[[  0, 148, 210],
        [  0, 148, 210],
        [  0, 148, 210],
        ...,
        [  1, 146, 216],
        [  2, 148, 218],
        [  0, 147, 216]],

       [[  0, 148, 208],
        [  0, 147, 208],
        [  0, 147, 208],
        ...,
        [  1, 147, 217],
        [  3, 147, 217],
        [  2, 146, 216]],

       [[  0, 147, 207],
        [  0, 147, 207],
        [  0, 147, 207],
        ...,
        [  1, 147, 216],
        [  2, 146, 216],
        [  1, 145, 215]],

       ...,

       [[ 62,  58,  41],
        [ 64,  62,  46],
        [ 60,  61,  46],
        ...,
        [  1,  75, 112],
        [  0,  74, 112],
        [  0,  76, 114]],

       [[ 94,  91,  75],
        [103, 102,  85],
        [ 85,  87,  71],
        ...,
        [  2,  76, 114],
        [  0,  76, 114],
        [  0,  77, 115]],

       [[146, 137, 134],
        [134, 127, 118],
        [105, 102,  87],
        ...,
        [  1,  76, 112],
        [  0,  75, 112],
        [  0,  76, 114]]], dtype=uint8)]"
Image_800.jpg,315,159,170,178,1200,735,485,337,178,daskShared_local/images/Image_800.jpg,800,"[array([[[116, 192, 206],
        [117, 193, 208],
        [114, 190, 204],
        ...,
        [  4,  30,  52],
        [  1,  32,  52],
        [  0,  37,  56]],

       [[107, 191, 208],
        [105, 190, 207],
        [103, 187, 204],
        ...,
        [ 12,  28,  58],
        [  9,  29,  57],
        [  1,  20,  46]],

       [[105, 189, 207],
        [102, 185, 203],
        [ 97, 181, 199],
        ...,
        [ 19,  34,  62],
        [ 18,  36,  63],
        [ 12,  35,  60]],

       ...,

       [[153, 195, 189],
        [153, 195, 190],
        [151, 194, 188],
        ...,
        [  4,   5,   0],
        [ 13,  14,   5],
        [ 46,  44,  28]],

       [[152, 194, 190],
        [152, 194, 191],
        [149, 192, 188],
        ...,
        [  8,   5,   1],
        [  9,   6,   2],
        [  5,   0,   0]],

       [[139, 184, 179],
        [141, 186, 183],
        [141, 186, 183],
        ...,
        [ 38,  12,   4],
        [ 19,   0,   0],
        [ 16,   0,   0]]], dtype=uint8)]"
Image_801.jpg,115,335,185,189,735,1102,300,524,189,daskShared_local/images/Image_801.jpg,801,"[array([[[  0, 123, 205],
        [  0, 123, 205],
        [  0, 122, 208],
        ...,
        [  0, 134, 215],
        [  3, 143, 222],
        [  0, 140, 216]],

       [[  0, 124, 208],
        [  0, 118, 209],
        [  2, 121, 212],
        ...,
        [  2, 144, 222],
        [  9, 146, 225],
        [  8, 142, 221]],

       [[  3, 125, 210],
        [  3, 122, 212],
        [  2, 121, 213],
        ...,
        [  4, 146, 224],
        [  3, 142, 221],
        [  2, 139, 218]],

       ...,

       [[  3, 122, 211],
        [  0, 119, 208],
        [  2, 123, 211],
        ...,
        [ 41,  98,  98],
        [ 46,  99,  93],
        [ 34,  80,  75]],

       [[  0, 120, 207],
        [  0, 119, 208],
        [  3, 124, 211],
        ...,
        [ 33,  80,  75],
        [ 42,  84,  81],
        [ 35,  73,  76]],

       [[  0, 120, 207],
        [  0, 122, 208],
        [  3, 125, 211],
        ...,
        [ 37,  76,  76],
        [ 55,  94,  97],
        [ 39,  77,  88]]], dtype=uint8)]"
Image_802.jpg,107,87,74,79,500,461,181,166,79,daskShared_local/images/Image_802.jpg,802,"[array([[[ 43, 127, 120],
        [ 40, 125, 117],
        [ 46, 128, 122],
        ...,
        [ 17,  91,  98],
        [ 16,  93,  99],
        [ 16,  92,  98]],

       [[ 41, 125, 118],
        [ 38, 124, 116],
        [ 44, 127, 121],
        ...,
        [ 17,  92,  98],
        [ 16,  94,  99],
        [ 16,  93,  99]],

       [[ 45, 128, 121],
        [ 42, 127, 119],
        [ 48, 129, 123],
        ...,
        [ 17,  91,  97],
        [ 16,  92,  98],
        [ 17,  91,  97]],

       ...,

       [[ 34,  92,  96],
        [ 34,  92,  96],
        [ 34,  92,  96],
        ...,
        [ 66,  29,  24],
        [ 68,  30,  26],
        [ 67,  30,  25]],

       [[ 34,  92,  96],
        [ 34,  92,  96],
        [ 34,  92,  96],
        ...,
        [ 64,  27,  22],
        [ 67,  30,  24],
        [ 65,  28,  23]],

       [[ 34,  92,  96],
        [ 34,  92,  96],
        [ 34,  92,  96],
        ...,
        [ 65,  28,  23],
        [ 67,  30,  25],
        [ 66,  29,  24]]], dtype=uint8)]"
Image_803.jpg,438,368,215,213,1024,683,653,581,215,daskShared_local/images/Image_803.jpg,803,"[array([[[ 95,  86,  91],
        [ 76,  67,  72],
        [118, 104,  98],
        ...,
        [ 63,  41,  35],
        [ 61,  40,  32],
        [ 57,  39,  29]],

       [[115,  94,  93],
        [100,  73,  68],
        [ 95,  77,  69],
        ...,
        [ 55,  39,  39],
        [ 49,  35,  32],
        [ 52,  41,  37]],

       [[128, 107, 103],
        [110,  85,  80],
        [156, 140, 132],
        ...,
        [ 57,  41,  41],
        [ 56,  42,  40],
        [ 60,  48,  44]],

       ...,

       [[190, 175, 140],
        [125, 115,  79],
        [101, 111,  68],
        ...,
        [217, 190, 140],
        [240, 215, 171],
        [206, 177, 140]],

       [[212, 186, 157],
        [190, 170, 141],
        [214, 213, 187],
        ...,
        [249, 230, 195],
        [240, 221, 189],
        [235, 216, 185]],

       [[222, 189, 163],
        [208, 178, 150],
        [211, 176, 141],
        ...,
        [248, 222, 194],
        [243, 219, 192],
        [254, 246, 215]]], dtype=uint8)]"
Image_804.jpg,504,79,321,391,1600,900,825,470,391,daskShared_local/images/Image_804.jpg,804,"[array([[[  1, 158, 211],
        [  1, 158, 211],
        [  0, 159, 211],
        ...,
        [153, 200, 242],
        [153, 200, 242],
        [154, 201, 243]],

       [[  0, 157, 210],
        [  0, 157, 210],
        [  0, 158, 210],
        ...,
        [152, 199, 241],
        [153, 200, 242],
        [154, 201, 243]],

       [[  0, 157, 210],
        [  0, 157, 210],
        [  0, 158, 210],
        ...,
        [152, 199, 241],
        [153, 200, 242],
        [153, 200, 242]],

       ...,

       [[  0, 143, 203],
        [  0, 143, 203],
        [  0, 143, 203],
        ...,
        [ 64,  48,  41],
        [ 74,  57,  42],
        [ 85,  66,  48]],

       [[  0, 143, 203],
        [  1, 144, 204],
        [  1, 144, 204],
        ...,
        [ 60,  44,  38],
        [ 74,  57,  44],
        [ 75,  56,  39]],

       [[  0, 143, 203],
        [  0, 143, 203],
        [  0, 143, 203],
        ...,
        [ 55,  39,  35],
        [ 74,  55,  44],
        [ 79,  57,  42]]], dtype=uint8)]"
Image_805.jpg,440,300,194,170,940,625,634,470,194,daskShared_local/images/Image_805.jpg,805,"[array([[[ 69,  61,  42],
        [ 72,  64,  43],
        [ 77,  70,  42],
        ...,
        [124, 149, 156],
        [116, 146, 150],
        [107, 142, 144]],

       [[ 59,  52,  33],
        [ 66,  58,  35],
        [ 68,  61,  33],
        ...,
        [112, 137, 144],
        [ 96, 125, 131],
        [ 96, 131, 135]],

       [[ 33,  26,   7],
        [ 45,  37,  14],
        [ 51,  44,  16],
        ...,
        [109, 134, 143],
        [ 93, 122, 130],
        [ 94, 129, 135]],

       ...,

       [[123, 177, 155],
        [119, 174, 154],
        [112, 167, 148],
        ...,
        [ 38, 106,  95],
        [ 36, 107,  95],
        [ 33, 105,  93]],

       [[104, 166, 155],
        [103, 163, 155],
        [102, 159, 152],
        ...,
        [ 31, 103,  89],
        [ 28, 102,  87],
        [ 24, 100,  87]],

       [[ 99, 160, 152],
        [ 97, 157, 149],
        [ 95, 152, 145],
        ...,
        [ 30, 102,  88],
        [ 26, 100,  85],
        [ 22,  99,  83]]], dtype=uint8)]"
Image_806.jpg,868,516,238,199,1920,1200,1106,715,238,daskShared_local/images/Image_806.jpg,806,"[array([[[  0, 113, 116],
        [  0, 112, 116],
        [  0, 112, 116],
        ...,
        [  3, 123, 123],
        [  1, 122, 118],
        [  1, 122, 115]],

       [[  1, 113, 117],
        [  1, 112, 117],
        [  1, 112, 116],
        ...,
        [  3, 123, 123],
        [  1, 121, 118],
        [  2, 123, 118]],

       [[  5, 115, 120],
        [  5, 114, 119],
        [  2, 110, 116],
        ...,
        [  3, 123, 122],
        [  3, 124, 121],
        [  1, 123, 119]],

       ...,

       [[104,  86,  43],
        [119, 102,  61],
        [126, 112,  70],
        ...,
        [ 52,  45,  41],
        [ 31,  28,  26],
        [ 29,  28,  26]],

       [[103,  85,  44],
        [119, 103,  62],
        [122, 108,  66],
        ...,
        [ 52,  42,  37],
        [ 31,  28,  21],
        [ 27,  27,  20]],

       [[ 95,  77,  37],
        [100,  85,  45],
        [113, 100,  58],
        ...,
        [ 64,  52,  45],
        [ 45,  42,  31],
        [ 30,  31,  18]]], dtype=uint8)]"
Image_807.jpg,315,197,223,223,900,720,538,420,223,daskShared_local/images/Image_807.jpg,807,"[array([[[ 82, 168, 225],
        [ 83, 169, 228],
        [ 83, 170, 230],
        ...,
        [ 90, 194, 247],
        [ 89, 193, 245],
        [ 89, 193, 244]],

       [[ 81, 174, 224],
        [ 82, 172, 226],
        [ 82, 172, 228],
        ...,
        [ 89, 193, 246],
        [ 90, 194, 245],
        [ 90, 194, 245]],

       [[ 85, 185, 231],
        [ 84, 181, 230],
        [ 83, 180, 230],
        ...,
        [ 88, 192, 245],
        [ 90, 193, 245],
        [ 90, 193, 245]],

       ...,

       [[ 68, 145, 201],
        [ 68, 145, 201],
        [ 70, 147, 203],
        ...,
        [ 77, 128,  87],
        [ 85, 112,  67],
        [118, 130,  92]],

       [[ 68, 145, 201],
        [ 68, 145, 201],
        [ 69, 146, 202],
        ...,
        [ 71, 107,  59],
        [113, 118,  83],
        [219, 213, 186]],

       [[ 67, 144, 200],
        [ 67, 144, 200],
        [ 68, 145, 201],
        ...,
        [ 75,  93,  42],
        [192, 180, 156],
        [222, 207, 190]]], dtype=uint8)]"
Image_808.jpg,629,460,219,179,1024,672,848,639,219,daskShared_local/images/Image_808.jpg,808,"[array([[[ 74,  72,  85],
        [ 77,  75,  88],
        [ 78,  75,  85],
        ...,
        [ 92, 110, 131],
        [ 94, 113, 132],
        [ 99, 116, 135]],

       [[ 73,  71,  85],
        [ 74,  71,  84],
        [ 75,  72,  83],
        ...,
        [114, 135, 172],
        [115, 134, 169],
        [118, 137, 172]],

       [[ 73,  71,  85],
        [ 71,  67,  81],
        [ 70,  66,  80],
        ...,
        [139, 161, 208],
        [136, 155, 202],
        [132, 152, 196]],

       ...,

       [[ 32,  88, 137],
        [ 32,  86, 135],
        [ 33,  87, 136],
        ...,
        [ 27, 122, 231],
        [ 25, 118, 227],
        [ 20, 113, 220]],

       [[ 34,  88, 135],
        [ 34,  86, 134],
        [ 34,  86, 134],
        ...,
        [ 28, 123, 232],
        [ 28, 122, 230],
        [ 27, 119, 228]],

       [[ 35,  87, 137],
        [ 34,  86, 134],
        [ 35,  85, 134],
        ...,
        [ 24, 119, 229],
        [ 27, 122, 230],
        [ 28, 123, 231]]], dtype=uint8)]"
Image_809.jpg,549,95,288,291,1024,770,837,386,291,daskShared_local/images/Image_809.jpg,809,"[array([[[  5, 113, 187],
        [  3, 112, 185],
        [  3, 111, 185],
        ...,
        [ 51,  68,  76],
        [ 43,  61,  70],
        [ 40,  59,  69]],

       [[  2, 112, 187],
        [  1, 111, 186],
        [  1, 110, 185],
        ...,
        [ 39,  56,  63],
        [ 45,  66,  72],
        [ 44,  69,  74]],

       [[  2, 112, 187],
        [  1, 111, 186],
        [  1, 111, 186],
        ...,
        [ 58,  75,  82],
        [ 45,  65,  71],
        [ 48,  71,  77]],

       ...,

       [[ 47,  51,  40],
        [ 81,  86,  78],
        [ 68,  74,  66],
        ...,
        [ 36,  35,  31],
        [ 40,  39,  35],
        [ 40,  39,  36]],

       [[ 42,  45,  31],
        [ 75,  79,  70],
        [ 73,  79,  72],
        ...,
        [ 35,  33,  30],
        [ 39,  35,  33],
        [ 40,  36,  33]],

       [[ 45,  48,  28],
        [ 65,  72,  58],
        [ 95, 102,  95],
        ...,
        [ 33,  33,  31],
        [ 35,  33,  31],
        [ 40,  36,  35]]], dtype=uint8)]"
Image_81.jpg,444,149,147,123,1024,512,591,272,147,daskShared_local/images/Image_81.jpg,81,"[array([[[  4, 130, 188],
        [  4, 130, 188],
        [  3, 130, 188],
        ...,
        [  1, 169, 213],
        [  1, 169, 213],
        [  1, 169, 213]],

       [[  3, 131, 188],
        [  3, 131, 188],
        [  2, 131, 188],
        ...,
        [  0, 168, 211],
        [  0, 168, 211],
        [  0, 168, 211]],

       [[  2, 131, 188],
        [  2, 131, 188],
        [  2, 131, 188],
        ...,
        [  0, 166, 210],
        [  1, 167, 211],
        [  1, 167, 211]],

       ...,

       [[ 93,  85,  56],
        [ 76,  70,  43],
        [ 66,  61,  37],
        ...,
        [  0, 142, 195],
        [  0, 142, 195],
        [  0, 142, 195]],

       [[102,  94,  65],
        [ 89,  81,  54],
        [ 76,  70,  44],
        ...,
        [  0, 142, 195],
        [  0, 142, 195],
        [  0, 142, 195]],

       [[119, 110,  81],
        [105,  97,  69],
        [ 85,  78,  52],
        ...,
        [  0, 142, 195],
        [  0, 142, 195],
        [  0, 141, 194]]], dtype=uint8)]"
Image_810.jpg,466,122,114,83,685,360,580,205,114,daskShared_local/images/Image_810.jpg,810,"[array([[[  0, 107, 151],
        [  0, 107, 151],
        [  0, 107, 151],
        ...,
        [  0, 101, 145],
        [  0, 101, 145],
        [  0, 101, 145]],

       [[  0, 107, 150],
        [  0, 107, 150],
        [  0, 107, 151],
        ...,
        [  0, 101, 145],
        [  0, 101, 145],
        [  0, 101, 145]],

       [[  0, 107, 149],
        [  0, 107, 149],
        [  1, 108, 150],
        ...,
        [  0, 101, 145],
        [  0, 101, 145],
        [  0, 101, 145]],

       ...,

       [[  1,  85, 121],
        [  1,  85, 121],
        [  1,  85, 121],
        ...,
        [  0,  82, 116],
        [  0,  82, 116],
        [  0,  82, 116]],

       [[  1,  85, 121],
        [  1,  85, 121],
        [  1,  85, 121],
        ...,
        [  0,  82, 116],
        [  0,  82, 116],
        [  0,  82, 116]],

       [[  1,  85, 121],
        [  1,  85, 121],
        [  1,  85, 121],
        ...,
        [  0,  82, 116],
        [  0,  82, 116],
        [  0,  82, 116]]], dtype=uint8)]"
Image_811.jpg,112,204,101,94,789,562,213,298,101,daskShared_local/images/Image_811.jpg,811,"[array([[[  0,  84, 156],
        [  0,  84, 156],
        [  0,  85, 156],
        ...,
        [  2,  99, 170],
        [  3, 100, 171],
        [  3, 100, 171]],

       [[  0,  84, 156],
        [  0,  84, 156],
        [  0,  85, 156],
        ...,
        [  2,  99, 170],
        [  3, 100, 171],
        [  3, 100, 171]],

       [[  0,  86, 157],
        [  0,  86, 157],
        [  0,  86, 157],
        ...,
        [  3, 100, 171],
        [  3, 100, 171],
        [  3, 100, 171]],

       ...,

       [[  1,  65, 111],
        [  1,  65, 111],
        [  1,  65, 111],
        ...,
        [  2,  61, 111],
        [  2,  60, 110],
        [  2,  60, 110]],

       [[  2,  64, 110],
        [  2,  64, 110],
        [  2,  64, 110],
        ...,
        [  1,  61, 111],
        [  1,  60, 110],
        [  1,  60, 110]],

       [[  2,  63, 110],
        [  2,  63, 110],
        [  2,  63, 110],
        ...,
        [  1,  61, 111],
        [  1,  60, 110],
        [  1,  60, 110]]], dtype=uint8)]"
Image_812.jpg,1775,643,326,278,2560,1440,2101,921,326,daskShared_local/images/Image_812.jpg,812,"[array([[[ 83,  79,  73],
        [151, 142, 126],
        [219, 219, 207],
        ...,
        [  0, 121, 168],
        [  0, 121, 168],
        [  0, 121, 168]],

       [[ 71,  74,  77],
        [102,  94,  86],
        [194, 193, 187],
        ...,
        [  0, 121, 168],
        [  0, 121, 168],
        [  0, 121, 168]],

       [[ 82,  90,  99],
        [ 97,  93,  91],
        [161, 161, 158],
        ...,
        [  0, 120, 167],
        [  0, 120, 167],
        [  0, 120, 167]],

       ...,

       [[  1, 123, 170],
        [  0, 122, 169],
        [  1, 123, 170],
        ...,
        [  0, 115, 163],
        [  0, 115, 163],
        [  0, 115, 163]],

       [[  0, 124, 170],
        [  1, 123, 170],
        [  1, 123, 170],
        ...,
        [  0, 114, 164],
        [  0, 114, 164],
        [  0, 114, 164]],

       [[  1, 124, 172],
        [  2, 124, 172],
        [  2, 124, 172],
        ...,
        [  0, 115, 163],
        [  0, 115, 163],
        [  0, 115, 163]]], dtype=uint8)]"
Image_813.jpg,119,359,251,222,1200,800,370,581,251,daskShared_local/images/Image_813.jpg,813,"[array([[[  2,  97, 101],
        [  3, 101, 104],
        [  4, 103, 106],
        ...,
        [ 24,  94, 110],
        [ 33,  98, 121],
        [ 22,  90, 116]],

       [[  0,  95,  99],
        [  4,  99, 103],
        [  4, 101, 104],
        ...,
        [  7,  96, 114],
        [ 18, 104, 124],
        [ 17, 103, 123]],

       [[  1,  92,  97],
        [  1,  94,  99],
        [  1,  96,  99],
        ...,
        [ 10, 110, 129],
        [  4, 105, 119],
        [ 12, 110, 124]],

       ...,

       [[177, 210, 111],
        [160, 184,  93],
        [148, 167,  91],
        ...,
        [  2,  61,  59],
        [  6,  62,  61],
        [  5,  61,  60]],

       [[164, 197, 104],
        [155, 181,  95],
        [152, 174, 101],
        ...,
        [  5,  62,  61],
        [  6,  62,  61],
        [  4,  62,  60]],

       [[155, 189, 107],
        [159, 190, 113],
        [173, 202, 132],
        ...,
        [  2,  56,  56],
        [  2,  59,  58],
        [  1,  61,  59]]], dtype=uint8)]"
Image_814.jpg,483,124,143,123,800,600,626,247,143,daskShared_local/images/Image_814.jpg,814,"[array([[[  6, 157, 174],
        [  4, 154, 171],
        [  2, 152, 169],
        ...,
        [ 52, 167, 173],
        [ 56, 173, 180],
        [ 56, 173, 180]],

       [[  3, 154, 171],
        [  2, 152, 169],
        [  1, 150, 167],
        ...,
        [ 48, 163, 170],
        [ 51, 167, 174],
        [ 52, 167, 174]],

       [[  1, 151, 168],
        [  0, 150, 167],
        [  0, 149, 166],
        ...,
        [ 42, 157, 165],
        [ 44, 158, 166],
        [ 45, 160, 168]],

       ...,

       [[ 34,  27,  15],
        [ 49,  43,  25],
        [ 74,  68,  46],
        ...,
        [  0, 140, 160],
        [  0, 140, 160],
        [  0, 140, 160]],

       [[ 27,  20,   3],
        [ 28,  21,   5],
        [ 38,  32,  16],
        ...,
        [  0, 138, 159],
        [  0, 138, 159],
        [  0, 138, 159]],

       [[ 36,  29,   5],
        [ 27,  20,   3],
        [ 20,  13,   4],
        ...,
        [  0, 138, 159],
        [  0, 137, 158],
        [  0, 137, 158]]], dtype=uint8)]"
Image_815.jpg,422,143,728,620,1152,763,1150,763,728,daskShared_local/images/Image_815.jpg,815,"[array([[[  1, 180, 236],
        [  0, 179, 235],
        [  1, 180, 236],
        ...,
        [  0, 183, 237],
        [  0, 183, 237],
        [  0, 183, 237]],

       [[  0, 179, 235],
        [  0, 179, 235],
        [  0, 179, 235],
        ...,
        [  0, 183, 237],
        [  0, 184, 238],
        [  0, 184, 238]],

       [[  0, 179, 235],
        [  0, 179, 235],
        [  0, 179, 235],
        ...,
        [  0, 183, 237],
        [  0, 183, 237],
        [  0, 183, 237]],

       ...,

       [[149, 174, 142],
        [146, 171, 138],
        [143, 170, 134],
        ...,
        [187, 200, 180],
        [171, 193, 183],
        [153, 181, 152]],

       [[154, 179, 149],
        [151, 176, 146],
        [148, 173, 142],
        ...,
        [167, 190, 184],
        [153, 182, 169],
        [140, 176, 149]],

       [[156, 181, 152],
        [156, 181, 152],
        [154, 178, 149],
        ...,
        [140, 174, 165],
        [130, 165, 154],
        [128, 159, 129]]], dtype=uint8)]"
Image_816.jpg,575,52,180,163,930,500,755,215,180,daskShared_local/images/Image_816.jpg,816,"[array([[[ 10, 145, 209],
        [  9, 147, 210],
        [ 12, 150, 213],
        ...,
        [ 11, 147, 209],
        [ 13, 149, 211],
        [ 14, 150, 212]],

       [[ 12, 147, 211],
        [  9, 146, 209],
        [ 11, 149, 212],
        ...,
        [  9, 145, 207],
        [ 11, 147, 209],
        [ 11, 147, 209]],

       [[ 12, 147, 211],
        [  7, 145, 208],
        [  9, 147, 210],
        ...,
        [ 10, 146, 208],
        [ 11, 147, 209],
        [ 10, 146, 208]],

       ...,

       [[233, 233, 233],
        [244, 244, 243],
        [239, 239, 237],
        ...,
        [  6, 134, 199],
        [  8, 133, 199],
        [  8, 133, 197]],

       [[235, 235, 235],
        [238, 238, 237],
        [225, 225, 223],
        ...,
        [  6, 134, 199],
        [  8, 133, 199],
        [  8, 133, 197]],

       [[236, 236, 236],
        [233, 233, 231],
        [216, 216, 214],
        ...,
        [  6, 134, 199],
        [  8, 133, 199],
        [  8, 133, 197]]], dtype=uint8)]"
Image_817.jpg,407,327,135,125,800,600,542,452,135,daskShared_local/images/Image_817.jpg,817,"[array([[[194, 164, 140],
        [194, 164, 133],
        [196, 167, 128],
        ...,
        [  6,  93, 103],
        [  6,  93, 104],
        [  6,  94, 105]],

       [[197, 172, 146],
        [201, 175, 143],
        [209, 184, 143],
        ...,
        [  6,  93, 103],
        [  6,  93, 103],
        [  6,  93, 104]],

       [[206, 188, 160],
        [214, 194, 160],
        [228, 205, 164],
        ...,
        [  6,  92, 102],
        [  6,  92, 102],
        [  5,  92, 102]],

       ...,

       [[ 24,  47,  47],
        [ 25,  49,  47],
        [ 26,  51,  48],
        ...,
        [ 35, 126,  76],
        [ 40, 125,  75],
        [ 45, 126,  75]],

       [[ 27,  52,  51],
        [ 27,  52,  50],
        [ 28,  53,  49],
        ...,
        [ 36, 119,  77],
        [ 39, 119,  75],
        [ 41, 119,  73]],

       [[ 30,  55,  54],
        [ 29,  55,  52],
        [ 29,  54,  50],
        ...,
        [ 38, 113,  75],
        [ 39, 114,  74],
        [ 38, 112,  71]]], dtype=uint8)]"
Image_818.jpg,541,134,139,102,759,500,680,236,139,daskShared_local/images/Image_818.jpg,818,"[array([[[181, 195,  56],
        [180, 195,  56],
        [180, 194,  55],
        ...,
        [ 28, 127, 218],
        [ 28, 127, 218],
        [ 28, 127, 218]],

       [[180, 194,  55],
        [179, 194,  55],
        [178, 194,  55],
        ...,
        [ 28, 127, 218],
        [ 28, 127, 218],
        [ 28, 127, 218]],

       [[178, 193,  53],
        [177, 193,  53],
        [177, 194,  54],
        ...,
        [ 27, 127, 218],
        [ 27, 126, 217],
        [ 27, 126, 217]],

       ...,

       [[ 34, 114, 126],
        [ 33, 114, 125],
        [ 31, 113, 123],
        ...,
        [ 35, 165, 217],
        [ 34, 164, 217],
        [ 33, 164, 216]],

       [[ 30, 117, 133],
        [ 30, 117, 131],
        [ 30, 116, 128],
        ...,
        [ 35, 165, 217],
        [ 34, 165, 217],
        [ 33, 164, 216]],

       [[ 27, 120, 136],
        [ 28, 118, 133],
        [ 30, 117, 130],
        ...,
        [ 35, 165, 217],
        [ 34, 165, 217],
        [ 33, 164, 216]]], dtype=uint8)]"
Image_819.jpg,781,502,1243,1509,3072,2304,2024,2011,1509,daskShared_local/images/Image_819.jpg,819,"[array([[[106,  96,  95],
        [ 86,  77,  77],
        [ 85,  80,  83],
        ...,
        [ 99,  72,  89],
        [ 91,  69,  82],
        [ 95,  76,  87]],

       [[105,  95,  93],
        [ 89,  82,  79],
        [109, 106, 106],
        ...,
        [ 81,  53,  74],
        [ 79,  54,  70],
        [ 96,  72,  86]],

       [[107,  98,  99],
        [105,  98,  99],
        [128, 125, 122],
        ...,
        [ 76,  51,  69],
        [ 76,  51,  70],
        [ 85,  61,  79]],

       ...,

       [[  7, 112, 122],
        [  7, 114, 120],
        [  6, 113, 119],
        ...,
        [ 30, 110, 130],
        [ 38, 118, 138],
        [ 41, 124, 143]],

       [[  6, 111, 121],
        [  7, 112, 121],
        [  6, 112, 120],
        ...,
        [ 38, 118, 140],
        [ 41, 123, 145],
        [ 42, 128, 148]],

       [[  6, 111, 118],
        [  7, 111, 122],
        [  8, 111, 122],
        ...,
        [ 35, 119, 139],
        [ 39, 124, 144],
        [ 38, 125, 144]]], dtype=uint8)]"
Image_82.jpg,108,76,94,67,475,264,202,143,94,daskShared_local/images/Image_82.jpg,82,"[array([[[22, 43, 62],
        [22, 43, 62],
        [20, 41, 60],
        ...,
        [32, 59, 88],
        [29, 54, 82],
        [29, 55, 83]],

       [[22, 43, 62],
        [22, 43, 62],
        [20, 41, 60],
        ...,
        [32, 59, 87],
        [28, 54, 82],
        [29, 54, 82]],

       [[21, 43, 62],
        [21, 44, 62],
        [21, 42, 60],
        ...,
        [35, 63, 91],
        [30, 57, 84],
        [31, 58, 85]],

       ...,

       [[11, 21, 29],
        [11, 20, 29],
        [11, 21, 29],
        ...,
        [39, 56, 61],
        [40, 58, 62],
        [40, 58, 62]],

       [[11, 22, 29],
        [11, 22, 29],
        [11, 22, 29],
        ...,
        [38, 59, 66],
        [38, 60, 67],
        [38, 60, 67]],

       [[11, 22, 29],
        [11, 22, 29],
        [11, 22, 29],
        ...,
        [38, 59, 65],
        [38, 60, 66],
        [38, 60, 66]]], dtype=uint8)]"
Image_820.jpg,423,147,276,276,1200,822,699,423,276,daskShared_local/images/Image_820.jpg,820,"[array([[[  2, 147, 174],
        [  2, 147, 174],
        [  1, 146, 173],
        ...,
        [  0, 164, 192],
        [  1, 165, 193],
        [  1, 165, 193]],

       [[  2, 147, 174],
        [  1, 146, 173],
        [  0, 145, 172],
        ...,
        [  1, 165, 193],
        [  1, 165, 193],
        [  1, 165, 193]],

       [[  1, 149, 175],
        [  0, 147, 173],
        [  0, 147, 173],
        ...,
        [  2, 166, 194],
        [  0, 164, 192],
        [  0, 164, 192]],

       ...,

       [[ 91,  97,  55],
        [ 89,  98,  48],
        [ 88,  95,  41],
        ...,
        [182, 157, 116],
        [241, 212, 175],
        [237, 210, 179]],

       [[ 77,  76,  38],
        [ 97, 104,  57],
        [109, 119,  63],
        ...,
        [123,  89,  41],
        [180, 145, 100],
        [236, 207, 171]],

       [[ 58,  52,  17],
        [ 74,  78,  36],
        [100, 113,  60],
        ...,
        [104,  69,  23],
        [127,  90,  44],
        [186, 153, 114]]], dtype=uint8)]"
Image_821.jpg,559,182,103,81,1000,700,662,263,103,daskShared_local/images/Image_821.jpg,821,"[array([[[  1, 158, 229],
        [  1, 158, 229],
        [  1, 159, 230],
        ...,
        [  0, 156, 230],
        [  0, 157, 230],
        [  0, 157, 230]],

       [[  1, 158, 229],
        [  1, 158, 229],
        [  1, 159, 230],
        ...,
        [  0, 156, 230],
        [  0, 157, 230],
        [  0, 157, 230]],

       [[  1, 159, 230],
        [  1, 159, 230],
        [  1, 159, 230],
        ...,
        [  0, 157, 230],
        [  0, 158, 231],
        [  0, 158, 231]],

       ...,

       [[ 70, 122, 142],
        [ 71, 122, 142],
        [ 85, 133, 148],
        ...,
        [  0, 151, 224],
        [  0, 152, 225],
        [  0, 152, 225]],

       [[ 36,  96, 118],
        [ 38,  97, 119],
        [ 60, 113, 131],
        ...,
        [  0, 151, 224],
        [  1, 152, 225],
        [  1, 152, 225]],

       [[ 34,  94, 117],
        [ 35,  95, 118],
        [ 58, 112, 130],
        ...,
        [  0, 151, 224],
        [  1, 152, 225],
        [  1, 152, 225]]], dtype=uint8)]"
Image_822.jpg,292,87,174,168,732,420,466,255,174,daskShared_local/images/Image_822.jpg,822,"[array([[[  1, 162, 214],
        [  1, 162, 214],
        [  1, 162, 214],
        ...,
        [ 77, 198, 236],
        [ 52, 196, 233],
        [ 42, 189, 225]],

       [[  1, 162, 214],
        [  1, 162, 214],
        [  1, 162, 214],
        ...,
        [ 61, 196, 229],
        [ 64, 200, 235],
        [ 61, 196, 233]],

       [[  1, 162, 214],
        [  1, 162, 214],
        [  1, 162, 214],
        ...,
        [ 47, 194, 224],
        [ 60, 198, 229],
        [ 64, 195, 230]],

       ...,

       [[205, 207, 200],
        [202, 208, 198],
        [200, 202, 191],
        ...,
        [  7,   1,   6],
        [  9,   1,  10],
        [  2,   1,   8]],

       [[181, 184, 153],
        [197, 199, 177],
        [210, 210, 197],
        ...,
        [  2,   2,   3],
        [  3,   2,   9],
        [  1,   4,   2]],

       [[166, 170, 121],
        [179, 182, 141],
        [193, 194, 162],
        ...,
        [  6,   0,   0],
        [  3,   1,   1],
        [  4,   6,   0]]], dtype=uint8)]"
Image_823.jpg,972,388,198,191,2000,1000,1170,579,198,daskShared_local/images/Image_823.jpg,823,"[array([[[203, 183, 148],
        [202, 182, 147],
        [205, 185, 150],
        ...,
        [209, 186, 154],
        [204, 184, 149],
        [204, 182, 145]],

       [[207, 187, 152],
        [209, 189, 154],
        [211, 191, 156],
        ...,
        [206, 186, 153],
        [209, 191, 155],
        [205, 185, 150]],

       [[208, 188, 151],
        [211, 191, 156],
        [212, 192, 157],
        ...,
        [200, 181, 148],
        [210, 191, 158],
        [204, 186, 150]],

       ...,

       [[153, 150, 135],
        [146, 143, 128],
        [137, 134, 117],
        ...,
        [200, 174, 137],
        [165, 154, 109],
        [186, 171, 128]],

       [[193, 191, 176],
        [205, 202, 187],
        [183, 180, 163],
        ...,
        [209, 185, 149],
        [197, 183, 138],
        [187, 168, 126]],

       [[164, 162, 149],
        [189, 186, 171],
        [187, 184, 169],
        ...,
        [197, 174, 140],
        [204, 178, 141],
        [183, 157, 120]]], dtype=uint8)]"
Image_824.jpg,384,80,117,83,580,435,501,163,117,daskShared_local/images/Image_824.jpg,824,"[array([[[ 80, 129, 128],
        [ 80, 129, 128],
        [ 80, 129, 128],
        ...,
        [ 83, 140, 141],
        [ 82, 141, 142],
        [ 82, 141, 142]],

       [[ 79, 127, 127],
        [ 79, 127, 127],
        [ 79, 128, 127],
        ...,
        [ 83, 140, 142],
        [ 84, 142, 143],
        [ 84, 142, 143]],

       [[ 77, 123, 123],
        [ 77, 123, 123],
        [ 76, 122, 122],
        ...,
        [ 85, 140, 143],
        [ 88, 145, 147],
        [ 89, 146, 148]],

       ...,

       [[135, 171, 161],
        [138, 174, 164],
        [146, 182, 172],
        ...,
        [ 99, 128, 110],
        [100, 130, 112],
        [100, 130, 112]],

       [[146, 180, 169],
        [143, 177, 167],
        [134, 169, 158],
        ...,
        [105, 132, 112],
        [105, 133, 114],
        [105, 133, 114]],

       [[149, 182, 172],
        [145, 178, 167],
        [131, 164, 154],
        ...,
        [107, 133, 112],
        [107, 134, 114],
        [106, 134, 115]]], dtype=uint8)]"
Image_825.jpg,309,306,152,130,966,642,461,436,152,daskShared_local/images/Image_825.jpg,825,"[array([[[  4, 137, 126],
        [  4, 137, 124],
        [  5, 137, 122],
        ...,
        [ 25,   4,   6],
        [ 25,   4,   7],
        [ 21,   1,   4]],

       [[ 16, 174, 175],
        [ 18, 175, 175],
        [ 22, 177, 177],
        ...,
        [ 32,   4,   5],
        [ 34,   6,   8],
        [ 32,   5,   6]],

       [[ 26, 199, 211],
        [ 30, 201, 213],
        [ 36, 204, 217],
        ...,
        [ 39,   3,   4],
        [ 43,   6,   5],
        [ 45,   8,   5]],

       ...,

       [[ 17, 195, 204],
        [ 18, 196, 204],
        [ 18, 197, 204],
        ...,
        [ 67, 232, 244],
        [ 67, 234, 247],
        [ 66, 235, 248]],

       [[ 18, 194, 204],
        [ 19, 196, 205],
        [ 19, 198, 205],
        ...,
        [ 73, 234, 249],
        [ 74, 237, 252],
        [ 73, 237, 253]],

       [[ 20, 194, 205],
        [ 20, 197, 205],
        [ 21, 198, 206],
        ...,
        [ 74, 236, 251],
        [ 76, 238, 254],
        [ 75, 238, 255]]], dtype=uint8)]"
Image_826.jpg,85,16,96,74,531,336,181,90,96,daskShared_local/images/Image_826.jpg,826,"[array([[[  8, 121, 125],
        [  8, 121, 125],
        [  7, 120, 124],
        ...,
        [  9, 135, 134],
        [  9, 135, 134],
        [  9, 135, 134]],

       [[  8, 121, 125],
        [  8, 121, 125],
        [  7, 120, 124],
        ...,
        [ 10, 136, 135],
        [ 10, 136, 135],
        [ 10, 136, 135]],

       [[  8, 121, 125],
        [  8, 121, 125],
        [  7, 120, 124],
        ...,
        [  9, 135, 134],
        [  9, 135, 134],
        [  9, 135, 134]],

       ...,

       [[  5, 123, 123],
        [  5, 123, 123],
        [  6, 124, 124],
        ...,
        [143, 108,  46],
        [153, 119,  57],
        [152, 118,  56]],

       [[  5, 123, 123],
        [  5, 123, 123],
        [  6, 124, 124],
        ...,
        [149, 114,  51],
        [150, 115,  53],
        [149, 115,  52]],

       [[  5, 123, 123],
        [  5, 123, 123],
        [  6, 124, 124],
        ...,
        [148, 114,  50],
        [150, 116,  53],
        [150, 115,  53]]], dtype=uint8)]"
Image_827.jpg,129,87,162,128,500,333,291,215,162,daskShared_local/images/Image_827.jpg,827,"[array([[[ 29,  44,  63],
        [ 29,  44,  63],
        [ 28,  43,  62],
        ...,
        [ 26,  44,  66],
        [ 25,  43,  65],
        [ 24,  42,  64]],

       [[ 29,  44,  63],
        [ 29,  44,  63],
        [ 28,  43,  62],
        ...,
        [ 26,  44,  66],
        [ 24,  42,  64],
        [ 23,  41,  63]],

       [[ 28,  43,  62],
        [ 28,  43,  62],
        [ 28,  43,  62],
        ...,
        [ 26,  44,  66],
        [ 25,  43,  65],
        [ 25,  43,  65]],

       ...,

       [[ 25,  43,  57],
        [ 25,  43,  57],
        [ 25,  43,  57],
        ...,
        [117, 134, 124],
        [117, 134, 124],
        [117, 134, 124]],

       [[ 25,  43,  57],
        [ 25,  43,  57],
        [ 26,  44,  58],
        ...,
        [120, 137, 127],
        [119, 136, 126],
        [119, 136, 126]],

       [[ 25,  43,  57],
        [ 25,  43,  57],
        [ 26,  44,  58],
        ...,
        [120, 137, 127],
        [119, 136, 126],
        [118, 135, 125]]], dtype=uint8)]"
Image_828.jpg,697,299,525,505,1920,1080,1222,804,525,daskShared_local/images/Image_828.jpg,828,"[array([[[ 47,  65,  54],
        [ 44,  63,  52],
        [ 49,  67,  57],
        ...,
        [ 28,  47,  49],
        [ 19,  41,  42],
        [ 12,  36,  37]],

       [[ 45,  62,  51],
        [ 49,  66,  55],
        [ 46,  64,  53],
        ...,
        [ 34,  65,  64],
        [ 20,  48,  49],
        [ 14,  42,  44]],

       [[ 43,  59,  49],
        [ 47,  65,  52],
        [ 44,  65,  53],
        ...,
        [ 51,  94,  90],
        [ 32,  75,  72],
        [ 27,  66,  65]],

       ...,

       [[ 28,  94, 144],
        [ 28,  94, 146],
        [ 30,  96, 148],
        ...,
        [ 23,  45,  40],
        [ 25,  43,  43],
        [ 29,  45,  44]],

       [[ 29,  95, 145],
        [ 28,  94, 146],
        [ 30,  96, 148],
        ...,
        [ 22,  44,  39],
        [ 27,  45,  44],
        [ 28,  44,  43]],

       [[ 30,  96, 145],
        [ 28,  94, 145],
        [ 29,  96, 148],
        ...,
        [ 23,  44,  39],
        [ 26,  45,  42],
        [ 27,  46,  44]]], dtype=uint8)]"
Image_829.jpg,393,112,171,171,800,600,564,283,171,daskShared_local/images/Image_829.jpg,829,"[array([[[217, 251, 238],
        [203, 239, 230],
        [188, 226, 220],
        ...,
        [124, 230, 187],
        [115, 224, 182],
        [112, 222, 177]],

       [[216, 253, 242],
        [209, 249, 241],
        [204, 243, 240],
        ...,
        [127, 232, 186],
        [115, 223, 177],
        [104, 213, 165]],

       [[197, 239, 231],
        [195, 238, 233],
        [190, 233, 231],
        ...,
        [104, 207, 157],
        [ 98, 204, 154],
        [ 86, 192, 143]],

       ...,

       [[220, 125,  26],
        [224, 129,  30],
        [228, 133,  33],
        ...,
        [119, 167, 115],
        [116, 163, 117],
        [121, 162, 121]],

       [[219, 126,  27],
        [220, 128,  29],
        [222, 131,  32],
        ...,
        [118, 160, 113],
        [107, 146, 105],
        [ 99, 133,  99]],

       [[220, 131,  31],
        [222, 133,  33],
        [224, 135,  35],
        ...,
        [123, 158, 116],
        [109, 141, 105],
        [ 88, 114,  86]]], dtype=uint8)]"
Image_83.jpg,567,172,192,183,1000,665,759,355,192,daskShared_local/images/Image_83.jpg,83,"[array([[[ 45, 134, 200],
        [ 42, 134, 199],
        [ 33, 134, 198],
        ...,
        [ 25, 129, 195],
        [ 32, 131, 196],
        [ 24, 132, 197]],

       [[ 51, 136, 201],
        [ 42, 134, 201],
        [ 35, 133, 200],
        ...,
        [ 29, 129, 197],
        [ 25, 130, 196],
        [ 29, 131, 197]],

       [[ 49, 136, 205],
        [ 41, 133, 200],
        [ 34, 132, 199],
        ...,
        [ 20, 128, 195],
        [ 28, 129, 197],
        [ 31, 130, 197]],

       ...,

       [[  2,  87, 107],
        [ 11,  97, 117],
        [ 17, 103, 123],
        ...,
        [  5, 116, 175],
        [ 67, 137, 179],
        [139, 165, 197]],

       [[ 14,  97, 115],
        [  8,  98, 117],
        [  3,  95, 117],
        ...,
        [  1, 119, 178],
        [  4, 114, 174],
        [ 73, 138, 181]],

       [[  1,  81,  98],
        [ 10,  95, 115],
        [  8, 100, 121],
        ...,
        [  1, 117, 178],
        [  3, 117, 179],
        [  1, 112, 175]]], dtype=uint8)]"
Image_830.jpg,177,349,243,177,1200,900,420,526,243,daskShared_local/images/Image_830.jpg,830,"[array([[[120, 186, 156],
        [117, 196, 163],
        [137, 196, 176],
        ...,
        [ 18, 146, 142],
        [ 16, 141, 138],
        [ 21, 139, 139]],

       [[127, 193, 165],
        [138, 182, 160],
        [144, 173, 167],
        ...,
        [ 45, 172, 167],
        [ 29, 153, 150],
        [ 23, 139, 139]],

       [[151, 215, 186],
        [149, 198, 170],
        [128, 183, 167],
        ...,
        [ 34, 162, 156],
        [ 35, 157, 154],
        [ 31, 146, 146]],

       ...,

       [[ 61,  87,  94],
        [ 86, 113, 103],
        [111, 128, 110],
        ...,
        [ 11,  13,  20],
        [  6,   8,  15],
        [  5,   9,  14]],

       [[117, 141, 132],
        [134, 159, 132],
        [143, 156, 121],
        ...,
        [ 10,  11,  19],
        [ 10,  12,  20],
        [ 10,  13,  20]],

       [[153, 173, 153],
        [160, 181, 151],
        [161, 170, 136],
        ...,
        [ 11,  11,  14],
        [ 16,  16,  19],
        [ 16,  18,  22]]], dtype=uint8)]"
Image_831.jpg,63,144,123,103,525,340,186,247,123,daskShared_local/images/Image_831.jpg,831,"[array([[[ 33,  85, 107],
        [ 31,  83, 105],
        [ 28,  80, 102],
        ...,
        [181, 203, 165],
        [103, 122,  82],
        [ 69,  87,  46]],

       [[ 32,  84, 106],
        [ 31,  83, 105],
        [ 28,  80, 102],
        ...,
        [186, 208, 170],
        [114, 133,  92],
        [ 82, 100,  58]],

       [[ 29,  81, 103],
        [ 29,  81, 103],
        [ 29,  81, 103],
        ...,
        [199, 220, 182],
        [141, 161, 118],
        [115, 134,  91]],

       ...,

       [[ 14,  47,  43],
        [ 27,  58,  51],
        [ 65,  90,  75],
        ...,
        [  6,  14,   6],
        [  5,  18,   6],
        [  7,  22,   8]],

       [[ 30,  52,  49],
        [ 29,  52,  47],
        [ 30,  55,  44],
        ...,
        [  2,  10,   2],
        [ 16,  29,  17],
        [ 23,  38,  24]],

       [[ 36,  53,  51],
        [ 29,  49,  44],
        [ 14,  40,  30],
        ...,
        [  1,   9,   1],
        [ 22,  35,  23],
        [ 31,  47,  32]]], dtype=uint8)]"
Image_832.jpg,351,92,314,296,1024,670,665,388,314,daskShared_local/images/Image_832.jpg,832,"[array([[[ 19, 109, 132],
        [ 11,  94, 121],
        [  9,  89, 120],
        ...,
        [  7,  19,  33],
        [  6,  18,  32],
        [  8,  20,  32]],

       [[ 13,  99, 131],
        [  9,  88, 123],
        [  8,  85, 122],
        ...,
        [  6,  18,  32],
        [  8,  20,  34],
        [  6,  18,  30]],

       [[  6,  85, 125],
        [  7,  82, 122],
        [  6,  80, 122],
        ...,
        [  9,  21,  35],
        [  8,  20,  34],
        [ 14,  26,  38]],

       ...,

       [[ 50, 106,  68],
        [ 42,  85,  43],
        [ 49, 110,  46],
        ...,
        [  7,  30,  32],
        [ 10,  35,  36],
        [  9,  35,  36]],

       [[ 87, 150, 109],
        [ 37,  95,  50],
        [ 55, 120,  63],
        ...,
        [  4,  24,  28],
        [  9,  30,  33],
        [  9,  30,  33]],

       [[ 86, 149, 104],
        [ 22,  84,  42],
        [ 26,  81,  40],
        ...,
        [  6,  23,  26],
        [  5,  24,  26],
        [  8,  27,  29]]], dtype=uint8)]"
Image_833.jpg,405,299,231,239,1500,1000,636,538,239,daskShared_local/images/Image_833.jpg,833,"[array([[[  0, 137, 158],
        [  0, 136, 157],
        [  0, 135, 156],
        ...,
        [  5, 117, 137],
        [  6, 118, 137],
        [  6, 118, 137]],

       [[  1, 143, 163],
        [  1, 143, 163],
        [  1, 143, 162],
        ...,
        [  0, 113, 132],
        [  1, 116, 134],
        [  1, 116, 134]],

       [[  4, 150, 169],
        [  6, 152, 170],
        [  5, 151, 170],
        ...,
        [  0, 113, 131],
        [  0, 113, 130],
        [  0, 112, 129]],

       ...,

       [[ 66, 105,  85],
        [ 82, 122, 103],
        [ 99, 140, 122],
        ...,
        [180, 176, 121],
        [150, 147,  92],
        [131, 128,  74]],

       [[ 80, 117,  99],
        [ 84, 123, 105],
        [ 87, 128, 111],
        ...,
        [151, 147,  91],
        [138, 135,  79],
        [130, 128,  71]],

       [[ 89, 124, 107],
        [ 90, 128, 110],
        [ 91, 131, 114],
        ...,
        [107, 102,  46],
        [102,  97,  41],
        [ 96,  91,  35]]], dtype=uint8)]"
Image_834.jpg,674,279,296,334,1600,900,970,613,334,daskShared_local/images/Image_834.jpg,834,"[array([[[  1, 117, 200],
        [  1, 117, 202],
        [  1, 117, 202],
        ...,
        [  0, 121, 202],
        [  0, 121, 202],
        [  0, 121, 202]],

       [[  0, 116, 200],
        [  0, 116, 201],
        [  0, 116, 201],
        ...,
        [  0, 121, 204],
        [  0, 121, 204],
        [  0, 121, 204]],

       [[  0, 116, 200],
        [  0, 116, 201],
        [  0, 116, 201],
        ...,
        [  0, 121, 204],
        [  0, 121, 204],
        [  0, 121, 204]],

       ...,

       [[203, 197, 169],
        [211, 207, 168],
        [181, 177, 137],
        ...,
        [127, 130,  99],
        [108, 112,  84],
        [106, 113,  92]],

       [[169, 164, 134],
        [167, 162, 130],
        [160, 157, 124],
        ...,
        [144, 146, 114],
        [104, 108,  75],
        [ 90,  96,  67]],

       [[193, 190, 156],
        [207, 205, 174],
        [208, 206, 177],
        ...,
        [163, 164, 131],
        [ 98, 102,  64],
        [ 92,  98,  60]]], dtype=uint8)]"
Image_835.jpg,122,174,151,130,900,695,273,304,151,daskShared_local/images/Image_835.jpg,835,"[array([[[  7, 135, 160],
        [  7, 135, 160],
        [  7, 135, 160],
        ...,
        [  8, 140, 165],
        [  7, 141, 166],
        [  6, 142, 168]],

       [[  7, 135, 160],
        [  7, 135, 160],
        [  7, 135, 160],
        ...,
        [  8, 140, 165],
        [  8, 140, 166],
        [  7, 141, 168]],

       [[  7, 135, 160],
        [  7, 135, 160],
        [  7, 135, 160],
        ...,
        [  8, 140, 165],
        [  8, 140, 166],
        [  7, 141, 167]],

       ...,

       [[  7, 132, 160],
        [  7, 132, 160],
        [  7, 132, 160],
        ...,
        [ 11, 149, 175],
        [ 11, 149, 175],
        [ 12, 150, 176]],

       [[  7, 132, 160],
        [  7, 132, 160],
        [  7, 132, 160],
        ...,
        [ 11, 149, 176],
        [ 11, 149, 176],
        [ 12, 150, 177]],

       [[  7, 132, 160],
        [  7, 132, 160],
        [  7, 132, 160],
        ...,
        [ 11, 149, 177],
        [ 11, 149, 177],
        [ 12, 150, 178]]], dtype=uint8)]"
Image_836.jpg,389,25,1082,985,1920,1080,1471,1010,1082,daskShared_local/images/Image_836.jpg,836,"[array([[[  1, 126, 157],
        [  0, 124, 156],
        [  0, 123, 154],
        ...,
        [ 54, 105, 105],
        [ 41,  93,  97],
        [ 28,  60,  70]],

       [[  0, 126, 156],
        [  0, 125, 156],
        [  0, 124, 156],
        ...,
        [ 53, 114, 110],
        [ 47, 108, 105],
        [ 38,  81,  82]],

       [[  0, 127, 157],
        [  0, 126, 158],
        [  0, 125, 157],
        ...,
        [ 58, 121, 116],
        [ 52, 116, 111],
        [ 46, 101,  91]],

       ...,

       [[ 77,  78,  41],
        [ 75,  73,  37],
        [ 84,  76,  38],
        ...,
        [ 11,  28,  29],
        [ 11,  28,  28],
        [ 13,  28,  28]],

       [[ 73,  70,  32],
        [ 83,  77,  40],
        [ 97,  87,  48],
        ...,
        [ 11,  27,  27],
        [ 12,  27,  27],
        [ 13,  27,  28]],

       [[ 90,  82,  40],
        [ 99,  89,  51],
        [107,  95,  58],
        ...,
        [ 12,  27,  27],
        [ 13,  26,  27],
        [ 13,  26,  27]]], dtype=uint8)]"
Image_837.jpg,136,32,135,147,425,282,271,179,147,daskShared_local/images/Image_837.jpg,837,"[array([[[  0,  91, 138],
        [  0,  91, 138],
        [  0,  90, 138],
        ...,
        [  0, 146, 191],
        [  0, 150, 194],
        [  0, 152, 196]],

       [[  0,  88, 136],
        [  0,  88, 136],
        [  0,  88, 136],
        ...,
        [  0, 145, 192],
        [  0, 148, 192],
        [  0, 150, 194]],

       [[  0,  84, 134],
        [  0,  85, 134],
        [  0,  86, 134],
        ...,
        [  0, 145, 194],
        [  0, 145, 191],
        [  0, 146, 191]],

       ...,

       [[ 15,   4,   4],
        [ 17,   7,   5],
        [ 19,  11,   8],
        ...,
        [  5,  54,  57],
        [ 12,  60,  61],
        [ 19,  63,  65]],

       [[ 13,   3,   2],
        [ 15,   6,   3],
        [ 18,  10,   7],
        ...,
        [ 52,  80,  71],
        [ 70,  96,  85],
        [ 80, 105,  93]],

       [[ 15,   5,   3],
        [ 16,   8,   3],
        [ 18,  11,   6],
        ...,
        [107, 114,  89],
        [136, 140, 112],
        [150, 154, 127]]], dtype=uint8)]"
Image_838.png,58,8,86,75,400,267,144,83,86,daskShared_local/images/Image_838.png,838,"[array([[[255, 255, 255],
        [255, 255, 255],
        [255, 255, 255],
        ...,
        [255, 255, 255],
        [255, 255, 255],
        [255, 255, 255]],

       [[255, 255, 255],
        [255, 255, 255],
        [255, 255, 255],
        ...,
        [255, 255, 255],
        [255, 255, 255],
        [255, 255, 255]],

       [[255, 255, 255],
        [255, 255, 255],
        [255, 255, 255],
        ...,
        [255, 255, 255],
        [255, 255, 255],
        [255, 255, 255]],

       ...,

       [[255, 255, 255],
        [255, 255, 255],
        [255, 255, 255],
        ...,
        [210, 215, 167],
        [201, 204, 152],
        [204, 207, 156]],

       [[255, 255, 255],
        [255, 255, 255],
        [255, 255, 255],
        ...,
        [204, 210, 164],
        [201, 204, 158],
        [202, 206, 160]],

       [[255, 255, 255],
        [255, 255, 255],
        [255, 255, 255],
        ...,
        [206, 212, 165],
        [201, 204, 156],
        [203, 206, 159]]], dtype=uint8)]"
Image_839.jpg,335,33,123,82,623,200,458,115,123,daskShared_local/images/Image_839.jpg,839,"[array([[[  0, 162, 252],
        [  0, 161, 252],
        [  0, 159, 253],
        ...,
        [  0, 128, 255],
        [  0, 128, 255],
        [  0, 128, 255]],

       [[  0, 162, 252],
        [  0, 161, 252],
        [  0, 159, 253],
        ...,
        [  0, 128, 255],
        [  0, 128, 255],
        [  0, 128, 255]],

       [[  0, 162, 252],
        [  0, 161, 252],
        [  0, 159, 253],
        ...,
        [  0, 128, 255],
        [  0, 128, 255],
        [  0, 128, 255]],

       ...,

       [[ 20,  36,  40],
        [ 17,  37,  40],
        [ 11,  40,  38],
        ...,
        [  8,  93, 223],
        [  4,  84, 208],
        [  2,  80, 202]],

       [[ 12,  28,  30],
        [ 10,  29,  30],
        [  5,  31,  30],
        ...,
        [  4,  87, 219],
        [  1,  77, 205],
        [  1,  74, 200]],

       [[  8,  24,  25],
        [  6,  25,  26],
        [  2,  27,  27],
        ...,
        [  2,  84, 218],
        [  1,  75, 204],
        [  0,  71, 199]]], dtype=uint8)]"
Image_84.jpg,756,536,1252,1475,3072,2304,2008,2011,1475,daskShared_local/images/Image_84.jpg,84,"[array([[[119, 121, 111],
        [122, 122, 115],
        [100, 102,  91],
        ...,
        [100,  73,  75],
        [105,  80,  85],
        [121,  93, 105]],

       [[116, 115, 103],
        [121, 119, 108],
        [ 96,  93,  81],
        ...,
        [ 73,  46,  52],
        [ 74,  51,  57],
        [ 85,  61,  72]],

       [[114, 112, 101],
        [115, 113, 101],
        [ 91,  87,  75],
        ...,
        [ 77,  47,  55],
        [ 63,  42,  47],
        [ 66,  43,  53]],

       ...,

       [[  8, 112, 123],
        [  7, 113, 121],
        [  6, 113, 120],
        ...,
        [ 16,  99, 116],
        [ 14,  99, 114],
        [  8,  97, 108]],

       [[  7, 111, 121],
        [  6, 112, 121],
        [  7, 111, 120],
        ...,
        [ 11,  98, 111],
        [ 12,  96, 108],
        [  7,  93, 108]],

       [[  7, 112, 118],
        [  6, 112, 120],
        [  8, 111, 122],
        ...,
        [  7,  94, 107],
        [ 10,  94, 108],
        [  8,  94, 110]]], dtype=uint8)]"
Image_840.jpg,517,371,176,167,1024,678,693,538,176,daskShared_local/images/Image_840.jpg,840,"[array([[[179, 160, 150],
        [185, 167, 152],
        [122, 103,  86],
        ...,
        [175, 125,  73],
        [210, 167, 125],
        [202, 169, 129]],

       [[155, 131, 123],
        [158, 126, 119],
        [ 87,  54,  48],
        ...,
        [210, 167,  96],
        [202, 163, 103],
        [177, 139,  91]],

       [[100,  74,  74],
        [128, 103,  98],
        [138, 118, 108],
        ...,
        [216, 178, 120],
        [166, 133,  76],
        [159, 126,  75]],

       ...,

       [[244, 230, 198],
        [243, 232, 199],
        [240, 229, 193],
        ...,
        [240, 214, 166],
        [236, 212, 164],
        [238, 212, 163]],

       [[244, 231, 189],
        [233, 220, 186],
        [235, 224, 195],
        ...,
        [242, 218, 167],
        [240, 213, 161],
        [241, 211, 158]],

       [[241, 224, 180],
        [237, 218, 176],
        [238, 226, 189],
        ...,
        [244, 217, 158],
        [243, 213, 152],
        [242, 210, 150]]], dtype=uint8)]"
Image_841.jpg,185,101,342,284,1024,670,527,385,342,daskShared_local/images/Image_841.jpg,841,"[array([[[ 26,  44,  50],
        [ 27,  43,  50],
        [ 21,  35,  44],
        ...,
        [ 58, 167, 204],
        [ 27, 141, 189],
        [ 70, 176, 232]],

       [[ 33,  52,  55],
        [ 25,  39,  44],
        [ 15,  25,  34],
        ...,
        [ 75, 211, 229],
        [ 55, 200, 231],
        [ 61, 185, 231]],

       [[ 28,  44,  51],
        [ 17,  28,  37],
        [ 16,  23,  34],
        ...,
        [ 48, 154, 142],
        [ 89, 188, 188],
        [ 63, 141, 153]],

       ...,

       [[ 53, 149, 131],
        [ 23,  99,  79],
        [  3,  47,  32],
        ...,
        [ 50, 136, 132],
        [ 41, 147, 138],
        [ 34, 135, 130]],

       [[ 62, 142, 141],
        [ 37, 113, 106],
        [  4,  68,  60],
        ...,
        [ 43, 143, 142],
        [ 44, 161, 157],
        [ 28, 140, 141]],

       [[ 71, 149, 164],
        [ 48, 128, 143],
        [ 42, 136, 141],
        ...,
        [ 29, 131, 137],
        [ 40, 154, 159],
        [ 37, 142, 151]]], dtype=uint8)]"
Image_842.jpg,165,7,106,98,498,272,271,105,106,daskShared_local/images/Image_842.jpg,842,"[array([[[  0,  25,  55],
        [  0,  25,  55],
        [  0,  25,  55],
        ...,
        [  2,  30,  52],
        [  2,  32,  53],
        [  2,  32,  53]],

       [[  1,  25,  55],
        [  1,  25,  55],
        [  1,  25,  55],
        ...,
        [  1,  30,  52],
        [  1,  32,  53],
        [  1,  32,  53]],

       [[  2,  27,  57],
        [  2,  27,  57],
        [  2,  27,  57],
        ...,
        [  0,  30,  51],
        [  0,  31,  52],
        [  0,  31,  52]],

       ...,

       [[165, 168, 114],
        [162, 165, 114],
        [142, 146, 110],
        ...,
        [164, 179, 176],
        [170, 184, 183],
        [170, 184, 184]],

       [[126, 130,  94],
        [124, 129,  94],
        [111, 116,  96],
        ...,
        [176, 191, 188],
        [181, 196, 195],
        [182, 196, 196]],

       [[121, 125,  92],
        [119, 124,  92],
        [107, 113,  94],
        ...,
        [178, 192, 190],
        [183, 197, 196],
        [184, 198, 197]]], dtype=uint8)]"
Image_843.jpg,354,18,608,537,1190,595,962,555,608,daskShared_local/images/Image_843.jpg,843,"[array([[[234, 246, 250],
        [229, 244, 248],
        [230, 243, 244],
        ...,
        [202, 216, 205],
        [201, 216, 205],
        [201, 215, 205]],

       [[227, 241, 241],
        [225, 240, 240],
        [223, 237, 237],
        ...,
        [203, 217, 206],
        [203, 216, 206],
        [203, 216, 206]],

       [[223, 239, 238],
        [221, 238, 240],
        [217, 233, 238],
        ...,
        [204, 217, 207],
        [203, 216, 206],
        [202, 216, 206]],

       ...,

       [[ 63,  24,  29],
        [ 50,  26,  25],
        [ 39,  22,  22],
        ...,
        [162, 128, 123],
        [155, 123, 120],
        [146, 112, 110]],

       [[ 87,  21,  37],
        [ 58,  22,  27],
        [ 42,  17,  20],
        ...,
        [155, 116, 109],
        [145, 106, 104],
        [135,  89,  89]],

       [[147,  48,  73],
        [ 80,  18,  33],
        [ 38,  14,  21],
        ...,
        [141, 101,  93],
        [131,  90,  88],
        [131,  85,  84]]], dtype=uint8)]"
Image_844.jpg,26,165,123,103,575,383,149,268,123,daskShared_local/images/Image_844.jpg,844,"[array([[[ 50,  86, 208],
        [ 50,  86, 208],
        [ 51,  87, 209],
        ...,
        [  3,  29,  62],
        [  0,  27,  61],
        [  0,  27,  62]],

       [[ 50,  86, 208],
        [ 50,  86, 208],
        [ 51,  87, 209],
        ...,
        [  3,  28,  60],
        [  0,  24,  58],
        [  0,  24,  59]],

       [[ 49,  85, 207],
        [ 50,  86, 208],
        [ 51,  87, 209],
        ...,
        [  3,  23,  54],
        [  0,  18,  52],
        [  0,  17,  52]],

       ...,

       [[ 20,  68, 176],
        [ 20,  68, 176],
        [ 21,  69, 177],
        ...,
        [ 33,  79, 191],
        [ 35,  81, 193],
        [ 35,  81, 193]],

       [[ 20,  68, 176],
        [ 20,  68, 176],
        [ 20,  68, 176],
        ...,
        [ 33,  79, 191],
        [ 35,  81, 193],
        [ 35,  81, 193]],

       [[ 20,  68, 176],
        [ 20,  68, 176],
        [ 19,  67, 175],
        ...,
        [ 34,  80, 192],
        [ 35,  81, 193],
        [ 35,  81, 193]]], dtype=uint8)]"
Image_845.jpg,196,120,421,315,800,533,617,435,421,daskShared_local/images/Image_845.jpg,845,"[array([[[  1,   2,  14],
        [  2,   4,  16],
        [  4,  11,  23],
        ...,
        [  3, 109, 190],
        [  7, 111, 192],
        [  6, 109, 189]],

       [[  4,   1,  17],
        [  4,   3,  19],
        [  1,   8,  19],
        ...,
        [  7, 112, 194],
        [  8, 112, 192],
        [  5, 109, 187]],

       [[  5,   1,  18],
        [  3,   2,  17],
        [  3,   8,  19],
        ...,
        [  6, 112, 194],
        [  8, 113, 193],
        [  7, 109, 188]],

       ...,

       [[ 22, 158, 155],
        [ 19, 164, 158],
        [ 22, 173, 173],
        ...,
        [ 48,  91, 105],
        [ 45,  84, 106],
        [ 25,  63,  92]],

       [[ 13, 151, 149],
        [ 12, 159, 155],
        [ 18, 173, 172],
        ...,
        [ 43,  89, 100],
        [ 27,  66,  95],
        [  5,  29,  73]],

       [[ 12, 151, 144],
        [ 15, 155, 151],
        [ 16, 164, 163],
        ...,
        [ 30,  81,  94],
        [  8,  38,  77],
        [  4,  13,  59]]], dtype=uint8)]"
Image_846.jpg,1630,538,861,600,4100,2660,2491,1138,861,daskShared_local/images/Image_846.jpg,846,"[array([[[186, 173, 160],
        [189, 179, 170],
        [185, 176, 166],
        ...,
        [137, 128, 116],
        [132, 124, 111],
        [132, 124, 108]],

       [[185, 172, 159],
        [187, 177, 167],
        [189, 179, 171],
        ...,
        [137, 128, 114],
        [136, 127, 114],
        [137, 129, 113]],

       [[188, 174, 159],
        [186, 175, 163],
        [187, 177, 166],
        ...,
        [139, 128, 112],
        [136, 124, 110],
        [137, 127, 111]],

       ...,

       [[ 53,  38,  33],
        [ 52,  37,  32],
        [ 53,  38,  33],
        ...,
        [131, 133, 135],
        [127, 122, 114],
        [141, 142, 147]],

       [[ 55,  40,  34],
        [ 54,  39,  34],
        [ 53,  38,  33],
        ...,
        [133, 138, 139],
        [112, 103,  87],
        [134, 131, 126]],

       [[ 56,  41,  36],
        [ 55,  40,  35],
        [ 54,  39,  34],
        ...,
        [145, 145, 139],
        [144, 135, 119],
        [177, 174, 161]]], dtype=uint8)]"
Image_847.jpg,240,68,332,356,800,600,572,424,356,daskShared_local/images/Image_847.jpg,847,"[array([[[ 65, 164, 190],
        [ 84, 200, 203],
        [ 78, 184, 155],
        ...,
        [  3,  95, 170],
        [  1,  95, 169],
        [  0,  94, 168]],

       [[ 94, 180, 177],
        [ 99, 175, 164],
        [ 65, 140, 144],
        ...,
        [  4,  96, 171],
        [  1,  95, 169],
        [  1,  95, 169]],

       [[ 70, 149, 155],
        [ 70, 151, 167],
        [ 33, 121, 161],
        ...,
        [  1,  95, 169],
        [  1,  95, 169],
        [  2,  96, 170]],

       ...,

       [[125, 149,  71],
        [129, 153,  77],
        [128, 159,  83],
        ...,
        [  3,  23,   0],
        [  8,  33,   9],
        [ 12,  48,  14]],

       [[130, 154,  78],
        [131, 157,  84],
        [129, 161,  85],
        ...,
        [  6,  38,   2],
        [  3,  26,   1],
        [  9,  41,  11]],

       [[128, 153,  81],
        [128, 156,  88],
        [129, 163,  87],
        ...,
        [ 15,  61,  13],
        [ 10,  38,   6],
        [ 17,  47,  21]]], dtype=uint8)]"
Image_848.jpg,380,113,157,128,624,468,537,241,157,daskShared_local/images/Image_848.jpg,848,"[array([[[  2,  30,  71],
        [  1,  29,  66],
        [  0,  30,  62],
        ...,
        [ 10,   3,   4],
        [ 10,   3,   6],
        [ 12,  10,  15]],

       [[  1,  32,  66],
        [  0,  30,  61],
        [  0,  30,  56],
        ...,
        [  9,   1,   5],
        [  8,   1,   7],
        [  6,   3,  11]],

       [[  1,  33,  63],
        [  1,  33,  59],
        [  0,  33,  53],
        ...,
        [  8,   4,   9],
        [  7,   5,  11],
        [  6,   6,  13]],

       ...,

       [[198, 156, 100],
        [208, 168, 112],
        [220, 185, 133],
        ...,
        [ 27,  19,  16],
        [ 22,  17,  13],
        [ 18,  14,  10]],

       [[201, 162, 112],
        [208, 171, 122],
        [220, 189, 142],
        ...,
        [ 29,  20,  17],
        [ 23,  17,  13],
        [ 18,  15,  10]],

       [[208, 171, 126],
        [211, 177, 131],
        [217, 190, 146],
        ...,
        [ 31,  22,  18],
        [ 26,  19,  16],
        [ 21,  17,  12]]], dtype=uint8)]"
Image_849.jpg,2239,265,612,511,3033,1757,2851,776,612,daskShared_local/images/Image_849.jpg,849,"[array([[[  0,  53, 217],
        [  0,  53, 217],
        [  0,  53, 217],
        ...,
        [  0,  53, 217],
        [  0,  53, 217],
        [  0,  53, 217]],

       [[  0,  53, 217],
        [  0,  53, 217],
        [  0,  53, 217],
        ...,
        [  0,  53, 217],
        [  0,  53, 217],
        [  0,  53, 217]],

       [[  0,  53, 217],
        [  0,  53, 217],
        [  0,  53, 217],
        ...,
        [  0,  53, 217],
        [  0,  53, 217],
        [  0,  53, 217]],

       ...,

       [[ 67,  74,  43],
        [ 67,  74,  41],
        [ 67,  75,  41],
        ...,
        [  0,  53, 217],
        [  0,  53, 217],
        [  0,  53, 217]],

       [[ 64,  71,  37],
        [ 61,  68,  35],
        [ 63,  71,  38],
        ...,
        [  0,  53, 217],
        [  0,  53, 217],
        [  0,  53, 217]],

       [[ 70,  76,  42],
        [ 63,  70,  37],
        [ 65,  73,  40],
        ...,
        [  0,  53, 217],
        [  0,  53, 217],
        [  0,  53, 217]]], dtype=uint8)]"
Image_85.jpg,194,340,286,192,1024,768,480,532,286,daskShared_local/images/Image_85.jpg,85,"[array([[[ 69, 121, 136],
        [ 52, 100, 118],
        [ 72, 119, 138],
        ...,
        [ 46,  68,  83],
        [ 61,  83,  98],
        [ 41,  65,  79]],

       [[ 87, 143, 162],
        [ 55, 108, 128],
        [ 36,  87, 106],
        ...,
        [ 94, 112, 130],
        [ 64,  83, 100],
        [ 59,  78,  95]],

       [[124, 180, 203],
        [104, 159, 179],
        [ 98, 153, 170],
        ...,
        [ 36,  51,  72],
        [ 33,  48,  69],
        [ 74,  91, 111]],

       ...,

       [[ 22,  27,  33],
        [ 13,  22,  33],
        [ 39,  53,  88],
        ...,
        [ 23,  13,  12],
        [ 17,   7,   6],
        [ 13,   4,   3]],

       [[ 12,  24,  34],
        [ 16,  37,  76],
        [ 29,  65, 118],
        ...,
        [ 21,   7,   7],
        [ 20,   6,   6],
        [ 14,   1,   1]],

       [[  3,  19,  27],
        [ 27,  55,  88],
        [ 59,  98, 144],
        ...,
        [ 16,   2,   2],
        [ 17,   3,   3],
        [ 19,   5,   5]]], dtype=uint8)]"
Image_850.jpg,110,129,117,110,800,544,227,239,117,daskShared_local/images/Image_850.jpg,850,"[array([[[  8,  24,  17],
        [  9,  24,  17],
        [  9,  25,  18],
        ...,
        [ 11,  37,  64],
        [ 14,  36,  63],
        [ 14,  36,  63]],

       [[  8,  24,  16],
        [  8,  24,  16],
        [  9,  25,  17],
        ...,
        [ 11,  37,  63],
        [ 14,  36,  63],
        [ 15,  36,  62]],

       [[  5,  22,  14],
        [  6,  23,  15],
        [  7,  24,  16],
        ...,
        [ 12,  36,  62],
        [ 14,  36,  61],
        [ 15,  36,  61]],

       ...,

       [[ 22,  82, 106],
        [ 21,  80, 104],
        [ 16,  76, 100],
        ...,
        [ 50, 106, 123],
        [ 49, 102, 119],
        [ 49, 101, 118]],

       [[ 30,  86, 110],
        [ 28,  85, 109],
        [ 24,  80, 106],
        ...,
        [ 43,  99, 116],
        [ 45,  97, 114],
        [ 45,  97, 114]],

       [[ 32,  87, 111],
        [ 31,  86, 110],
        [ 26,  82, 107],
        ...,
        [ 41,  97, 114],
        [ 43,  96, 113],
        [ 44,  96, 113]]], dtype=uint8)]"
Image_851.jpg,1285,624,186,183,2304,1536,1471,807,186,daskShared_local/images/Image_851.jpg,851,"[array([[[  0, 105, 150],
        [  0, 105, 150],
        [  1, 106, 151],
        ...,
        [  1, 103, 142],
        [  3, 107, 146],
        [  3, 107, 146]],

       [[  5, 103, 155],
        [  5, 103, 155],
        [  4, 104, 156],
        ...,
        [  2, 104, 144],
        [  2, 104, 144],
        [  2, 104, 144]],

       [[  1, 106, 161],
        [  1, 108, 162],
        [  1, 109, 163],
        ...,
        [  2, 106, 145],
        [  1, 105, 144],
        [  0, 104, 143]],

       ...,

       [[163, 204, 197],
        [169, 210, 200],
        [179, 215, 208],
        ...,
        [ 33,  42,  62],
        [ 33,  42,  64],
        [ 40,  38,  59]],

       [[119, 164, 167],
        [145, 190, 188],
        [166, 207, 203],
        ...,
        [ 28,  34,  52],
        [ 36,  40,  64],
        [ 34,  36,  55]],

       [[ 84, 137, 144],
        [ 99, 154, 149],
        [139, 187, 178],
        ...,
        [ 30,  34,  54],
        [ 33,  31,  52],
        [ 27,  29,  45]]], dtype=uint8)]"
Image_852.jpg,1353,421,549,421,2500,1667,1902,842,549,daskShared_local/images/Image_852.jpg,852,"[array([[[174, 201, 205],
        [177, 202, 207],
        [172, 199, 203],
        ...,
        [188, 215, 224],
        [188, 215, 224],
        [184, 211, 220]],

       [[175, 200, 204],
        [174, 199, 203],
        [171, 199, 202],
        ...,
        [187, 213, 222],
        [188, 213, 223],
        [185, 210, 220]],

       [[169, 201, 203],
        [169, 201, 204],
        [160, 193, 197],
        ...,
        [186, 211, 221],
        [190, 214, 224],
        [189, 211, 222]],

       ...,

       [[146, 126,  75],
        [134, 115,  68],
        [135, 118,  70],
        ...,
        [  0, 160, 199],
        [  0, 157, 196],
        [  0, 156, 196]],

       [[130, 112,  51],
        [131, 114,  56],
        [146, 129,  73],
        ...,
        [  1, 159, 201],
        [  0, 161, 203],
        [  0, 168, 207]],

       [[146, 129,  60],
        [161, 145,  77],
        [163, 147,  84],
        ...,
        [  3, 152, 198],
        [  2, 157, 200],
        [  0, 164, 204]]], dtype=uint8)]"
Image_853.jpg,1008,1487,1115,806,4613,2968,2123,2293,1115,daskShared_local/images/Image_853.jpg,853,"[array([[[134, 160, 162],
        [136, 166, 168],
        [147, 173, 175],
        ...,
        [ 46,  40,  33],
        [ 93,  89,  76],
        [ 43,  35,  26]],

       [[132, 153, 157],
        [134, 159, 163],
        [137, 162, 165],
        ...,
        [ 73,  73,  67],
        [169, 169, 161],
        [ 96,  89,  76]],

       [[129, 148, 152],
        [134, 151, 156],
        [132, 151, 156],
        ...,
        [ 94,  86,  81],
        [115, 108, 101],
        [ 81,  67,  57]],

       ...,

       [[ 61,  62,  64],
        [ 56,  58,  60],
        [ 59,  62,  64],
        ...,
        [172, 167, 151],
        [186, 181, 163],
        [187, 170, 147]],

       [[ 72,  75,  78],
        [ 65,  67,  72],
        [ 60,  63,  66],
        ...,
        [132, 123, 101],
        [164, 151, 128],
        [182, 172, 155]],

       [[ 55,  60,  63],
        [ 57,  61,  65],
        [ 61,  65,  68],
        ...,
        [117, 111,  92],
        [144, 137, 116],
        [138, 128, 111]]], dtype=uint8)]"
Image_854.jpg,413,347,304,249,1536,1024,717,596,304,daskShared_local/images/Image_854.jpg,854,"[array([[[  6, 140, 239],
        [  6, 140, 239],
        [  7, 138, 244],
        ...,
        [ 15, 178, 245],
        [ 13, 176, 244],
        [  9, 171, 241]],

       [[ 12, 144, 244],
        [ 11, 145, 244],
        [ 10, 141, 246],
        ...,
        [ 15, 178, 245],
        [ 12, 175, 244],
        [  9, 171, 240]],

       [[ 16, 148, 246],
        [ 17, 149, 247],
        [ 15, 146, 249],
        ...,
        [ 13, 176, 243],
        [ 13, 176, 245],
        [ 13, 175, 245]],

       ...,

       [[ 10,  62, 210],
        [ 10,  62, 210],
        [ 10,  62, 218],
        ...,
        [ 23, 143, 176],
        [  9, 132, 160],
        [  5, 105, 117]],

       [[ 12,  64, 212],
        [ 13,  65, 213],
        [  7,  63, 209],
        ...,
        [ 11,  86, 116],
        [ 21, 114, 145],
        [ 17,  88,  96]],

       [[ 10,  62, 210],
        [ 11,  63, 211],
        [  6,  64, 201],
        ...,
        [  9,  71,  52],
        [ 23,  92,  98],
        [ 23,  96, 104]]], dtype=uint8)]"
Image_855.jpg,395,136,217,205,869,574,612,341,217,daskShared_local/images/Image_855.jpg,855,"[array([[[  0, 147, 213],
        [  0, 147, 211],
        [  0, 144, 210],
        ...,
        [ 79, 165, 242],
        [ 79, 165, 242],
        [ 79, 165, 242]],

       [[  0, 143, 213],
        [  0, 142, 212],
        [  0, 142, 212],
        ...,
        [ 79, 166, 243],
        [ 78, 165, 242],
        [ 78, 165, 242]],

       [[  1, 139, 211],
        [  2, 140, 211],
        [  3, 139, 212],
        ...,
        [ 78, 166, 243],
        [ 77, 165, 242],
        [ 76, 164, 241]],

       ...,

       [[ 12,  97,  73],
        [  2,  53,  43],
        [  2,  21,  21],
        ...,
        [  2, 104, 179],
        [  2, 104, 179],
        [  2, 104, 179]],

       [[ 10,  55,  46],
        [  5,  20,  22],
        [  7,  12,  18],
        ...,
        [  2, 104, 179],
        [  2, 104, 179],
        [  2, 104, 179]],

       [[  1,   3,   6],
        [  0,   9,   9],
        [  2,  32,  25],
        ...,
        [  2, 104, 179],
        [  2, 104, 179],
        [  2, 104, 179]]], dtype=uint8)]"
Image_856.jpg,295,164,230,212,1000,664,525,376,230,daskShared_local/images/Image_856.jpg,856,"[array([[[  1,  80, 147],
        [  0,  81, 147],
        [  1,  80, 147],
        ...,
        [  0, 100, 170],
        [  0, 101, 171],
        [  0,  99, 169]],

       [[  1,  80, 147],
        [  0,  79, 147],
        [  0,  79, 146],
        ...,
        [  0,  99, 168],
        [  0, 100, 169],
        [  0,  99, 171]],

       [[  0,  80, 147],
        [  1,  80, 147],
        [  0,  79, 147],
        ...,
        [  0,  99, 168],
        [  0,  99, 168],
        [  0,  99, 171]],

       ...,

       [[ 34,  50,  50],
        [ 37,  55,  51],
        [ 33,  58,  53],
        ...,
        [233, 220, 184],
        [234, 222, 186],
        [236, 233, 191]],

       [[ 31,  41,  36],
        [ 33,  43,  42],
        [ 33,  53,  48],
        ...,
        [231, 220, 182],
        [231, 219, 176],
        [234, 227, 181]],

       [[ 29,  37,  27],
        [ 22,  26,  24],
        [ 21,  32,  33],
        ...,
        [207, 194, 158],
        [217, 205, 159],
        [222, 209, 165]]], dtype=uint8)]"
Image_857.jpg,600,214,404,443,1600,1070,1004,657,443,daskShared_local/images/Image_857.jpg,857,"[array([[[ 22,  75, 145],
        [ 22,  75, 145],
        [ 22,  75, 145],
        ...,
        [ 28,  69, 133],
        [ 28,  69, 133],
        [ 28,  69, 133]],

       [[ 22,  75, 145],
        [ 22,  75, 145],
        [ 22,  75, 145],
        ...,
        [ 28,  69, 133],
        [ 28,  69, 133],
        [ 28,  69, 133]],

       [[ 22,  75, 145],
        [ 22,  75, 145],
        [ 22,  75, 145],
        ...,
        [ 28,  69, 133],
        [ 28,  69, 133],
        [ 28,  69, 133]],

       ...,

       [[140, 128, 107],
        [159, 144, 115],
        [187, 165, 128],
        ...,
        [244, 198, 139],
        [246, 206, 144],
        [245, 207, 152]],

       [[134, 122, 101],
        [143, 134, 111],
        [169, 160, 131],
        ...,
        [210, 172, 116],
        [241, 210, 161],
        [253, 227, 190]],

       [[131, 111,  89],
        [115, 102,  84],
        [130, 122, 103],
        ...,
        [166, 133,  84],
        [197, 168, 124],
        [245, 217, 184]]], dtype=uint8)]"
Image_858.jpg,419,140,230,226,1024,686,649,366,230,daskShared_local/images/Image_858.jpg,858,"[array([[[ 32, 188, 239],
        [ 32, 188, 239],
        [ 31, 187, 238],
        ...,
        [  0, 158, 219],
        [  0, 158, 219],
        [  0, 156, 217]],

       [[ 30, 186, 237],
        [ 30, 186, 237],
        [ 29, 185, 236],
        ...,
        [  0, 157, 218],
        [  0, 157, 218],
        [  0, 156, 217]],

       [[ 30, 186, 237],
        [ 29, 185, 236],
        [ 29, 185, 236],
        ...,
        [  1, 156, 218],
        [  1, 156, 218],
        [  0, 156, 217]],

       ...,

       [[227, 220, 217],
        [211, 204, 200],
        [211, 201, 197],
        ...,
        [  3, 115, 181],
        [  3, 115, 181],
        [  5, 116, 185]],

       [[220, 216, 215],
        [210, 207, 207],
        [226, 222, 222],
        ...,
        [  3, 115, 181],
        [  3, 115, 181],
        [  3, 114, 183]],

       [[219, 215, 216],
        [202, 203, 205],
        [229, 230, 233],
        ...,
        [  3, 115, 181],
        [  3, 115, 181],
        [  0, 110, 179]]], dtype=uint8)]"
Image_859.jpg,449,231,166,164,900,586,615,395,166,daskShared_local/images/Image_859.jpg,859,"[array([[[  1, 174, 208],
        [  1, 174, 208],
        [  1, 174, 208],
        ...,
        [103, 205, 227],
        [103, 205, 227],
        [103, 205, 227]],

       [[  1, 174, 208],
        [  1, 174, 208],
        [  1, 174, 208],
        ...,
        [103, 205, 227],
        [103, 205, 227],
        [103, 205, 227]],

       [[  0, 171, 210],
        [  0, 172, 210],
        [  0, 174, 212],
        ...,
        [103, 204, 227],
        [103, 204, 227],
        [103, 204, 227]],

       ...,

       [[  6,  76,  69],
        [  2,  55,  48],
        [  0,  48,  41],
        ...,
        [  1, 163, 209],
        [  1, 163, 209],
        [  1, 163, 209]],

       [[  9,  92,  82],
        [  2,  71,  60],
        [  0,  46,  40],
        ...,
        [  1, 163, 209],
        [  1, 163, 209],
        [  1, 163, 209]],

       [[ 12, 104,  90],
        [  3,  82,  69],
        [  0,  47,  43],
        ...,
        [  1, 163, 209],
        [  1, 163, 209],
        [  1, 163, 209]]], dtype=uint8)]"
Image_86.jpg,490,145,221,154,800,600,711,299,221,daskShared_local/images/Image_86.jpg,86,"[array([[[  2,  32,  67],
        [  3,  35,  73],
        [  2,  31,  67],
        ...,
        [ 13,  20,  26],
        [ 10,  13,  20],
        [  8,   8,  16]],

       [[  0,  34,  73],
        [  4,  39,  85],
        [  1,  35,  80],
        ...,
        [ 11,  16,  22],
        [  9,  12,  19],
        [  9,   9,  17]],

       [[  2,  37,  76],
        [  5,  45,  94],
        [  3,  44,  94],
        ...,
        [  8,  13,  19],
        [  7,  10,  16],
        [  7,   8,  15]],

       ...,

       [[207, 180, 134],
        [199, 175, 124],
        [198, 171, 116],
        ...,
        [ 28,  14,  11],
        [ 28,  13,  10],
        [ 27,  11,  11]],

       [[203, 176, 137],
        [202, 176, 136],
        [196, 170, 125],
        ...,
        [ 27,  15,  12],
        [ 29,  15,  12],
        [ 24,  10,   9]],

       [[201, 171, 143],
        [195, 169, 141],
        [194, 169, 136],
        ...,
        [ 28,  21,  16],
        [ 32,  24,  18],
        [ 28,  18,  16]]], dtype=uint8)]"
Image_860.jpg,733,436,447,330,2119,1414,1180,766,447,daskShared_local/images/Image_860.jpg,860,"[array([[[ 98, 154, 183],
        [ 92, 150, 180],
        [ 94, 153, 183],
        ...,
        [ 76, 140, 168],
        [ 75, 138, 168],
        [ 77, 142, 172]],

       [[ 97, 152, 182],
        [ 95, 152, 182],
        [ 97, 154, 184],
        ...,
        [ 80, 143, 171],
        [ 77, 140, 171],
        [ 77, 142, 172]],

       [[101, 156, 186],
        [ 94, 151, 181],
        [100, 158, 188],
        ...,
        [ 76, 141, 169],
        [ 83, 147, 177],
        [ 74, 139, 169]],

       ...,

       [[ 86, 176, 202],
        [ 85, 175, 200],
        [ 85, 175, 199],
        ...,
        [239, 244, 245],
        [236, 244, 249],
        [230, 241, 253]],

       [[ 86, 178, 203],
        [ 85, 177, 200],
        [ 85, 177, 200],
        ...,
        [204, 199, 218],
        [227, 224, 246],
        [214, 219, 247]],

       [[ 84, 176, 201],
        [ 84, 176, 200],
        [ 84, 176, 199],
        ...,
        [181, 168, 186],
        [198, 187, 207],
        [180, 180, 205]]], dtype=uint8)]"
Image_861.jpg,1888,598,1202,1196,4752,3168,3090,1794,1202,daskShared_local/images/Image_861.jpg,861,"[array([[[ 69,  65,  41],
        [ 70,  67,  42],
        [ 71,  68,  40],
        ...,
        [ 54, 126, 150],
        [ 53, 125, 149],
        [ 54, 126, 150]],

       [[ 71,  65,  39],
        [ 75,  70,  41],
        [ 72,  67,  38],
        ...,
        [ 52, 123, 149],
        [ 52, 123, 148],
        [ 53, 124, 149]],

       [[ 71,  63,  38],
        [ 74,  66,  39],
        [ 71,  62,  35],
        ...,
        [ 46, 119, 148],
        [ 48, 120, 149],
        [ 48, 120, 149]],

       ...,

       [[  3,  96, 140],
        [  3,  96, 141],
        [  2,  96, 140],
        ...,
        [115,  94,  75],
        [ 98,  81,  74],
        [ 79,  65,  66]],

       [[  7,  97, 141],
        [  3,  96, 140],
        [  3,  97, 140],
        ...,
        [114,  93,  72],
        [ 92,  75,  66],
        [ 70,  57,  56]],

       [[ 11,  97, 141],
        [  8,  98, 141],
        [  7,  98, 141],
        ...,
        [131, 113,  88],
        [ 97,  82,  72],
        [ 68,  57,  54]]], dtype=uint8)]"
Image_862.jpg,447,221,181,190,1200,630,628,411,190,daskShared_local/images/Image_862.jpg,862,"[array([[[ 28, 103, 171],
        [ 31, 106, 173],
        [ 30, 108, 174],
        ...,
        [ 22,  39,  46],
        [ 27,  41,  48],
        [ 18,  28,  37]],

       [[ 29, 104, 172],
        [ 28, 103, 170],
        [ 26, 104, 170],
        ...,
        [ 33,  50,  57],
        [ 34,  47,  55],
        [ 25,  34,  43]],

       [[ 32, 108, 175],
        [ 27, 104, 170],
        [ 25, 103, 169],
        ...,
        [ 43,  58,  65],
        [ 23,  33,  42],
        [ 22,  31,  40]],

       ...,

       [[ 36,  81, 104],
        [ 31,  74,  98],
        [ 28,  70,  94],
        ...,
        [ 17,  21,  22],
        [ 20,  26,  26],
        [ 27,  33,  33]],

       [[ 37,  82, 105],
        [ 33,  78, 101],
        [ 31,  73,  97],
        ...,
        [ 20,  26,  26],
        [ 14,  23,  22],
        [ 25,  34,  33]],

       [[ 34,  80, 103],
        [ 31,  76,  99],
        [ 27,  72,  95],
        ...,
        [ 29,  40,  36],
        [ 19,  30,  26],
        [ 17,  28,  24]]], dtype=uint8)]"
Image_863.jpg,688,656,419,294,2793,2090,1107,950,419,daskShared_local/images/Image_863.jpg,863,"[array([[[  5,  69, 192],
        [  5,  69, 192],
        [  5,  69, 192],
        ...,
        [  3,  68, 186],
        [  4,  67, 186],
        [  6,  66, 186]],

       [[  5,  69, 192],
        [  5,  69, 192],
        [  5,  69, 192],
        ...,
        [  3,  68, 186],
        [  4,  67, 186],
        [  6,  66, 186]],

       [[  5,  69, 192],
        [  5,  69, 192],
        [  5,  69, 192],
        ...,
        [  3,  68, 186],
        [  4,  67, 186],
        [  6,  66, 186]],

       ...,

       [[  1,  52, 149],
        [  1,  52, 149],
        [  2,  51, 149],
        ...,
        [155, 187, 167],
        [ 91, 126, 112],
        [ 24,  55,  47]],

       [[  3,  51, 149],
        [  3,  51, 149],
        [  3,  51, 149],
        ...,
        [150, 179, 151],
        [108, 139, 116],
        [ 65,  96,  81]],

       [[  3,  51, 149],
        [  3,  51, 149],
        [  3,  51, 149],
        ...,
        [123, 156, 130],
        [103, 137, 115],
        [ 89, 121, 106]]], dtype=uint8)]"
Image_864.png,242,31,83,87,589,295,325,118,87,daskShared_local/images/Image_864.png,864,"[array([[[  0, 171, 190],
        [  0, 171, 191],
        [  0, 169, 188],
        ...,
        [  7, 175, 200],
        [ 14, 176, 200],
        [ 12, 176, 200]],

       [[  0, 171, 191],
        [  0, 172, 192],
        [  0, 169, 189],
        ...,
        [  8, 175, 199],
        [ 16, 176, 200],
        [ 14, 176, 200]],

       [[  0, 170, 189],
        [  0, 170, 190],
        [  0, 169, 187],
        ...,
        [  4, 174, 200],
        [  8, 175, 199],
        [  7, 175, 199]],

       ...,

       [[ 57,  37,  35],
        [ 58,  38,  36],
        [ 55,  35,  33],
        ...,
        [176, 128, 124],
        [189, 134, 129],
        [185, 133, 128]],

       [[ 62,  41,  38],
        [ 62,  41,  37],
        [ 64,  41,  40],
        ...,
        [199, 166, 168],
        [193, 154, 157],
        [195, 157, 160]],

       [[ 61,  40,  37],
        [ 61,  40,  37],
        [ 62,  39,  38],
        ...,
        [193, 155, 156],
        [192, 149, 150],
        [192, 151, 151]]], dtype=uint8)]"
Image_865.jpg,227,188,155,165,500,559,382,353,165,daskShared_local/images/Image_865.jpg,865,"[array([[[ 83, 174, 174],
        [ 80, 173, 173],
        [ 76, 172, 174],
        ...,
        [132, 215, 207],
        [136, 213, 204],
        [139, 212, 203]],

       [[ 77, 171, 173],
        [ 76, 174, 176],
        [ 73, 172, 174],
        ...,
        [133, 213, 206],
        [138, 212, 204],
        [143, 212, 203]],

       [[ 69, 161, 163],
        [ 68, 164, 166],
        [ 68, 165, 168],
        ...,
        [127, 209, 200],
        [133, 209, 200],
        [141, 210, 201]],

       ...,

       [[ 83,  86,  48],
        [ 87,  93,  50],
        [ 85,  90,  42],
        ...,
        [110, 132,  23],
        [121, 139,  42],
        [115, 131,  43]],

       [[ 43,  37,  19],
        [ 49,  46,  28],
        [ 58,  58,  28],
        ...,
        [ 95, 129,  31],
        [106, 137,  48],
        [105, 132,  49]],

       [[ 51,  34,   2],
        [ 46,  29,   3],
        [ 34,  24,  17],
        ...,
        [ 72, 128,  51],
        [ 80, 133,  53],
        [ 86, 136,  52]]], dtype=uint8)]"
Image_866.jpeg,637,146,264,256,1200,800,901,402,264,daskShared_local/images/Image_866.jpeg,866,"[array([[[163, 210, 222],
        [170, 216, 229],
        [171, 213, 229],
        ...,
        [179, 212, 229],
        [177, 210, 227],
        [177, 210, 227]],

       [[165, 214, 221],
        [170, 218, 227],
        [172, 212, 224],
        ...,
        [176, 212, 229],
        [175, 211, 228],
        [176, 212, 229]],

       [[167, 217, 221],
        [170, 219, 224],
        [173, 214, 220],
        ...,
        [174, 213, 230],
        [172, 211, 228],
        [173, 212, 229]],

       ...,

       [[ 50,  14,   1],
        [126,  94,   5],
        [165, 124,  54],
        ...,
        [141, 118,  40],
        [122, 100,  29],
        [117,  96,  36]],

       [[ 98,  64,  20],
        [184, 156,  52],
        [199, 163,  79],
        ...,
        [117, 103,  51],
        [111,  97,  47],
        [115, 101,  55]],

       [[159, 123,  85],
        [215, 185, 114],
        [226, 192, 108],
        ...,
        [110, 103,  74],
        [108, 101,  69],
        [ 97,  88,  52]]], dtype=uint8)]"
Image_867.jpg,486,241,355,227,1200,900,841,468,355,daskShared_local/images/Image_867.jpg,867,"[array([[[ 11, 149, 156],
        [ 38, 161, 170],
        [ 10, 148, 152],
        ...,
        [ 83, 188, 206],
        [ 90, 189, 205],
        [ 99, 192, 209]],

       [[ 14, 153, 162],
        [ 38, 150, 157],
        [ 25, 147, 170],
        ...,
        [ 77, 183, 200],
        [ 78, 185, 198],
        [ 88, 191, 206]],

       [[ 29, 151, 153],
        [ 40, 161, 171],
        [ 38, 166, 173],
        ...,
        [ 60, 183, 205],
        [ 81, 188, 204],
        [ 94, 191, 213]],

       ...,

       [[ 74, 128, 102],
        [ 67, 128, 103],
        [ 66, 128, 102],
        ...,
        [129, 201, 213],
        [131, 201, 214],
        [151, 207, 223]],

       [[ 66, 128, 101],
        [ 76, 128, 104],
        [ 86, 136, 116],
        ...,
        [152, 209, 219],
        [155, 211, 222],
        [166, 214, 227]],

       [[ 78, 132, 111],
        [ 80, 131, 112],
        [ 73, 140, 123],
        ...,
        [167, 215, 225],
        [168, 217, 228],
        [152, 209, 225]]], dtype=uint8)]"
Image_868.jpg,280,167,174,168,800,533,454,335,174,daskShared_local/images/Image_868.jpg,868,"[array([[[236, 215, 185],
        [237, 216, 186],
        [237, 216, 185],
        ...,
        [101,  99, 121],
        [ 98,  96, 116],
        [ 73,  72,  90]],

       [[241, 220, 198],
        [237, 216, 195],
        [233, 212, 191],
        ...,
        [ 66,  64,  85],
        [ 86,  85, 103],
        [ 95,  94, 111]],

       [[246, 224, 214],
        [241, 219, 209],
        [238, 216, 206],
        ...,
        [ 27,  26,  44],
        [ 49,  48,  65],
        [ 88,  87, 103]],

       ...,

       [[165, 138, 123],
        [164, 137, 122],
        [165, 138, 123],
        ...,
        [103,  87,  73],
        [ 97,  81,  67],
        [ 92,  76,  62]],

       [[174, 149, 127],
        [172, 147, 125],
        [169, 144, 122],
        ...,
        [105,  91,  82],
        [104,  90,  81],
        [100,  86,  77]],

       [[174, 149, 128],
        [169, 144, 123],
        [162, 137, 117],
        ...,
        [100,  86,  77],
        [ 97,  83,  74],
        [ 93,  79,  70]]], dtype=uint8)]"
Image_869.jpg,1733,512,1416,1618,4631,3087,3149,2130,1618,daskShared_local/images/Image_869.jpg,869,"[array([[[ 19,  95, 241],
        [ 19,  95, 241],
        [ 19,  95, 241],
        ...,
        [  1,  60, 199],
        [  1,  60, 198],
        [  1,  60, 198]],

       [[ 20,  94, 241],
        [ 20,  94, 241],
        [ 20,  94, 241],
        ...,
        [  1,  60, 198],
        [  1,  59, 197],
        [  0,  59, 197]],

       [[ 20,  94, 241],
        [ 20,  94, 241],
        [ 20,  94, 241],
        ...,
        [  1,  60, 197],
        [  0,  59, 196],
        [  0,  59, 195]],

       ...,

       [[ 71,  72,  76],
        [ 94,  94,  89],
        [127, 127, 102],
        ...,
        [ 31,  38,  15],
        [ 41,  49,  23],
        [ 43,  51,  27]],

       [[ 35,  40,  50],
        [ 55,  59,  68],
        [113, 107,  93],
        ...,
        [ 39,  46,  23],
        [ 52,  61,  36],
        [ 43,  50,  29]],

       [[ 28,  35,  42],
        [ 46,  49,  54],
        [ 98,  87,  77],
        ...,
        [ 44,  51,  27],
        [ 53,  61,  36],
        [ 42,  49,  30]]], dtype=uint8)]"
Image_87.jpg,104,110,458,284,800,533,562,394,458,daskShared_local/images/Image_87.jpg,87,"[array([[[  0,  11,  58],
        [  1,  12,  58],
        [  3,  11,  58],
        ...,
        [ 22,  48, 107],
        [ 19,  49, 109],
        [ 20,  53, 112]],

       [[  1,  14,  58],
        [  2,  12,  55],
        [  2,  11,  54],
        ...,
        [ 20,  47, 103],
        [ 18,  48, 105],
        [ 20,  50, 110]],

       [[  2,  14,  56],
        [  4,  11,  57],
        [  3,  10,  56],
        ...,
        [ 20,  43, 100],
        [ 18,  45, 102],
        [ 18,  47, 107]],

       ...,

       [[  4,  10,  55],
        [  5,  14,  57],
        [  6,  15,  60],
        ...,
        [129,  79,  32],
        [135,  87,  36],
        [144, 101,  49]],

       [[  5,  16,  59],
        [  5,  15,  58],
        [  3,  17,  59],
        ...,
        [118,  60,  16],
        [179, 129,  83],
        [160, 128,  80]],

       [[  4,  19,  59],
        [  4,  17,  59],
        [  2,  20,  59],
        ...,
        [129,  69,  26],
        [174, 129,  88],
        [169, 141, 101]]], dtype=uint8)]"
Image_870.jpg,339,129,263,247,845,563,602,376,263,daskShared_local/images/Image_870.jpg,870,"[array([[[ 93, 203, 202],
        [ 98, 203, 204],
        [103, 203, 205],
        ...,
        [ 85, 193, 196],
        [ 89, 196, 199],
        [ 93, 198, 202]],

       [[ 81, 199, 197],
        [ 85, 197, 198],
        [ 93, 201, 202],
        ...,
        [ 87, 196, 198],
        [ 92, 200, 202],
        [ 96, 201, 204]],

       [[ 78, 198, 197],
        [ 79, 196, 196],
        [ 87, 201, 201],
        ...,
        [ 88, 200, 201],
        [ 91, 202, 202],
        [ 94, 202, 202]],

       ...,

       [[ 58, 102,  35],
        [ 60, 102,  37],
        [ 59, 101,  37],
        ...,
        [ 50, 195, 192],
        [ 50, 195, 192],
        [ 51, 196, 192]],

       [[ 64, 102,  35],
        [ 65, 101,  38],
        [ 66, 103,  40],
        ...,
        [ 64, 202, 196],
        [ 64, 202, 196],
        [ 64, 202, 196]],

       [[ 63,  95,  30],
        [ 59,  92,  29],
        [ 57,  91,  30],
        ...,
        [ 74, 206, 200],
        [ 75, 207, 201],
        [ 74, 208, 201]]], dtype=uint8)]"
Image_871.png,390,188,308,282,900,600,698,470,308,daskShared_local/images/Image_871.png,871,"[array([[[128, 113, 108],
        [123, 111,  97],
        [132, 129, 119],
        ...,
        [ 22, 150, 180],
        [ 27, 151, 181],
        [ 28, 151, 184]],

       [[121, 111, 100],
        [112,  96,  88],
        [114, 112, 103],
        ...,
        [ 21, 150, 181],
        [ 22, 151, 180],
        [ 26, 153, 181]],

       [[136, 130, 125],
        [136, 116, 112],
        [133, 119, 118],
        ...,
        [ 20, 151, 178],
        [ 24, 150, 181],
        [ 26, 151, 182]],

       ...,

       [[ 21,  81,  82],
        [ 25,  70,  67],
        [ 20,  61,  62],
        ...,
        [ 82, 150, 140],
        [ 79, 149, 141],
        [ 86, 147, 138]],

       [[ 17,  59,  58],
        [ 18,  58,  57],
        [ 25,  54,  56],
        ...,
        [ 74, 148, 140],
        [ 86, 148, 139],
        [ 76, 151, 140]],

       [[ 18,  58,  57],
        [ 20,  57,  56],
        [ 20,  57,  55],
        ...,
        [ 78, 152, 142],
        [ 78, 152, 145],
        [ 80, 151, 144]]], dtype=uint8)]"
Image_872.jpg,353,93,154,201,728,486,507,294,201,daskShared_local/images/Image_872.jpg,872,"[array([[[  0,  68, 253],
        [  0,  70, 254],
        [  2,  67, 255],
        ...,
        [  0, 109, 252],
        [  1, 110, 253],
        [  0, 111, 252]],

       [[  1,  66, 254],
        [  1,  66, 254],
        [  2,  65, 255],
        ...,
        [  0, 109, 254],
        [  0, 111, 255],
        [  1, 110, 253]],

       [[  1,  64, 255],
        [  1,  64, 253],
        [  0,  67, 254],
        ...,
        [  0, 109, 254],
        [  0, 109, 252],
        [  1, 112, 253]],

       ...,

       [[204, 159, 121],
        [199, 158, 128],
        [198, 157, 126],
        ...,
        [172, 188, 184],
        [198, 203, 189],
        [184, 184, 164]],

       [[202, 158, 129],
        [187, 151, 127],
        [194, 152, 114],
        ...,
        [ 90, 100,  67],
        [133, 156, 141],
        [215, 220, 215]],

       [[203, 157, 124],
        [200, 154, 120],
        [201, 149, 112],
        ...,
        [ 88,  98,  62],
        [ 72,  85,  42],
        [127, 151, 153]]], dtype=uint8)]"
Image_873.jpg,305,209,200,202,1000,600,505,411,202,daskShared_local/images/Image_873.jpg,873,"[array([[[  1, 146, 193],
        [  1, 146, 193],
        [  1, 146, 193],
        ...,
        [  1, 158, 201],
        [  1, 158, 201],
        [  1, 158, 201]],

       [[  1, 146, 193],
        [  1, 146, 193],
        [  1, 146, 193],
        ...,
        [  1, 158, 201],
        [  1, 158, 201],
        [  1, 158, 201]],

       [[  1, 146, 193],
        [  1, 146, 193],
        [  1, 146, 193],
        ...,
        [  1, 158, 201],
        [  1, 158, 201],
        [  1, 158, 201]],

       ...,

       [[150, 123,  53],
        [189, 162,  86],
        [217, 185, 127],
        ...,
        [249, 219, 154],
        [249, 223, 162],
        [249, 224, 160]],

       [[169, 139,  52],
        [202, 170,  99],
        [229, 195, 130],
        ...,
        [249, 221, 158],
        [248, 223, 159],
        [247, 222, 158]],

       [[187, 148,  53],
        [214, 175, 104],
        [231, 194, 113],
        ...,
        [248, 223, 159],
        [246, 222, 158],
        [245, 222, 155]]], dtype=uint8)]"
Image_874.jpg,652,118,204,184,1156,650,856,302,204,daskShared_local/images/Image_874.jpg,874,"[array([[[ 30, 151, 170],
        [ 20, 145, 165],
        [ 13, 140, 162],
        ...,
        [ 29, 147, 170],
        [ 38, 140, 163],
        [ 36, 128, 151]],

       [[ 41, 150, 176],
        [ 37, 148, 175],
        [ 26, 141, 168],
        ...,
        [ 21, 141, 161],
        [ 40, 146, 166],
        [ 52, 147, 167]],

       [[ 54, 162, 190],
        [ 53, 162, 191],
        [ 42, 153, 183],
        ...,
        [ 16, 138, 154],
        [ 37, 145, 160],
        [ 69, 167, 182]],

       ...,

       [[ 75,  73,  50],
        [ 91,  90,  62],
        [ 87,  86,  56],
        ...,
        [  1, 132, 174],
        [  0, 130, 172],
        [  0, 129, 171]],

       [[ 47,  45,  22],
        [ 72,  71,  42],
        [ 82,  81,  51],
        ...,
        [  2, 133, 177],
        [  0, 131, 177],
        [  0, 130, 176]],

       [[  9,   7,   0],
        [ 24,  23,   1],
        [ 48,  47,  16],
        ...,
        [  2, 133, 179],
        [  1, 131, 180],
        [  0, 130, 179]]], dtype=uint8)]"
Image_875.jpg,423,146,236,261,1200,822,659,407,261,daskShared_local/images/Image_875.jpg,875,"[array([[[  0, 146, 171],
        [  0, 145, 170],
        [  0, 145, 170],
        ...,
        [  0, 162, 188],
        [  2, 163, 189],
        [  2, 164, 189]],

       [[  1, 144, 170],
        [  0, 143, 169],
        [  0, 142, 168],
        ...,
        [  1, 162, 190],
        [  2, 163, 191],
        [  2, 163, 191]],

       [[  2, 143, 170],
        [  1, 142, 169],
        [  1, 142, 169],
        ...,
        [  2, 161, 190],
        [  1, 162, 190],
        [  0, 161, 189]],

       ...,

       [[103, 112,  43],
        [100, 111,  46],
        [ 95, 111,  48],
        ...,
        [ 78,  60,  40],
        [103,  84,  64],
        [141, 121, 101]],

       [[103, 106,  24],
        [100, 108,  28],
        [100, 111,  36],
        ...,
        [109,  89,  68],
        [137, 123,  98],
        [149, 141, 114]],

       [[101, 104,  14],
        [ 98, 102,  15],
        [100, 108,  23],
        ...,
        [134, 117,  93],
        [147, 139, 109],
        [134, 134, 100]]], dtype=uint8)]"
Image_876.jpg,702,263,457,516,1920,1080,1159,779,516,daskShared_local/images/Image_876.jpg,876,"[array([[[  0, 118, 202],
        [  0, 119, 203],
        [  0, 119, 203],
        ...,
        [  2, 117, 201],
        [  1, 116, 199],
        [  1, 116, 199]],

       [[  0, 118, 202],
        [  0, 119, 203],
        [  0, 119, 203],
        ...,
        [  2, 117, 200],
        [  1, 116, 199],
        [  1, 116, 199]],

       [[  0, 118, 202],
        [  0, 119, 203],
        [  0, 119, 203],
        ...,
        [  2, 117, 200],
        [  1, 116, 199],
        [  1, 116, 199]],

       ...,

       [[ 77,  83,  62],
        [ 90,  99,  76],
        [121, 129, 100],
        ...,
        [154, 141, 109],
        [133, 121,  83],
        [133, 125,  78]],

       [[ 77,  82,  73],
        [ 93, 103,  87],
        [ 79,  89,  64],
        ...,
        [164, 150, 119],
        [163, 148, 115],
        [160, 147, 110]],

       [[ 68,  75,  56],
        [ 75,  87,  64],
        [ 83,  94,  66],
        ...,
        [188, 177, 142],
        [180, 167, 133],
        [176, 164, 129]]], dtype=uint8)]"
Image_877.jpg,34,83,216,165,800,600,250,248,216,daskShared_local/images/Image_877.jpg,877,"[array([[[  4, 156, 205],
        [  2, 154, 204],
        [  0, 154, 204],
        ...,
        [ 21, 176, 224],
        [ 21, 178, 223],
        [ 18, 176, 223]],

       [[  7, 157, 205],
        [  5, 155, 205],
        [  3, 154, 204],
        ...,
        [ 23, 178, 225],
        [ 23, 178, 224],
        [ 23, 180, 225]],

       [[  4, 151, 202],
        [  8, 155, 206],
        [  7, 155, 206],
        ...,
        [ 23, 178, 224],
        [ 24, 179, 224],
        [ 25, 182, 227]],

       ...,

       [[ 67, 133, 121],
        [ 68, 138, 120],
        [ 67, 139, 119],
        ...,
        [104,  89,  67],
        [101,  87,  62],
        [ 99,  83,  58]],

       [[ 63, 129, 118],
        [ 63, 132, 114],
        [ 64, 133, 114],
        ...,
        [103,  83,  64],
        [104,  84,  63],
        [ 98,  77,  54]],

       [[ 62, 125, 116],
        [ 60, 127, 112],
        [ 60, 129, 110],
        ...,
        [102,  80,  60],
        [102,  82,  58],
        [101,  81,  57]]], dtype=uint8)]"
Image_878.jpg,1002,138,241,316,1686,1216,1243,454,316,daskShared_local/images/Image_878.jpg,878,"[array([[[127, 184, 214],
        [127, 184, 214],
        [126, 183, 213],
        ...,
        [161, 201, 226],
        [161, 201, 226],
        [162, 202, 227]],

       [[126, 183, 213],
        [125, 182, 212],
        [126, 183, 213],
        ...,
        [161, 201, 226],
        [161, 201, 226],
        [162, 202, 227]],

       [[125, 182, 212],
        [124, 181, 211],
        [125, 182, 212],
        ...,
        [160, 200, 225],
        [160, 200, 225],
        [161, 201, 226]],

       ...,

       [[130, 192, 181],
        [121, 184, 171],
        [ 93, 156, 138],
        ...,
        [ 91, 167, 203],
        [ 92, 168, 204],
        [ 92, 167, 202]],

       [[121, 186, 171],
        [106, 173, 156],
        [ 83, 147, 129],
        ...,
        [ 90, 166, 202],
        [ 94, 170, 206],
        [ 93, 168, 203]],

       [[104, 169, 152],
        [ 96, 163, 145],
        [ 83, 148, 130],
        ...,
        [ 90, 166, 202],
        [ 93, 169, 205],
        [ 94, 169, 204]]], dtype=uint8)]"
Image_879.jpg,419,158,796,671,1500,1000,1215,829,796,daskShared_local/images/Image_879.jpg,879,"[array([[[  1,  58,  67],
        [  3,  56,  67],
        [  3,  55,  66],
        ...,
        [165, 159, 176],
        [171, 163, 180],
        [158, 152, 173]],

       [[  1,  58,  67],
        [  3,  56,  67],
        [  3,  55,  66],
        ...,
        [173, 164, 182],
        [171, 162, 182],
        [151, 145, 169]],

       [[  1,  58,  69],
        [  2,  57,  69],
        [  2,  56,  68],
        ...,
        [165, 156, 178],
        [157, 150, 174],
        [138, 132, 162]],

       ...,

       [[196, 199, 202],
        [192, 195, 199],
        [180, 182, 190],
        ...,
        [ 40,  67,  42],
        [ 38,  66,  43],
        [ 37,  65,  42]],

       [[202, 205, 207],
        [204, 204, 206],
        [197, 197, 201],
        ...,
        [ 41,  69,  44],
        [ 38,  66,  42],
        [ 38,  66,  43]],

       [[198, 203, 207],
        [208, 208, 210],
        [203, 203, 206],
        ...,
        [ 44,  72,  47],
        [ 40,  68,  44],
        [ 38,  66,  41]]], dtype=uint8)]"
Image_88.jpg,114,392,390,279,1715,1286,504,671,390,daskShared_local/images/Image_88.jpg,88,"[array([[[135, 146, 146],
        [136, 148, 150],
        [142, 155, 155],
        ...,
        [ 44,  48,  87],
        [ 47,  39,  62],
        [ 41,  39,  61]],

       [[133, 143, 144],
        [138, 148, 150],
        [142, 151, 154],
        ...,
        [ 44,  37,  71],
        [ 44,  37,  60],
        [ 46,  39,  55]],

       [[132, 143, 144],
        [134, 146, 148],
        [139, 151, 152],
        ...,
        [ 67,  41,  59],
        [ 59,  41,  53],
        [ 60,  44,  59]],

       ...,

       [[194, 198, 181],
        [189, 190, 180],
        [184, 186, 172],
        ...,
        [198, 208, 215],
        [202, 212, 221],
        [203, 214, 220]],

       [[194, 200, 184],
        [192, 195, 183],
        [188, 190, 181],
        ...,
        [197, 205, 214],
        [200, 208, 220],
        [204, 209, 224]],

       [[189, 199, 187],
        [185, 196, 181],
        [184, 193, 178],
        ...,
        [194, 197, 216],
        [196, 205, 220],
        [206, 216, 223]]], dtype=uint8)]"
Image_880.jpg,251,382,856,683,1512,1231,1107,1065,856,daskShared_local/images/Image_880.jpg,880,"[array([[[ 71,  84,  70],
        [ 72,  84,  70],
        [ 73,  86,  73],
        ...,
        [ 90, 124,  91],
        [ 84, 118,  85],
        [ 79, 112,  80]],

       [[ 69,  83,  67],
        [ 70,  83,  68],
        [ 73,  86,  72],
        ...,
        [ 96, 129,  97],
        [ 87, 121,  88],
        [ 80, 114,  81]],

       [[ 69,  81,  71],
        [ 70,  83,  71],
        [ 72,  86,  75],
        ...,
        [104, 136, 104],
        [ 92, 126,  95],
        [ 83, 117,  85]],

       ...,

       [[209, 191, 176],
        [185, 168, 152],
        [169, 151, 133],
        ...,
        [249, 233, 211],
        [251, 241, 221],
        [248, 243, 224]],

       [[142, 131, 123],
        [130, 118, 107],
        [129, 114, 100],
        ...,
        [247, 233, 212],
        [247, 237, 220],
        [248, 238, 221]],

       [[115, 112, 108],
        [112, 104,  96],
        [117, 104,  94],
        ...,
        [247, 231, 207],
        [246, 233, 214],
        [246, 234, 214]]], dtype=uint8)]"
Image_881.jpg,468,135,281,298,1600,1019,749,433,298,daskShared_local/images/Image_881.jpg,881,"[array([[[ 26, 109, 213],
        [ 26, 109, 213],
        [ 26, 109, 213],
        ...,
        [ 28, 116, 213],
        [ 28, 116, 213],
        [ 28, 116, 213]],

       [[ 26, 109, 213],
        [ 26, 109, 213],
        [ 27, 110, 214],
        ...,
        [ 28, 116, 213],
        [ 28, 116, 213],
        [ 28, 116, 213]],

       [[ 26, 109, 213],
        [ 26, 109, 213],
        [ 27, 110, 214],
        ...,
        [ 28, 116, 213],
        [ 28, 116, 213],
        [ 28, 116, 213]],

       ...,

       [[202, 208, 201],
        [190, 203, 193],
        [182, 196, 186],
        ...,
        [ 52,  11,  11],
        [ 70,  29,  30],
        [ 56,  40,  33]],

       [[176, 190, 186],
        [169, 190, 184],
        [169, 192, 183],
        ...,
        [ 48,   2,   4],
        [ 64,  18,  20],
        [ 49,  33,  26]],

       [[176, 181, 180],
        [174, 180, 180],
        [175, 179, 179],
        ...,
        [ 41,   6,   0],
        [ 41,   9,   3],
        [ 38,  20,   8]]], dtype=uint8)]"
Image_882.jpg,648,285,320,335,1600,1000,968,620,335,daskShared_local/images/Image_882.jpg,882,"[array([[[  0,  71, 161],
        [  0,  71, 161],
        [  0,  71, 162],
        ...,
        [  2,  69, 160],
        [  1,  68, 159],
        [  1,  68, 159]],

       [[  0,  71, 161],
        [  0,  71, 161],
        [  0,  71, 162],
        ...,
        [  2,  69, 160],
        [  1,  68, 159],
        [  1,  68, 159]],

       [[  0,  71, 163],
        [  0,  71, 163],
        [  0,  71, 163],
        ...,
        [  1,  68, 159],
        [  1,  68, 159],
        [  2,  69, 160]],

       ...,

       [[ 37,  43,  26],
        [ 30,  41,  24],
        [ 49,  66,  48],
        ...,
        [165, 160, 113],
        [139, 129,  82],
        [168, 153, 107]],

       [[ 32,  39,  22],
        [ 59,  70,  53],
        [ 74,  91,  69],
        ...,
        [135, 131,  89],
        [126, 119,  75],
        [147, 137,  92]],

       [[ 32,  36,  21],
        [ 41,  50,  31],
        [ 37,  52,  28],
        ...,
        [131, 128,  95],
        [132, 129,  93],
        [132, 127,  91]]], dtype=uint8)]"
Image_883.jpg,451,269,165,179,850,567,616,448,179,daskShared_local/images/Image_883.jpg,883,"[array([[[ 48,  36,  40],
        [ 56,  35,  42],
        [ 79,  50,  57],
        ...,
        [ 43,  49,  77],
        [ 97, 104, 118],
        [125, 137, 138]],

       [[ 48,  30,  31],
        [ 69,  43,  45],
        [101,  68,  72],
        ...,
        [ 33,  39,  70],
        [ 69,  81,  99],
        [132, 155, 153]],

       [[ 56,  39,  41],
        [ 91,  63,  63],
        [119,  83,  76],
        ...,
        [ 34,  41,  65],
        [ 32,  49,  70],
        [100, 127, 130]],

       ...,

       [[  8, 122, 234],
        [  7, 121, 233],
        [  9, 123, 235],
        ...,
        [ 11, 129, 235],
        [  9, 127, 233],
        [  9, 127, 233]],

       [[  8, 122, 234],
        [  8, 122, 234],
        [ 10, 124, 236],
        ...,
        [ 11, 129, 235],
        [ 10, 128, 234],
        [ 10, 128, 234]],

       [[  8, 122, 234],
        [ 10, 124, 236],
        [ 11, 125, 237],
        ...,
        [  9, 127, 233],
        [  9, 127, 233],
        [  9, 127, 233]]], dtype=uint8)]"
Image_884.jpg,3365,1259,136,113,3840,2160,3501,1372,136,daskShared_local/images/Image_884.jpg,884,"[array([[[ 20, 100, 127],
        [ 19, 100, 125],
        [ 19,  98, 123],
        ...,
        [  3,  54,  55],
        [  4,  55,  56],
        [  4,  55,  56]],

       [[ 19, 100, 126],
        [ 18,  99, 125],
        [ 17,  97, 122],
        ...,
        [  3,  55,  55],
        [  4,  55,  56],
        [  4,  55,  56]],

       [[ 22, 103, 129],
        [ 21, 102, 127],
        [ 20, 100, 124],
        ...,
        [  3,  55,  56],
        [  4,  55,  56],
        [  5,  56,  57]],

       ...,

       [[  0, 113, 163],
        [  0, 113, 163],
        [  0, 113, 163],
        ...,
        [  2, 109, 155],
        [  2, 109, 155],
        [  2, 109, 155]],

       [[  0, 113, 163],
        [  0, 113, 163],
        [  0, 113, 163],
        ...,
        [  2, 109, 155],
        [  2, 109, 155],
        [  2, 109, 155]],

       [[  0, 113, 163],
        [  0, 113, 163],
        [  0, 113, 163],
        ...,
        [  2, 109, 155],
        [  2, 109, 155],
        [  2, 109, 155]]], dtype=uint8)]"
Image_885.jpg,196,451,192,186,2015,1510,388,637,192,daskShared_local/images/Image_885.jpg,885,"[array([[[ 29,  21,  10],
        [ 31,  23,  12],
        [ 27,  19,   8],
        ...,
        [  8,  15,   8],
        [  3,  10,   3],
        [  2,   7,   1]],

       [[ 40,  32,  22],
        [ 41,  32,  23],
        [ 43,  34,  25],
        ...,
        [  4,  11,   4],
        [  1,   6,   0],
        [  0,   4,   0]],

       [[ 62,  53,  44],
        [ 59,  50,  41],
        [ 60,  51,  42],
        ...,
        [  4,   9,   3],
        [  3,   5,   0],
        [  1,   3,   0]],

       ...,

       [[115,  99,  82],
        [125, 110,  91],
        [176, 161, 142],
        ...,
        [218, 228, 227],
        [206, 216, 215],
        [177, 187, 186]],

       [[156, 141, 122],
        [162, 147, 128],
        [201, 186, 167],
        ...,
        [214, 224, 223],
        [205, 215, 214],
        [187, 197, 196]],

       [[184, 169, 150],
        [184, 169, 150],
        [207, 192, 173],
        ...,
        [216, 226, 225],
        [203, 213, 212],
        [191, 201, 200]]], dtype=uint8)]"
Image_886.jpg,356,110,208,216,1280,720,564,326,216,daskShared_local/images/Image_886.jpg,886,"[array([[[ 16, 112, 199],
        [ 18, 114, 201],
        [ 20, 116, 203],
        ...,
        [ 18, 131, 211],
        [ 21, 134, 214],
        [ 23, 136, 216]],

       [[ 16, 112, 199],
        [ 21, 117, 204],
        [ 25, 121, 208],
        ...,
        [ 21, 134, 214],
        [ 23, 136, 216],
        [ 25, 138, 218]],

       [[ 15, 109, 197],
        [ 20, 114, 202],
        [ 26, 120, 208],
        ...,
        [ 26, 139, 219],
        [ 26, 139, 219],
        [ 25, 138, 218]],

       ...,

       [[  8,  73, 165],
        [  9,  74, 166],
        [ 11,  76, 168],
        ...,
        [ 65,  60,  34],
        [148, 141, 109],
        [189, 180, 146]],

       [[ 13,  78, 170],
        [ 13,  78, 170],
        [ 14,  79, 171],
        ...,
        [ 13,   9,   3],
        [ 49,  44,  18],
        [ 86,  79,  50]],

       [[ 24,  89, 181],
        [ 25,  90, 182],
        [ 24,  89, 181],
        ...,
        [ 59,  57,  36],
        [ 16,  13,   4],
        [ 16,  10,   2]]], dtype=uint8)]"
Image_887.jpg,911,451,686,551,3008,2000,1597,1002,686,daskShared_local/images/Image_887.jpg,887,"[array([[[148, 187, 194],
        [148, 187, 194],
        [148, 187, 194],
        ...,
        [135, 177, 189],
        [136, 178, 190],
        [137, 179, 191]],

       [[148, 187, 194],
        [148, 187, 194],
        [148, 187, 194],
        ...,
        [135, 177, 189],
        [136, 178, 190],
        [137, 179, 191]],

       [[148, 187, 194],
        [148, 187, 194],
        [148, 187, 194],
        ...,
        [136, 178, 190],
        [137, 179, 191],
        [137, 179, 191]],

       ...,

       [[114, 168, 176],
        [115, 168, 176],
        [113, 166, 174],
        ...,
        [ 86,  95, 102],
        [ 76,  90,  95],
        [ 64,  82,  86]],

       [[114, 168, 176],
        [115, 168, 176],
        [115, 168, 176],
        ...,
        [ 87,  96, 103],
        [ 75,  89,  95],
        [ 64,  83,  87]],

       [[114, 168, 176],
        [115, 168, 176],
        [115, 168, 176],
        ...,
        [ 76,  86,  93],
        [ 78,  92,  97],
        [ 73,  92,  96]]], dtype=uint8)]"
Image_888.jpg,412,3,415,516,1280,720,827,519,516,daskShared_local/images/Image_888.jpg,888,"[array([[[161, 229, 239],
        [163, 229, 238],
        [159, 226, 237],
        ...,
        [ 60, 181, 209],
        [ 37, 178, 203],
        [ 27, 179, 203]],

       [[160, 228, 238],
        [161, 228, 237],
        [159, 226, 236],
        ...,
        [ 32, 177, 204],
        [ 38, 178, 208],
        [ 54, 182, 212]],

       [[158, 228, 238],
        [158, 228, 238],
        [160, 226, 239],
        ...,
        [ 42, 180, 206],
        [ 68, 185, 212],
        [ 85, 191, 217]],

       ...,

       [[ 29,  29,  16],
        [ 38,  38,  29],
        [ 77,  64,  37],
        ...,
        [  3,  73,  97],
        [  2,  72,  97],
        [  2,  72,  97]],

       [[ 84,  70,  32],
        [ 85,  70,  35],
        [110,  88,  50],
        ...,
        [  2,  73,  95],
        [  2,  72,  97],
        [  1,  71,  96]],

       [[115,  93,  53],
        [119,  93,  55],
        [123,  95,  56],
        ...,
        [  2,  73,  96],
        [  1,  71,  96],
        [  0,  70,  95]]], dtype=uint8)]"
Image_889.jpg,401,1005,839,598,4601,3200,1240,1603,839,daskShared_local/images/Image_889.jpg,889,"[array([[[ 34, 152, 237],
        [ 39, 167, 242],
        [ 36, 167, 243],
        ...,
        [ 48, 156, 229],
        [ 48, 155, 226],
        [ 47, 156, 224]],

       [[ 38, 159, 237],
        [ 39, 162, 240],
        [ 35, 158, 229],
        ...,
        [ 50, 163, 228],
        [ 49, 168, 226],
        [ 48, 166, 224]],

       [[ 30, 161, 239],
        [ 29, 163, 244],
        [ 30, 161, 238],
        ...,
        [ 48, 161, 243],
        [ 41, 154, 232],
        [ 37, 153, 231]],

       ...,

       [[ 34, 162, 224],
        [ 28, 154, 213],
        [ 22, 149, 210],
        ...,
        [ 44, 153, 210],
        [ 45, 150, 208],
        [ 49, 149, 212]],

       [[ 26, 156, 223],
        [ 24, 153, 219],
        [ 20, 151, 216],
        ...,
        [ 47, 156, 211],
        [ 44, 150, 206],
        [ 50, 153, 218]],

       [[ 19, 151, 219],
        [ 20, 150, 217],
        [ 22, 151, 219],
        ...,
        [ 48, 160, 212],
        [ 47, 158, 209],
        [ 45, 151, 208]]], dtype=uint8)]"
Image_89.jpg,315,291,145,100,1280,720,460,391,145,daskShared_local/images/Image_89.jpg,89,"[array([[[  0,  60, 133],
        [  0,  60, 133],
        [  0,  60, 133],
        ...,
        [  0,  62, 139],
        [  0,  62, 139],
        [  0,  62, 139]],

       [[  0,  60, 133],
        [  0,  60, 133],
        [  0,  60, 133],
        ...,
        [  0,  62, 139],
        [  0,  62, 139],
        [  0,  62, 139]],

       [[  0,  60, 133],
        [  0,  60, 133],
        [  0,  60, 133],
        ...,
        [  0,  62, 139],
        [  0,  62, 139],
        [  0,  62, 139]],

       ...,

       [[ 33, 108, 131],
        [ 33, 108, 131],
        [ 33, 108, 131],
        ...,
        [ 22,  98, 130],
        [ 22,  98, 130],
        [ 22,  98, 130]],

       [[ 35, 110, 133],
        [ 35, 110, 133],
        [ 35, 110, 133],
        ...,
        [ 22,  98, 130],
        [ 23,  98, 130],
        [ 23,  98, 130]],

       [[ 36, 111, 134],
        [ 36, 111, 134],
        [ 36, 111, 134],
        ...,
        [ 23,  98, 130],
        [ 23,  98, 130],
        [ 24,  99, 131]]], dtype=uint8)]"
Image_890.jpg,605,302,209,169,1400,933,814,471,209,daskShared_local/images/Image_890.jpg,890,"[array([[[  1, 172, 228],
        [  1, 172, 228],
        [  1, 172, 228],
        ...,
        [  1, 213, 251],
        [  0, 212, 250],
        [  2, 211, 250]],

       [[  1, 172, 228],
        [  1, 172, 228],
        [  1, 172, 228],
        ...,
        [  0, 212, 250],
        [  0, 212, 250],
        [  1, 210, 249]],

       [[  1, 172, 228],
        [  1, 172, 228],
        [  1, 172, 228],
        ...,
        [  2, 211, 250],
        [  1, 210, 249],
        [  1, 210, 249]],

       ...,

       [[213, 187, 138],
        [224, 212, 167],
        [250, 247, 222],
        ...,
        [  1, 180, 236],
        [  1, 180, 236],
        [  1, 180, 236]],

       [[219, 196, 154],
        [209, 190, 161],
        [233, 221, 191],
        ...,
        [  1, 180, 236],
        [  1, 180, 236],
        [  1, 180, 236]],

       [[253, 246, 211],
        [217, 200, 169],
        [190, 169, 126],
        ...,
        [  1, 180, 236],
        [  1, 180, 236],
        [  1, 180, 236]]], dtype=uint8)]"
Image_891.jpg,100,253,150,129,900,600,250,382,150,daskShared_local/images/Image_891.jpg,891,"[array([[[  5,  79,  95],
        [  5,  82,  95],
        [  5,  85,  94],
        ...,
        [  2,  88, 100],
        [  1,  87, 100],
        [  0,  86,  99]],

       [[  3,  77,  91],
        [  2,  77,  89],
        [  2,  78,  87],
        ...,
        [  1,  87,  99],
        [  1,  87, 100],
        [  0,  86,  99]],

       [[  1,  75,  87],
        [  0,  73,  84],
        [  0,  72,  81],
        ...,
        [  1,  87,  99],
        [  0,  86,  99],
        [  0,  86,  99]],

       ...,

       [[  0,  66,  75],
        [  0,  66,  76],
        [  0,  65,  76],
        ...,
        [ 12,  41,  35],
        [ 12,  40,  31],
        [ 13,  39,  31]],

       [[  0,  66,  75],
        [  0,  66,  75],
        [  0,  65,  75],
        ...,
        [ 12,  41,  34],
        [ 12,  40,  31],
        [ 14,  40,  31]],

       [[  0,  66,  75],
        [  0,  65,  74],
        [  0,  65,  74],
        ...,
        [ 13,  42,  35],
        [ 12,  41,  31],
        [ 14,  41,  32]]], dtype=uint8)]"
Image_892.jpg,210,34,208,184,900,521,418,218,208,daskShared_local/images/Image_892.jpg,892,"[array([[[ 16,  58, 170],
        [ 16,  58, 170],
        [ 16,  58, 170],
        ...,
        [ 33,  70, 185],
        [ 32,  69, 184],
        [ 32,  69, 184]],

       [[ 16,  58, 170],
        [ 16,  58, 170],
        [ 16,  58, 170],
        ...,
        [ 33,  70, 185],
        [ 32,  69, 184],
        [ 32,  69, 184]],

       [[ 15,  57, 169],
        [ 15,  57, 169],
        [ 16,  58, 170],
        ...,
        [ 31,  68, 183],
        [ 31,  68, 183],
        [ 31,  68, 183]],

       ...,

       [[  2,  54, 140],
        [  2,  54, 140],
        [  2,  54, 140],
        ...,
        [144, 161, 153],
        [191, 208, 202],
        [212, 229, 223]],

       [[  2,  54, 140],
        [  2,  54, 140],
        [  2,  54, 140],
        ...,
        [157, 174, 166],
        [191, 208, 202],
        [208, 225, 219]],

       [[  0,  54, 140],
        [  0,  54, 140],
        [  0,  54, 140],
        ...,
        [174, 191, 183],
        [190, 207, 201],
        [204, 221, 215]]], dtype=uint8)]"
Image_893.jpg,689,185,198,147,1000,600,887,332,198,daskShared_local/images/Image_893.jpg,893,"[array([[[  5, 153, 199],
        [  0, 151, 196],
        [  1, 152, 197],
        ...,
        [  2, 145, 205],
        [  3, 146, 206],
        [  4, 147, 207]],

       [[  4, 152, 200],
        [  0, 151, 198],
        [  0, 152, 199],
        ...,
        [  2, 145, 205],
        [  2, 145, 205],
        [  1, 144, 204]],

       [[  1, 152, 199],
        [  1, 152, 199],
        [  1, 153, 200],
        ...,
        [  1, 144, 204],
        [  1, 144, 204],
        [  0, 143, 203]],

       ...,

       [[ 55,  37,  15],
        [111,  95,  70],
        [151, 137, 108],
        ...,
        [165, 161, 160],
        [209, 205, 204],
        [227, 224, 219]],

       [[125, 111,  76],
        [178, 165, 131],
        [204, 193, 163],
        ...,
        [185, 180, 184],
        [233, 228, 234],
        [255, 254, 255]],

       [[172, 164, 117],
        [180, 172, 133],
        [188, 179, 148],
        ...,
        [226, 221, 225],
        [237, 232, 239],
        [248, 243, 250]]], dtype=uint8)]"
Image_894.jpg,377,311,377,263,1904,803,754,574,377,daskShared_local/images/Image_894.jpg,894,"[array([[[ 47, 159, 155],
        [ 43, 159, 156],
        [ 36, 157, 152],
        ...,
        [155, 210, 211],
        [128, 205, 200],
        [111, 187, 178]],

       [[ 38, 158, 150],
        [ 33, 153, 148],
        [ 30, 148, 149],
        ...,
        [119, 219, 221],
        [ 63, 183, 185],
        [ 72, 175, 163]],

       [[ 23, 146, 136],
        [ 24, 146, 140],
        [ 28, 149, 148],
        ...,
        [ 58, 151, 160],
        [ 83, 190, 199],
        [136, 232, 226]],

       ...,

       [[  0,  41,  76],
        [  0,  44,  76],
        [  0,  46,  76],
        ...,
        [  5,  41,  93],
        [ 11,  43,  97],
        [  2,  44,  94]],

       [[  0,  41,  79],
        [  0,  44,  78],
        [  0,  46,  78],
        ...,
        [  4,  42,  94],
        [  6,  43,  95],
        [  2,  44,  94]],

       [[  4,  46,  86],
        [  5,  49,  85],
        [  5,  50,  85],
        ...,
        [  4,  45,  95],
        [  2,  43,  94],
        [  2,  44,  94]]], dtype=uint8)]"
Image_895.jpg,264,199,209,132,1000,667,473,331,209,daskShared_local/images/Image_895.jpg,895,"[array([[[  1,  74, 179],
        [  1,  74, 179],
        [  2,  75, 178],
        ...,
        [  2,  51, 130],
        [  1,  50, 129],
        [  2,  49, 131]],

       [[  1,  74, 179],
        [  0,  72, 180],
        [  0,  72, 180],
        ...,
        [  3,  49, 135],
        [  2,  48, 136],
        [  1,  49, 133]],

       [[  1,  74, 178],
        [  1,  74, 178],
        [  2,  72, 180],
        ...,
        [  0,  46, 132],
        [  2,  48, 133],
        [  1,  49, 134]],

       ...,

       [[ 94, 123,  87],
        [ 86, 114,  82],
        [100, 122, 103],
        ...,
        [ 87, 100,  72],
        [ 90, 102,  78],
        [ 74,  77,  60]],

       [[ 83, 105,  67],
        [ 74,  95,  65],
        [ 75,  99,  73],
        ...,
        [ 88,  98,  76],
        [ 63,  74,  59],
        [142, 154, 141]],

       [[ 87, 109,  58],
        [ 76,  93,  58],
        [ 80, 106,  76],
        ...,
        [104, 111,  98],
        [104, 112,  99],
        [121, 130, 125]]], dtype=uint8)]"
Image_896.jpg,509,79,150,200,1200,630,659,279,200,daskShared_local/images/Image_896.jpg,896,"[array([[[  0, 157, 224],
        [  0, 157, 224],
        [  0, 157, 224],
        ...,
        [  5, 157, 224],
        [  5, 157, 224],
        [  4, 156, 223]],

       [[  4, 157, 224],
        [  4, 157, 224],
        [  4, 157, 224],
        ...,
        [  3, 155, 222],
        [  3, 155, 222],
        [  3, 155, 222]],

       [[  4, 157, 224],
        [  4, 157, 224],
        [  4, 157, 224],
        ...,
        [  3, 155, 222],
        [  3, 155, 222],
        [  3, 155, 222]],

       ...,

       [[ 55,  39,  42],
        [112,  96,  99],
        [ 78,  63,  66],
        ...,
        [  5,  85, 122],
        [  2,  84, 121],
        [  1,  83, 120]],

       [[ 47,  31,  34],
        [ 68,  53,  56],
        [ 62,  47,  50],
        ...,
        [  7,  87, 124],
        [  4,  84, 121],
        [  0,  82, 119]],

       [[ 33,  18,  21],
        [ 11,   0,   0],
        [ 25,  11,  14],
        ...,
        [  6,  86, 123],
        [  3,  83, 120],
        [  1,  81, 118]]], dtype=uint8)]"
Image_897.jpg,364,21,152,149,550,380,516,170,152,daskShared_local/images/Image_897.jpg,897,"[array([[[ 76,  95, 151],
        [ 76,  95, 151],
        [ 76,  95, 151],
        ...,
        [ 69,  84, 143],
        [ 69,  84, 143],
        [ 69,  84, 143]],

       [[ 76,  95, 151],
        [ 76,  95, 151],
        [ 76,  95, 151],
        ...,
        [ 69,  84, 143],
        [ 69,  84, 143],
        [ 69,  84, 143]],

       [[ 76,  95, 151],
        [ 76,  95, 151],
        [ 76,  95, 151],
        ...,
        [ 69,  84, 143],
        [ 69,  84, 143],
        [ 69,  84, 143]],

       ...,

       [[127, 102,  80],
        [138, 115,  92],
        [152, 131, 107],
        ...,
        [ 65,  79, 140],
        [ 64,  78, 139],
        [ 64,  78, 139]],

       [[121,  96,  75],
        [136, 113,  91],
        [161, 139, 117],
        ...,
        [ 65,  79, 140],
        [ 64,  78, 139],
        [ 64,  78, 139]],

       [[103,  79,  58],
        [124, 101,  80],
        [163, 141, 119],
        ...,
        [ 64,  78, 139],
        [ 64,  78, 139],
        [ 64,  78, 139]]], dtype=uint8)]"
Image_898.jpg,508,79,315,445,1600,900,823,524,445,daskShared_local/images/Image_898.jpg,898,"[array([[[  0, 152, 208],
        [  0, 153, 209],
        [  0, 154, 208],
        ...,
        [156, 201, 242],
        [156, 201, 242],
        [156, 201, 242]],

       [[  0, 153, 210],
        [  0, 153, 210],
        [  0, 154, 208],
        ...,
        [156, 201, 242],
        [156, 201, 242],
        [155, 200, 241]],

       [[  0, 153, 210],
        [  0, 153, 210],
        [  0, 154, 208],
        ...,
        [156, 201, 242],
        [156, 201, 242],
        [156, 201, 242]],

       ...,

       [[  1, 139, 202],
        [  1, 139, 202],
        [  0, 140, 201],
        ...,
        [ 69,  69,  69],
        [109,  94,  85],
        [132, 110,  86]],

       [[  0, 138, 201],
        [  1, 139, 202],
        [  1, 140, 202],
        ...,
        [ 96,  87,  81],
        [128, 104,  87],
        [149, 116,  85]],

       [[  0, 138, 201],
        [  1, 139, 202],
        [  1, 140, 202],
        ...,
        [125, 110,  95],
        [141, 113,  91],
        [159, 124,  92]]], dtype=uint8)]"
Image_899.jpg,1266,1015,393,438,2592,1944,1659,1453,438,daskShared_local/images/Image_899.jpg,899,"[array([[[247, 237, 206],
        [249, 246, 214],
        [237, 235, 195],
        ...,
        [ 45, 113, 168],
        [ 45, 112, 167],
        [ 42, 114, 168]],

       [[252, 246, 228],
        [244, 244, 228],
        [246, 248, 221],
        ...,
        [ 45, 116, 170],
        [ 45, 114, 169],
        [ 40, 115, 170]],

       [[248, 243, 235],
        [243, 243, 241],
        [244, 245, 237],
        ...,
        [ 42, 115, 168],
        [ 44, 115, 169],
        [ 39, 115, 169]],

       ...,

       [[ 38, 119, 166],
        [ 43, 118, 166],
        [ 40, 118, 164],
        ...,
        [ 37, 120, 165],
        [ 37, 119, 164],
        [ 39, 117, 165]],

       [[ 40, 118, 166],
        [ 44, 117, 167],
        [ 40, 118, 166],
        ...,
        [ 38, 121, 165],
        [ 38, 120, 165],
        [ 40, 118, 165]],

       [[ 43, 117, 166],
        [ 46, 115, 166],
        [ 39, 117, 166],
        ...,
        [ 36, 118, 165],
        [ 37, 119, 166],
        [ 40, 118, 166]]], dtype=uint8)]"
Image_9.jpg,382,136,226,203,869,574,608,339,226,daskShared_local/images/Image_9.jpg,9,"[array([[[  2, 145, 215],
        [  2, 147, 216],
        [  5, 149, 217],
        ...,
        [ 77, 164, 241],
        [ 76, 165, 241],
        [ 75, 167, 244]],

       [[  1, 145, 215],
        [  0, 146, 215],
        [  0, 146, 215],
        ...,
        [ 79, 165, 242],
        [ 79, 165, 242],
        [ 79, 166, 243]],

       [[  1, 143, 213],
        [  0, 142, 212],
        [  0, 143, 213],
        ...,
        [ 78, 164, 241],
        [ 77, 162, 240],
        [ 76, 161, 238]],

       ...,

       [[  3,  13,   8],
        [  9,  27,  18],
        [  8,  32,  21],
        ...,
        [  0, 106, 180],
        [  0, 106, 180],
        [  0, 106, 180]],

       [[  4,  70,  47],
        [ 18,  93,  67],
        [ 17,  89,  62],
        ...,
        [  0, 106, 180],
        [  0, 106, 180],
        [  0, 106, 180]],

       [[ 33, 108,  84],
        [ 17, 100,  73],
        [  2,  82,  53],
        ...,
        [  0, 105, 179],
        [  0, 105, 179],
        [  0, 105, 179]]], dtype=uint8)]"
Image_90.jpg,342,22,622,504,1190,595,964,526,622,daskShared_local/images/Image_90.jpg,90,"[array([[[220, 238, 248],
        [223, 242, 250],
        [224, 243, 251],
        ...,
        [204, 217, 207],
        [201, 217, 206],
        [200, 215, 206]],

       [[206, 225, 235],
        [216, 234, 244],
        [217, 235, 245],
        ...,
        [203, 217, 207],
        [203, 217, 207],
        [203, 216, 207]],

       [[192, 212, 222],
        [207, 225, 235],
        [211, 229, 239],
        ...,
        [204, 216, 207],
        [204, 215, 207],
        [203, 216, 206]],

       ...,

       [[ 39,  20,  24],
        [ 45,  32,  34],
        [ 38,  27,  31],
        ...,
        [164,  95,  83],
        [170, 104,  87],
        [175, 111, 100]],

       [[ 28,  19,  25],
        [ 48,  38,  38],
        [ 47,  32,  34],
        ...,
        [163,  90,  75],
        [168, 107,  86],
        [172, 119, 102]],

       [[ 27,  16,  22],
        [ 40,  25,  24],
        [ 54,  37,  35],
        ...,
        [161,  88,  70],
        [169, 104,  88],
        [169, 116,  99]]], dtype=uint8)]"
Image_900.jpg,972,390,200,189,2000,1000,1172,579,200,daskShared_local/images/Image_900.jpg,900,"[array([[[203, 183, 148],
        [202, 182, 147],
        [205, 185, 150],
        ...,
        [204, 182, 145],
        [206, 182, 144],
        [210, 187, 146]],

       [[207, 187, 152],
        [209, 189, 154],
        [211, 191, 156],
        ...,
        [205, 185, 150],
        [205, 183, 146],
        [207, 185, 146]],

       [[208, 188, 151],
        [211, 191, 156],
        [212, 192, 157],
        ...,
        [204, 186, 150],
        [203, 183, 148],
        [207, 187, 150]],

       ...,

       [[165, 163, 150],
        [189, 186, 171],
        [187, 184, 169],
        ...,
        [184, 158, 121],
        [203, 175, 138],
        [203, 173, 137]],

       [[165, 163, 150],
        [189, 187, 174],
        [183, 179, 167],
        ...,
        [190, 155, 125],
        [177, 142, 110],
        [179, 145, 108]],

       [[121, 119, 104],
        [160, 157, 143],
        [183, 180, 165],
        ...,
        [202, 169, 136],
        [188, 154, 116],
        [186, 153, 112]]], dtype=uint8)]"
Image_901.jpg,111,141,400,308,1152,768,511,449,400,daskShared_local/images/Image_901.jpg,901,"[array([[[181, 233, 225],
        [181, 233, 224],
        [182, 233, 224],
        ...,
        [187, 241, 235],
        [188, 242, 235],
        [190, 243, 235]],

       [[183, 233, 225],
        [183, 233, 224],
        [183, 233, 224],
        ...,
        [179, 237, 231],
        [182, 238, 232],
        [184, 240, 233]],

       [[183, 233, 225],
        [183, 233, 224],
        [183, 233, 224],
        ...,
        [173, 235, 230],
        [176, 236, 231],
        [178, 239, 232]],

       ...,

       [[ 83, 171, 185],
        [ 83, 171, 184],
        [ 84, 172, 185],
        ...,
        [121, 145, 131],
        [118, 141, 125],
        [110, 131, 113]],

       [[ 75, 167, 183],
        [ 75, 168, 184],
        [ 76, 167, 183],
        ...,
        [121, 144, 130],
        [113, 134, 116],
        [117, 134, 112]],

       [[ 66, 162, 181],
        [ 67, 162, 183],
        [ 69, 163, 184],
        ...,
        [125, 146, 133],
        [119, 139, 124],
        [122, 140, 123]]], dtype=uint8)]"
Image_902.jpg,1002,130,2622,2675,4608,3072,3624,2805,2675,daskShared_local/images/Image_902.jpg,902,"[array([[[ 46,  46,  45],
        [ 44,  44,  42],
        [ 43,  43,  41],
        ...,
        [170, 164, 121],
        [170, 163, 120],
        [169, 163, 120]],

       [[ 44,  45,  43],
        [ 41,  41,  39],
        [ 37,  37,  35],
        ...,
        [169, 163, 121],
        [169, 162, 119],
        [169, 163, 117]],

       [[ 38,  39,  36],
        [ 35,  35,  33],
        [ 32,  32,  30],
        ...,
        [163, 158, 121],
        [166, 161, 118],
        [167, 161, 117]],

       ...,

       [[ 87,  70,  37],
        [ 88,  71,  38],
        [ 86,  70,  42],
        ...,
        [176, 150,  84],
        [173, 149,  98],
        [173, 156, 113]],

       [[ 82,  67,  37],
        [ 82,  67,  35],
        [ 82,  66,  34],
        ...,
        [162, 146, 106],
        [159, 142, 106],
        [159, 144, 115]],

       [[ 77,  60,  33],
        [ 78,  62,  31],
        [ 79,  63,  31],
        ...,
        [162, 139,  91],
        [157, 129,  87],
        [153, 125,  92]]], dtype=uint8)]"
Image_903.jpg,629,224,127,107,1000,667,756,331,127,daskShared_local/images/Image_903.jpg,903,"[array([[[ 57, 106, 110],
        [ 57, 105, 110],
        [ 58, 104, 109],
        ...,
        [ 27, 106, 115],
        [ 18, 101, 110],
        [ 14,  99, 108]],

       [[ 56, 103, 108],
        [ 56, 102, 107],
        [ 57, 101, 106],
        ...,
        [ 31, 109, 118],
        [ 22, 104, 113],
        [ 18, 101, 110]],

       [[ 55,  97, 103],
        [ 55,  96, 102],
        [ 54,  94, 100],
        ...,
        [ 40, 116, 123],
        [ 32, 110, 118],
        [ 28, 107, 116]],

       ...,

       [[137, 137, 109],
        [135, 135, 107],
        [129, 128, 100],
        ...,
        [ 91, 171, 180],
        [ 90, 170, 178],
        [ 90, 169, 177]],

       [[131, 132, 103],
        [132, 133, 105],
        [135, 133, 106],
        ...,
        [ 91, 171, 179],
        [ 90, 170, 177],
        [ 90, 169, 176]],

       [[126, 128,  99],
        [130, 130, 102],
        [136, 135, 107],
        ...,
        [ 91, 171, 178],
        [ 90, 169, 177],
        [ 90, 169, 176]]], dtype=uint8)]"
Image_904.jpg,214,207,138,158,800,600,352,365,158,daskShared_local/images/Image_904.jpg,904,"[array([[[ 76, 191, 212],
        [ 76, 191, 212],
        [ 76, 190, 211],
        ...,
        [ 28, 169, 196],
        [ 29, 168, 196],
        [ 29, 167, 195]],

       [[ 75, 190, 211],
        [ 75, 190, 211],
        [ 75, 190, 210],
        ...,
        [ 28, 168, 195],
        [ 30, 167, 195],
        [ 29, 167, 195]],

       [[ 75, 190, 211],
        [ 75, 190, 211],
        [ 74, 190, 210],
        ...,
        [ 27, 166, 194],
        [ 28, 166, 194],
        [ 28, 166, 194]],

       ...,

       [[ 19, 130, 120],
        [ 23, 132, 122],
        [ 24, 131, 120],
        ...,
        [235, 205, 162],
        [232, 201, 158],
        [225, 195, 138]],

       [[ 22, 127, 116],
        [ 24, 129, 117],
        [ 25, 129, 116],
        ...,
        [238, 208, 161],
        [232, 200, 151],
        [228, 197, 142]],

       [[ 25, 127, 114],
        [ 25, 127, 114],
        [ 27, 127, 114],
        ...,
        [237, 207, 156],
        [233, 201, 144],
        [233, 203, 142]]], dtype=uint8)]"
Image_905.png,384,51,170,156,600,600,554,207,170,daskShared_local/images/Image_905.png,905,"[array([[[  0, 105, 249],
        [  0, 104, 248],
        [  0, 103, 247],
        ...,
        [  0, 118, 254],
        [  0, 118, 254],
        [  0, 118, 254]],

       [[  0, 105, 249],
        [  0, 104, 248],
        [  0, 104, 248],
        ...,
        [  0, 117, 255],
        [  1, 117, 254],
        [  1, 117, 254]],

       [[  1, 106, 250],
        [  1, 106, 250],
        [  1, 106, 250],
        ...,
        [  0, 117, 255],
        [  1, 117, 254],
        [  1, 117, 254]],

       ...,

       [[215, 196,  90],
        [225, 198, 118],
        [204, 167,  90],
        ...,
        [237, 249, 236],
        [236, 247, 222],
        [242, 248, 215]],

       [[163, 138,  62],
        [189, 176,  77],
        [211, 195, 112],
        ...,
        [240, 252, 241],
        [239, 250, 239],
        [236, 243, 224]],

       [[107,  73,  63],
        [123,  98,  42],
        [180, 166, 102],
        ...,
        [242, 251, 239],
        [238, 247, 238],
        [244, 247, 238]]], dtype=uint8)]"
Image_906.jpg,608,78,208,175,1068,601,816,253,208,daskShared_local/images/Image_906.jpg,906,"[array([[[  0,  73, 255],
        [  0,  73, 255],
        [  0,  73, 255],
        ...,
        [  0,  88, 255],
        [  0,  88, 255],
        [  0,  88, 255]],

       [[  0,  73, 253],
        [  0,  73, 253],
        [  0,  73, 253],
        ...,
        [  0,  88, 255],
        [  0,  88, 255],
        [  0,  88, 255]],

       [[  0,  71, 254],
        [  0,  71, 254],
        [  0,  71, 254],
        ...,
        [  2,  87, 255],
        [  2,  87, 255],
        [  2,  87, 255]],

       ...,

       [[103,  87,  65],
        [127, 110, 114],
        [ 90,  72,  92],
        ...,
        [ 51, 105, 209],
        [  4,  65, 197],
        [ 22,  91, 238]],

       [[141, 129,  87],
        [106,  93,  80],
        [130, 116, 119],
        ...,
        [146, 190, 252],
        [ 58, 110, 209],
        [  4,  61, 174]],

       [[185, 171, 109],
        [177, 158, 127],
        [118,  98,  86],
        ...,
        [200, 233, 254],
        [147, 187, 246],
        [ 54,  97, 166]]], dtype=uint8)]"
Image_907.jpg,428,148,231,197,1000,667,659,345,231,daskShared_local/images/Image_907.jpg,907,"[array([[[ 36, 178, 250],
        [ 35, 178, 251],
        [ 35, 178, 252],
        ...,
        [  0, 138, 219],
        [  0, 139, 220],
        [  0, 139, 220]],

       [[ 38, 180, 251],
        [ 35, 178, 250],
        [ 33, 177, 250],
        ...,
        [  0, 137, 218],
        [  1, 138, 219],
        [  1, 140, 219]],

       [[ 40, 183, 252],
        [ 36, 178, 251],
        [ 33, 176, 250],
        ...,
        [  0, 136, 218],
        [  0, 137, 218],
        [  0, 137, 218]],

       ...,

       [[187, 157,  94],
        [210, 192, 132],
        [218, 201, 144],
        ...,
        [  0,  61, 105],
        [  0,  61, 105],
        [  0,  61, 105]],

       [[192, 163,  97],
        [212, 193, 132],
        [221, 206, 147],
        ...,
        [  0,  60, 105],
        [  1,  59, 103],
        [  2,  60, 105]],

       [[202, 182, 122],
        [217, 202, 146],
        [224, 211, 156],
        ...,
        [  0,  60, 103],
        [  0,  61, 103],
        [  0,  62, 103]]], dtype=uint8)]"
Image_908.jpg,417,138,735,625,1152,763,1152,763,735,daskShared_local/images/Image_908.jpg,908,"[array([[[  1, 180, 236],
        [  0, 179, 235],
        [  2, 181, 237],
        ...,
        [  0, 183, 237],
        [  0, 183, 237],
        [  0, 183, 237]],

       [[  2, 181, 237],
        [  2, 181, 237],
        [  1, 180, 236],
        ...,
        [  0, 183, 237],
        [  0, 183, 237],
        [  0, 183, 237]],

       [[  2, 181, 237],
        [  2, 181, 237],
        [  0, 179, 235],
        ...,
        [  0, 183, 237],
        [  0, 183, 237],
        [  0, 183, 237]],

       ...,

       [[152, 177, 145],
        [149, 175, 142],
        [146, 171, 139],
        ...,
        [190, 203, 180],
        [170, 192, 177],
        [151, 180, 149]],

       [[154, 179, 149],
        [154, 179, 148],
        [152, 177, 145],
        ...,
        [170, 192, 183],
        [155, 183, 165],
        [142, 176, 145]],

       [[155, 180, 150],
        [156, 181, 152],
        [156, 181, 152],
        ...,
        [149, 181, 174],
        [134, 170, 160],
        [128, 162, 131]]], dtype=uint8)]"
Image_909.jpg,524,227,181,210,990,681,705,437,210,daskShared_local/images/Image_909.jpg,909,"[array([[[ 20,  23,   4],
        [ 20,  23,   4],
        [ 21,  22,   4],
        ...,
        [ 28,  15,   6],
        [ 34,  20,   9],
        [ 39,  22,  12]],

       [[ 22,  23,   5],
        [ 21,  22,   4],
        [ 21,  22,   4],
        ...,
        [ 31,  14,   4],
        [ 36,  20,   7],
        [ 41,  23,   9]],

       [[ 24,  24,   6],
        [ 23,  23,   5],
        [ 24,  22,   7],
        ...,
        [ 33,  15,   2],
        [ 38,  21,   5],
        [ 43,  24,   7]],

       ...,

       [[144, 145, 114],
        [145, 146, 114],
        [149, 145, 110],
        ...,
        [ 43,  53,  27],
        [ 48,  58,  31],
        [ 48,  58,  31]],

       [[139, 137, 102],
        [138, 135, 100],
        [136, 131,  95],
        ...,
        [ 50,  60,  35],
        [ 48,  58,  31],
        [ 43,  55,  27]],

       [[137, 132,  94],
        [126, 121,  81],
        [126, 118,  81],
        ...,
        [ 55,  65,  40],
        [ 50,  62,  36],
        [ 48,  61,  35]]], dtype=uint8)]"
Image_91.jpg,1620,539,885,706,4100,2660,2505,1245,885,daskShared_local/images/Image_91.jpg,91,"[array([[[191, 181, 171],
        [195, 183, 172],
        [193, 180, 167],
        ...,
        [151, 139, 124],
        [150, 138, 124],
        [148, 136, 122]],

       [[189, 177, 167],
        [194, 181, 171],
        [197, 184, 172],
        ...,
        [151, 138, 126],
        [148, 135, 119],
        [151, 138, 122]],

       [[192, 178, 167],
        [188, 176, 161],
        [195, 182, 171],
        ...,
        [151, 138, 122],
        [155, 142, 125],
        [154, 141, 125]],

       ...,

       [[168, 151, 134],
        [172, 155, 138],
        [177, 161, 145],
        ...,
        [129, 112,  82],
        [120, 104,  71],
        [128, 111,  83]],

       [[173, 157, 143],
        [174, 158, 146],
        [172, 157, 140],
        ...,
        [131, 114,  88],
        [127, 109,  79],
        [133, 114,  82]],

       [[174, 161, 146],
        [173, 162, 148],
        [168, 156, 141],
        ...,
        [124, 106,  76],
        [120, 103,  72],
        [122, 105,  74]]], dtype=uint8)]"
Image_910.jpg,491,161,106,83,660,438,597,244,106,daskShared_local/images/Image_910.jpg,910,"[array([[[  6,  32,  74],
        [  6,  32,  75],
        [  6,  34,  77],
        ...,
        [ 28,  42,  77],
        [ 18,  33,  69],
        [ 17,  32,  68]],

       [[  6,  32,  73],
        [  6,  32,  74],
        [  7,  35,  76],
        ...,
        [ 28,  42,  78],
        [ 18,  33,  69],
        [ 17,  32,  68]],

       [[  5,  35,  66],
        [  6,  36,  67],
        [ 11,  42,  72],
        ...,
        [ 32,  46,  81],
        [ 21,  35,  70],
        [ 19,  33,  69]],

       ...,

       [[ 74,  93,  88],
        [ 86, 104,  99],
        [177, 189, 182],
        ...,
        [ 27,  18,  42],
        [ 22,  16,  39],
        [ 21,  16,  38]],

       [[ 31,  47,  65],
        [ 35,  50,  67],
        [ 65,  72,  81],
        ...,
        [ 28,  19,  43],
        [ 23,  17,  40],
        [ 22,  17,  40]],

       [[ 26,  41,  62],
        [ 28,  43,  63],
        [ 50,  57,  68],
        ...,
        [ 28,  19,  43],
        [ 23,  17,  40],
        [ 22,  17,  40]]], dtype=uint8)]"
Image_911.jpg,379,151,127,139,900,600,506,290,139,daskShared_local/images/Image_911.jpg,911,"[array([[[ 35, 105, 178],
        [ 25, 102, 175],
        [ 12, 101, 173],
        ...,
        [  0, 120, 201],
        [  1, 119, 200],
        [  1, 118, 200]],

       [[ 19,  98, 173],
        [ 13,  98, 172],
        [  6,  99, 173],
        ...,
        [  1, 121, 201],
        [  2, 122, 201],
        [  3, 123, 202]],

       [[  0,  92, 169],
        [  0,  94, 170],
        [  0,  98, 173],
        ...,
        [  1, 120, 200],
        [  8, 125, 202],
        [ 15, 129, 204]],

       ...,

       [[  0, 107, 191],
        [  0, 109, 193],
        [  0, 111, 196],
        ...,
        [141, 110, 128],
        [137, 106, 125],
        [135, 104, 122]],

       [[  1, 106, 191],
        [  0, 108, 192],
        [  0, 110, 195],
        ...,
        [140, 109, 125],
        [135, 104, 121],
        [133, 101, 118]],

       [[  1, 106, 191],
        [  1, 108, 193],
        [  0, 110, 195],
        ...,
        [140, 108, 123],
        [134, 102, 118],
        [131,  99, 116]]], dtype=uint8)]"
Image_912.jpg,410,125,121,100,759,422,531,225,121,daskShared_local/images/Image_912.jpg,912,"[array([[[114, 184, 185],
        [116, 186, 187],
        [123, 193, 193],
        ...,
        [ 29, 140, 156],
        [ 40, 152, 168],
        [ 43, 156, 173]],

       [[118, 188, 189],
        [120, 190, 191],
        [125, 195, 195],
        ...,
        [ 28, 141, 157],
        [ 36, 150, 166],
        [ 39, 153, 170]],

       [[129, 199, 200],
        [129, 199, 200],
        [131, 201, 201],
        ...,
        [ 26, 143, 160],
        [ 25, 144, 161],
        [ 25, 145, 161]],

       ...,

       [[  0, 154, 185],
        [  0, 154, 185],
        [  0, 155, 186],
        ...,
        [  3, 139, 161],
        [  2, 138, 160],
        [  2, 138, 160]],

       [[  0, 154, 185],
        [  0, 154, 185],
        [  0, 154, 185],
        ...,
        [  3, 138, 160],
        [  2, 138, 160],
        [  2, 138, 160]],

       [[  0, 154, 185],
        [  0, 154, 185],
        [  0, 154, 185],
        ...,
        [  3, 138, 160],
        [  2, 138, 160],
        [  2, 137, 159]]], dtype=uint8)]"
Image_913.jpg,472,149,239,283,981,650,711,432,283,daskShared_local/images/Image_913.jpg,913,"[array([[[245, 245, 245],
        [245, 245, 245],
        [245, 245, 245],
        ...,
        [243, 243, 243],
        [243, 243, 243],
        [243, 243, 243]],

       [[244, 244, 244],
        [244, 244, 244],
        [244, 244, 244],
        ...,
        [243, 243, 243],
        [243, 243, 243],
        [243, 243, 243]],

       [[244, 244, 244],
        [244, 244, 244],
        [244, 244, 244],
        ...,
        [243, 243, 243],
        [243, 243, 243],
        [243, 243, 243]],

       ...,

       [[ 27,  94, 173],
        [ 26,  93, 172],
        [ 26,  93, 172],
        ...,
        [ 23,  90, 169],
        [ 25,  92, 171],
        [ 26,  93, 172]],

       [[ 26,  93, 172],
        [ 25,  92, 171],
        [ 25,  92, 171],
        ...,
        [ 23,  90, 168],
        [ 25,  92, 171],
        [ 28,  95, 174]],

       [[ 26,  93, 172],
        [ 25,  92, 170],
        [ 25,  92, 171],
        ...,
        [ 24,  91, 170],
        [ 25,  92, 171],
        [ 28,  95, 174]]], dtype=uint8)]"
Image_914.jpg,395,297,235,233,1500,1000,630,530,235,daskShared_local/images/Image_914.jpg,914,"[array([[[  0, 140, 165],
        [  1, 139, 165],
        [  1, 140, 166],
        ...,
        [  1, 122, 146],
        [  1, 118, 140],
        [  0, 113, 135]],

       [[  1, 142, 167],
        [  1, 142, 167],
        [  1, 141, 167],
        ...,
        [  0, 119, 142],
        [  0, 115, 137],
        [  0, 116, 137]],

       [[  3, 145, 172],
        [  3, 145, 172],
        [  1, 143, 170],
        ...,
        [  0, 118, 140],
        [  0, 114, 135],
        [  0, 118, 139]],

       ...,

       [[ 55,  94,  76],
        [ 67, 107,  88],
        [ 81, 120,  99],
        ...,
        [131, 113,  50],
        [128, 111,  50],
        [163, 147,  90]],

       [[112, 146, 135],
        [131, 167, 155],
        [147, 183, 169],
        ...,
        [ 74,  55,   6],
        [ 91,  74,  14],
        [ 97,  82,  22]],

       [[150, 182, 168],
        [164, 198, 182],
        [181, 215, 199],
        ...,
        [ 91,  73,  12],
        [ 82,  66,   5],
        [ 95,  80,  20]]], dtype=uint8)]"
Image_915.jpg,1282,633,195,169,2304,1536,1477,802,195,daskShared_local/images/Image_915.jpg,915,"[array([[[  0, 105, 150],
        [  0, 105, 150],
        [  0, 104, 149],
        ...,
        [  0, 105, 144],
        [  0, 106, 142],
        [  0, 107, 143]],

       [[  0, 105, 150],
        [  0, 104, 149],
        [  0, 104, 149],
        ...,
        [  0, 104, 143],
        [  0, 104, 143],
        [  0, 104, 141]],

       [[  0, 105, 150],
        [  0, 104, 149],
        [  0, 104, 149],
        ...,
        [  0, 104, 143],
        [  0, 104, 143],
        [  0, 104, 143]],

       ...,

       [[ 64, 113, 120],
        [ 75, 119, 118],
        [ 92, 131, 126],
        ...,
        [ 20,  18,  39],
        [ 21,  20,  38],
        [ 24,  23,  39]],

       [[ 68, 111, 118],
        [ 98, 139, 131],
        [136, 174, 160],
        ...,
        [ 22,  20,  41],
        [ 22,  21,  39],
        [ 21,  20,  36]],

       [[ 97, 142, 139],
        [118, 166, 153],
        [159, 206, 190],
        ...,
        [ 20,  21,  41],
        [ 21,  20,  38],
        [ 19,  18,  34]]], dtype=uint8)]"
Image_916.jpg,187,92,359,309,1024,670,546,401,359,daskShared_local/images/Image_916.jpg,916,"[array([[[ 26,  42,  58],
        [ 30,  47,  65],
        [ 27,  44,  63],
        ...,
        [ 51, 104, 122],
        [ 55, 104, 121],
        [ 50, 104, 126]],

       [[ 28,  44,  60],
        [ 34,  49,  67],
        [ 31,  47,  64],
        ...,
        [ 37,  90, 110],
        [ 42,  90, 112],
        [ 37, 101, 114]],

       [[ 32,  48,  59],
        [ 26,  41,  54],
        [ 26,  38,  54],
        ...,
        [ 45, 105, 119],
        [ 47, 104, 118],
        [ 42, 112, 117]],

       ...,

       [[ 45, 176, 194],
        [ 50, 153, 174],
        [ 62, 140, 162],
        ...,
        [ 69, 175, 199],
        [120, 202, 232],
        [159, 223, 236]],

       [[ 52, 182, 186],
        [ 52, 158, 163],
        [ 56, 143, 148],
        ...,
        [ 24, 114, 143],
        [ 53, 120, 155],
        [101, 176, 219]],

       [[ 40, 174, 165],
        [ 39, 153, 142],
        [ 44, 145, 134],
        ...,
        [ 51, 133, 155],
        [ 42, 103, 131],
        [ 36, 104, 139]]], dtype=uint8)]"
Image_917.jpg,245,215,141,146,775,518,386,361,146,daskShared_local/images/Image_917.jpg,917,"[array([[[ 44,  45,  31],
        [ 25,  24,  17],
        [ 41,  37,  31],
        ...,
        [143, 113,  83],
        [155, 126,  96],
        [168, 138, 110]],

       [[ 32,  32,  19],
        [ 33,  32,  21],
        [ 76,  71,  63],
        ...,
        [139, 109,  78],
        [143, 113,  83],
        [146, 115,  85]],

       [[ 45,  44,  31],
        [ 76,  73,  60],
        [137, 130, 119],
        ...,
        [132, 101,  69],
        [130,  99,  67],
        [123,  92,  60]],

       ...,

       [[136, 100,  48],
        [135, 101,  49],
        [148, 116,  65],
        ...,
        [205, 165, 129],
        [198, 157, 120],
        [202, 161, 123]],

       [[136, 101,  49],
        [137, 103,  51],
        [150, 117,  67],
        ...,
        [201, 160, 124],
        [194, 153, 116],
        [199, 157, 119]],

       [[146, 110,  58],
        [147, 113,  61],
        [158, 125,  75],
        ...,
        [196, 154, 119],
        [191, 149, 112],
        [195, 153, 115]]], dtype=uint8)]"
Image_918.jpg,306,306,147,135,966,642,453,441,147,daskShared_local/images/Image_918.jpg,918,"[array([[[ 34, 206, 213],
        [ 38, 208, 216],
        [ 44, 213, 221],
        ...,
        [ 56,  30,   7],
        [ 62,  36,   8],
        [ 62,  37,   9]],

       [[ 36, 206, 219],
        [ 41, 209, 222],
        [ 47, 213, 227],
        ...,
        [ 59,  26,  11],
        [ 58,  24,   8],
        [ 54,  20,   5]],

       [[ 36, 206, 223],
        [ 41, 208, 226],
        [ 46, 211, 230],
        ...,
        [ 71,  34,  23],
        [ 67,  25,  15],
        [ 58,  15,   5]],

       ...,

       [[ 19, 192, 208],
        [ 18, 192, 207],
        [ 17, 192, 206],
        ...,
        [ 50, 228, 237],
        [ 52, 230, 239],
        [ 53, 231, 239]],

       [[ 20, 192, 209],
        [ 19, 192, 208],
        [ 18, 191, 207],
        ...,
        [ 44, 227, 236],
        [ 45, 229, 237],
        [ 47, 230, 237]],

       [[ 21, 193, 210],
        [ 20, 192, 209],
        [ 19, 191, 207],
        ...,
        [ 41, 227, 235],
        [ 40, 228, 234],
        [ 42, 228, 235]]], dtype=uint8)]"
Image_919.jpg,725,337,195,166,1600,1000,920,503,195,daskShared_local/images/Image_919.jpg,919,"[array([[[  2,  83, 165],
        [  2,  83, 165],
        [  2,  83, 165],
        ...,
        [  0,  81, 163],
        [  0,  81, 163],
        [  0,  81, 163]],

       [[  2,  83, 165],
        [  2,  83, 165],
        [  2,  83, 165],
        ...,
        [  0,  81, 163],
        [  0,  81, 163],
        [  0,  81, 163]],

       [[  2,  83, 165],
        [  2,  83, 165],
        [  2,  83, 165],
        ...,
        [  0,  81, 163],
        [  0,  81, 163],
        [  0,  81, 163]],

       ...,

       [[242, 233, 168],
        [241, 222, 153],
        [253, 231, 163],
        ...,
        [211, 190, 147],
        [209, 195, 158],
        [192, 190, 160]],

       [[245, 222, 144],
        [225, 192, 113],
        [210, 171,  96],
        ...,
        [227, 204, 163],
        [233, 219, 182],
        [203, 199, 172]],

       [[225, 193, 118],
        [201, 163,  88],
        [180, 137,  68],
        ...,
        [203, 179, 141],
        [221, 205, 171],
        [208, 201, 175]]], dtype=uint8)]"
Image_92.jpg,341,127,186,192,770,422,527,319,192,daskShared_local/images/Image_92.jpg,92,"[array([[[153, 118,  86],
        [179, 135, 102],
        [180, 132, 102],
        ...,
        [ 51, 143, 228],
        [ 41, 135, 223],
        [ 39, 133, 221]],

       [[121, 122,  97],
        [116, 113,  92],
        [106, 105,  90],
        ...,
        [ 36, 128, 215],
        [ 33, 124, 213],
        [ 30, 120, 210]],

       [[124, 118, 103],
        [115, 109,  98],
        [104,  99,  94],
        ...,
        [ 35, 127, 214],
        [ 35, 124, 214],
        [ 31, 120, 210]],

       ...,

       [[ 62,  75,  32],
        [ 57,  69,  29],
        [ 54,  66,  29],
        ...,
        [  2,  16,  39],
        [  2,  10,  29],
        [  4,  12,  31]],

       [[ 66,  80,  29],
        [ 60,  72,  23],
        [ 55,  66,  23],
        ...,
        [  0,   7,  32],
        [  4,  11,  29],
        [  7,  16,  33]],

       [[ 72,  86,  27],
        [ 67,  80,  26],
        [ 62,  74,  26],
        ...,
        [  0,   9,  30],
        [  0,   9,  24],
        [  2,  14,  28]]], dtype=uint8)]"
Image_920.jpg,399,319,145,136,800,600,544,455,145,daskShared_local/images/Image_920.jpg,920,"[array([[[236, 218, 187],
        [232, 215, 186],
        [222, 210, 181],
        ...,
        [  4,  96, 108],
        [  3,  92, 105],
        [  1,  90, 103]],

       [[234, 215, 186],
        [228, 214, 186],
        [218, 209, 182],
        ...,
        [  4,  99, 110],
        [  3,  96, 107],
        [  2,  93, 105]],

       [[231, 213, 186],
        [224, 211, 188],
        [213, 207, 186],
        ...,
        [  4, 102, 111],
        [  3,  99, 108],
        [  2,  97, 107]],

       ...,

       [[ 22,  46,  48],
        [ 21,  47,  48],
        [ 21,  48,  49],
        ...,
        [ 50, 130,  88],
        [ 40, 116,  82],
        [ 36, 109,  79]],

       [[ 22,  47,  49],
        [ 20,  47,  48],
        [ 20,  47,  48],
        ...,
        [ 71, 158, 107],
        [ 55, 137,  92],
        [ 45, 124,  83]],

       [[ 22,  48,  50],
        [ 21,  48,  49],
        [ 20,  48,  49],
        ...,
        [ 86, 178, 116],
        [ 69, 155,  97],
        [ 56, 139,  83]]], dtype=uint8)]"
Image_921.jpg,688,299,514,503,1920,1080,1202,802,514,daskShared_local/images/Image_921.jpg,921,"[array([[[ 22,  62,  82],
        [ 20,  44,  53],
        [ 36,  56,  54],
        ...,
        [ 32,  64,  63],
        [ 44,  82,  78],
        [ 31,  68,  68]],

       [[ 54,  98, 122],
        [ 12,  37,  51],
        [ 39,  57,  60],
        ...,
        [ 33,  75,  71],
        [ 25,  69,  64],
        [ 57, 114, 111]],

       [[ 66, 109, 129],
        [ 17,  45,  55],
        [ 38,  58,  59],
        ...,
        [ 24,  79,  72],
        [105, 164, 157],
        [151, 235, 227]],

       ...,

       [[ 28,  94, 142],
        [ 27,  93, 143],
        [ 28,  94, 144],
        ...,
        [ 26,  44,  42],
        [ 23,  44,  39],
        [ 25,  43,  40]],

       [[ 28,  94, 144],
        [ 29,  95, 145],
        [ 29,  95, 145],
        ...,
        [ 26,  44,  42],
        [ 24,  44,  40],
        [ 25,  43,  41]],

       [[ 28,  94, 144],
        [ 29,  95, 146],
        [ 29,  95, 146],
        ...,
        [ 26,  43,  42],
        [ 25,  43,  39],
        [ 26,  45,  43]]], dtype=uint8)]"
Image_922.jpg,159,171,185,147,728,500,344,318,185,daskShared_local/images/Image_922.jpg,922,"[array([[[  2,  73, 225],
        [  2,  73, 227],
        [  2,  73, 225],
        ...,
        [  1,  81, 230],
        [  2,  82, 231],
        [  2,  82, 229]],

       [[  1,  72, 224],
        [  0,  72, 226],
        [  0,  73, 224],
        ...,
        [  0,  80, 229],
        [  0,  80, 227],
        [  0,  80, 227]],

       [[  1,  72, 224],
        [  1,  72, 224],
        [  0,  71, 222],
        ...,
        [  0,  80, 227],
        [  1,  81, 228],
        [  1,  81, 228]],

       ...,

       [[ 37, 145, 155],
        [ 37, 155, 156],
        [ 22, 155, 150],
        ...,
        [236, 205, 175],
        [236, 212, 179],
        [239, 218, 201]],

       [[ 26, 139, 151],
        [ 29, 146, 155],
        [ 24, 145, 153],
        ...,
        [238, 200, 128],
        [241, 204, 140],
        [235, 197, 142]],

       [[ 19, 137, 145],
        [ 24, 142, 151],
        [ 28, 142, 150],
        ...,
        [245, 236, 171],
        [242, 216, 139],
        [246, 220, 137]]], dtype=uint8)]"
Image_923.jpg,794,329,166,128,1536,1024,960,457,166,daskShared_local/images/Image_923.jpg,923,"[array([[[  0,  18,  32],
        [  0,  18,  32],
        [  0,  19,  33],
        ...,
        [ 47, 124, 214],
        [ 47, 124, 214],
        [ 47, 124, 214]],

       [[  1,  19,  33],
        [  0,  19,  33],
        [  0,  19,  33],
        ...,
        [ 47, 124, 214],
        [ 47, 124, 214],
        [ 47, 124, 214]],

       [[  0,  19,  33],
        [  0,  19,  33],
        [  1,  20,  34],
        ...,
        [ 46, 123, 213],
        [ 46, 123, 213],
        [ 46, 123, 213]],

       ...,

       [[ 10, 118, 202],
        [ 13, 117, 203],
        [ 15, 115, 202],
        ...,
        [ 10, 113, 205],
        [ 10, 113, 205],
        [ 11, 114, 206]],

       [[ 13, 118, 202],
        [ 15, 118, 202],
        [ 17, 116, 202],
        ...,
        [ 11, 113, 205],
        [ 10, 113, 205],
        [ 10, 114, 205]],

       [[ 12, 117, 200],
        [ 14, 116, 200],
        [ 17, 115, 201],
        ...,
        [ 10, 114, 204],
        [  9, 114, 205],
        [  8, 113, 204]]], dtype=uint8)]"
Image_924.jpg,1792,2523,511,487,2720,4080,2303,3010,511,daskShared_local/images/Image_924.jpg,924,"[array([[[ 96,  83,  65],
        [ 62,  56,  44],
        [ 42,  46,  41],
        ...,
        [  5, 131, 197],
        [  4, 133, 198],
        [  6, 136, 200]],

       [[147, 127, 106],
        [119, 105,  90],
        [ 99,  91,  85],
        ...,
        [  5, 132, 197],
        [  4, 132, 197],
        [  7, 133, 198]],

       [[105,  87,  78],
        [ 91,  74,  67],
        [ 92,  74,  68],
        ...,
        [  5, 130, 196],
        [  2, 122, 189],
        [  4, 128, 194]],

       ...,

       [[  4, 112, 186],
        [  6, 117, 191],
        [  8, 120, 194],
        ...,
        [  3, 113, 189],
        [  2, 111, 187],
        [  5, 116, 192]],

       [[  4, 115, 189],
        [  7, 118, 192],
        [  4, 116, 190],
        ...,
        [  6, 117, 193],
        [  4, 113, 189],
        [  5, 117, 193]],

       [[  5, 117, 191],
        [  3, 115, 189],
        [  5, 117, 191],
        ...,
        [  4, 113, 189],
        [  4, 111, 187],
        [  6, 117, 193]]], dtype=uint8)]"
Image_925.jpg,77,86,121,134,637,450,198,220,134,daskShared_local/images/Image_925.jpg,925,"[array([[[  1, 172, 254],
        [  1, 172, 254],
        [  1, 172, 254],
        ...,
        [  2, 166, 255],
        [  2, 166, 255],
        [  1, 165, 254]],

       [[  1, 172, 254],
        [  1, 172, 254],
        [  1, 172, 254],
        ...,
        [  2, 166, 255],
        [  2, 166, 255],
        [  1, 165, 254]],

       [[  1, 172, 254],
        [  1, 172, 254],
        [  1, 172, 254],
        ...,
        [  2, 166, 255],
        [  2, 165, 254],
        [  1, 165, 254]],

       ...,

       [[  1, 145, 247],
        [  2, 148, 249],
        [  4, 153, 252],
        ...,
        [  0,  82,  78],
        [  8,  91,  87],
        [ 13,  97,  93]],

       [[  2, 147, 248],
        [  4, 150, 251],
        [  6, 156, 254],
        ...,
        [  1,  84,  83],
        [  8,  94,  93],
        [ 13, 101,  99]],

       [[  2, 148, 249],
        [  4, 151, 251],
        [  7, 157, 255],
        ...,
        [  1,  86,  87],
        [  7,  96,  96],
        [ 12, 102, 101]]], dtype=uint8)]"
Image_926.jpg,279,123,109,124,775,518,388,247,124,daskShared_local/images/Image_926.jpg,926,"[array([[[ 88, 159, 177],
        [ 87, 158, 176],
        [ 86, 157, 175],
        ...,
        [ 91, 163, 181],
        [ 86, 158, 176],
        [ 84, 156, 174]],

       [[ 87, 158, 176],
        [ 86, 157, 175],
        [ 84, 155, 173],
        ...,
        [ 90, 162, 180],
        [ 86, 159, 176],
        [ 85, 157, 174]],

       [[ 86, 157, 175],
        [ 84, 155, 173],
        [ 81, 152, 170],
        ...,
        [ 87, 159, 176],
        [ 87, 158, 176],
        [ 87, 158, 176]],

       ...,

       [[154, 112,  90],
        [146, 104,  82],
        [131,  89,  65],
        ...,
        [114,  87,  65],
        [125,  99,  81],
        [129, 104,  88]],

       [[159, 115,  93],
        [150, 106,  84],
        [131,  88,  64],
        ...,
        [110,  82,  56],
        [123,  96,  75],
        [127, 101,  82]],

       [[161, 117,  94],
        [152, 108,  85],
        [133,  88,  65],
        ...,
        [109,  79,  52],
        [122,  95,  73],
        [128, 102,  81]]], dtype=uint8)]"
Image_927.jpg,618,314,161,128,1440,960,779,442,161,daskShared_local/images/Image_927.jpg,927,"[array([[[  0, 144, 207],
        [  0, 145, 208],
        [  1, 146, 209],
        ...,
        [  0, 144, 214],
        [  1, 145, 215],
        [  1, 145, 215]],

       [[  0, 145, 208],
        [  0, 145, 208],
        [  1, 146, 209],
        ...,
        [  0, 144, 214],
        [  1, 145, 215],
        [  2, 146, 216]],

       [[  0, 145, 208],
        [  0, 145, 208],
        [  0, 145, 208],
        ...,
        [  1, 146, 214],
        [  2, 146, 215],
        [  2, 147, 215]],

       ...,

       [[ 93,  87,  66],
        [112, 108,  87],
        [108, 107,  86],
        ...,
        [  0,  77, 115],
        [  0,  78, 116],
        [  0,  78, 116]],

       [[ 62,  62,  44],
        [ 78,  79,  61],
        [ 86,  88,  71],
        ...,
        [  1,  79, 117],
        [  1,  79, 117],
        [  1,  79, 117]],

       [[ 32,  37,  23],
        [ 36,  41,  27],
        [ 55,  60,  47],
        ...,
        [  1,  79, 117],
        [  1,  79, 117],
        [  0,  78, 116]]], dtype=uint8)]"
Image_928.jpg,455,144,139,130,1024,512,594,274,139,daskShared_local/images/Image_928.jpg,928,"[array([[[  1, 136, 192],
        [  1, 136, 192],
        [  1, 136, 192],
        ...,
        [  3, 168, 213],
        [  2, 166, 212],
        [  1, 166, 212]],

       [[  1, 136, 192],
        [  1, 136, 192],
        [  1, 136, 192],
        ...,
        [  2, 166, 212],
        [  2, 165, 211],
        [  1, 164, 211]],

       [[  1, 135, 191],
        [  0, 135, 191],
        [  0, 135, 191],
        ...,
        [  1, 163, 210],
        [  1, 162, 210],
        [  1, 162, 209]],

       ...,

       [[ 71,  65,  36],
        [ 66,  61,  32],
        [ 60,  55,  27],
        ...,
        [  1, 142, 197],
        [  1, 142, 198],
        [  1, 142, 198]],

       [[ 89,  83,  52],
        [ 77,  71,  42],
        [ 63,  58,  29],
        ...,
        [  1, 142, 197],
        [  1, 142, 198],
        [  1, 142, 198]],

       [[104,  97,  66],
        [ 87,  80,  50],
        [ 66,  60,  31],
        ...,
        [  1, 142, 197],
        [  1, 142, 198],
        [  1, 142, 198]]], dtype=uint8)]"
Image_929.jpg,108,76,86,69,475,264,194,145,86,daskShared_local/images/Image_929.jpg,929,"[array([[[16, 37, 60],
        [16, 37, 61],
        [18, 37, 59],
        ...,
        [20, 38, 60],
        [19, 37, 59],
        [20, 38, 59]],

       [[14, 34, 56],
        [13, 34, 56],
        [16, 35, 56],
        ...,
        [20, 38, 60],
        [19, 37, 59],
        [20, 38, 59]],

       [[23, 44, 70],
        [23, 45, 71],
        [22, 42, 67],
        ...,
        [20, 38, 59],
        [19, 37, 58],
        [20, 38, 58]],

       ...,

       [[16, 25, 32],
        [15, 24, 32],
        [16, 25, 33],
        ...,
        [60, 79, 76],
        [57, 76, 73],
        [58, 77, 74]],

       [[16, 25, 33],
        [15, 24, 33],
        [16, 25, 33],
        ...,
        [72, 94, 87],
        [70, 92, 85],
        [70, 92, 85]],

       [[16, 25, 33],
        [15, 24, 33],
        [16, 25, 33],
        ...,
        [68, 90, 83],
        [66, 87, 81],
        [67, 88, 82]]], dtype=uint8)]"
Image_93.jpg,450,201,189,194,900,600,639,395,194,daskShared_local/images/Image_93.jpg,93,"[array([[[  0, 124, 236],
        [  0, 125, 235],
        [  0, 125, 235],
        ...,
        [  0,  89, 209],
        [  1,  92, 209],
        [  1,  92, 209]],

       [[  0, 124, 236],
        [  0, 125, 235],
        [  0, 125, 235],
        ...,
        [  0,  89, 209],
        [  1,  92, 209],
        [  1,  92, 209]],

       [[  0, 123, 235],
        [  0, 124, 234],
        [  0, 124, 234],
        ...,
        [  0,  88, 206],
        [  0,  91, 208],
        [  1,  92, 209]],

       ...,

       [[116,  81,  16],
        [163, 128,  65],
        [112,  76,  16],
        ...,
        [ 14,  57, 120],
        [  1,  53, 152],
        [  1,  53, 154]],

       [[143, 107,  29],
        [147, 111,  36],
        [104,  67,   3],
        ...,
        [  0,  49, 117],
        [  2,  56, 156],
        [  2,  55, 157]],

       [[183, 149,  60],
        [178, 144,  57],
        [164, 129,  47],
        ...,
        [  3,  52, 129],
        [  3,  56, 158],
        [  2,  55, 161]]], dtype=uint8)]"
Image_930.jpg,577,164,187,192,1000,665,764,356,192,daskShared_local/images/Image_930.jpg,930,"[array([[[ 42, 134, 199],
        [ 32, 132, 200],
        [ 22, 130, 199],
        ...,
        [ 26, 130, 196],
        [ 21, 129, 197],
        [ 12, 129, 196]],

       [[ 40, 133, 200],
        [ 41, 134, 201],
        [ 31, 132, 200],
        ...,
        [ 14, 128, 195],
        [ 14, 128, 195],
        [ 25, 129, 196]],

       [[ 37, 135, 200],
        [ 37, 132, 198],
        [ 42, 135, 200],
        ...,
        [ 16, 128, 196],
        [ 24, 130, 196],
        [ 31, 131, 196]],

       ...,

       [[ 30,  88, 100],
        [ 25,  84,  94],
        [  9,  77,  85],
        ...,
        [  1,  74,  81],
        [  3,  76,  83],
        [  0,  70,  78]],

       [[ 13,  72,  80],
        [  7,  59,  62],
        [  6,  59,  63],
        ...,
        [  4,  75,  82],
        [  4,  79,  85],
        [  3,  73,  81]],

       [[ 35,  91, 106],
        [ 22,  79,  88],
        [ 24,  75,  82],
        ...,
        [  7,  82,  88],
        [  5,  78,  87],
        [  4,  77,  84]]], dtype=uint8)]"
Image_931.jpg,764,488,1252,1532,3072,2304,2016,2020,1532,daskShared_local/images/Image_931.jpg,931,"[array([[[ 92,  78,  75],
        [ 99,  86,  83],
        [106,  95,  92],
        ...,
        [111,  78,  94],
        [ 99,  67,  84],
        [ 93,  66,  81]],

       [[ 89,  77,  73],
        [ 91,  80,  75],
        [104,  94,  89],
        ...,
        [113,  83,  98],
        [106,  80,  94],
        [100,  76,  89]],

       [[ 93,  79,  78],
        [ 93,  78,  78],
        [105,  94,  93],
        ...,
        [ 97,  70,  88],
        [ 87,  65,  79],
        [ 93,  73,  84]],

       ...,

       [[  5, 110, 118],
        [  7, 111, 119],
        [  7, 111, 121],
        ...,
        [ 36, 116, 138],
        [ 40, 123, 144],
        [ 42, 128, 148]],

       [[  5, 110, 116],
        [  6, 111, 117],
        [  7, 111, 119],
        ...,
        [ 33, 118, 138],
        [ 37, 124, 143],
        [ 38, 125, 144]],

       [[  5, 110, 116],
        [  6, 110, 117],
        [  5, 108, 121],
        ...,
        [ 32, 121, 138],
        [ 36, 123, 142],
        [ 37, 123, 143]]], dtype=uint8)]"
Image_932.jpg,197,330,300,207,1024,768,497,537,300,daskShared_local/images/Image_932.jpg,932,"[array([[[ 77, 117, 131],
        [ 78, 119, 137],
        [ 59, 101, 123],
        ...,
        [ 62,  96, 112],
        [ 51,  88, 103],
        [ 41,  73,  88]],

       [[ 50,  83,  94],
        [ 55,  88, 105],
        [ 70, 102, 124],
        ...,
        [ 24,  67,  88],
        [ 80, 126, 146],
        [ 65, 108, 120]],

       [[ 61,  92, 105],
        [ 59,  89, 109],
        [ 65,  95, 120],
        ...,
        [ 46,  89, 112],
        [ 68, 113, 135],
        [ 93, 135, 148]],

       ...,

       [[ 75, 122, 148],
        [149, 205, 219],
        [149, 210, 204],
        ...,
        [ 16,   9,  25],
        [ 15,   7,  24],
        [ 22,  14,  31]],

       [[140, 191, 201],
        [148, 206, 204],
        [126, 185, 170],
        ...,
        [ 21,  10,  26],
        [ 19,   8,  24],
        [ 18,   9,  24]],

       [[168, 225, 219],
        [147, 204, 191],
        [133, 188, 166],
        ...,
        [ 25,  12,  29],
        [ 18,   6,  21],
        [ 14,   6,  15]]], dtype=uint8)]"
Image_933.jpg,497,141,210,164,800,600,707,305,210,daskShared_local/images/Image_933.jpg,933,"[array([[[  1,  25,  61],
        [  3,  28,  58],
        [  2,  25,  53],
        ...,
        [ 11,  19,  26],
        [ 10,  17,  25],
        [  9,  12,  21]],

       [[  4,  29,  66],
        [  3,  27,  58],
        [  1,  22,  50],
        ...,
        [ 10,  18,  25],
        [  9,  16,  24],
        [  8,  11,  20]],

       [[  2,  36,  74],
        [  0,  29,  60],
        [  1,  25,  51],
        ...,
        [ 14,  20,  27],
        [ 12,  17,  23],
        [  8,  13,  19]],

       ...,

       [[203, 172, 112],
        [212, 191, 136],
        [203, 187, 143],
        ...,
        [ 67,  69,  84],
        [ 26,  27,  40],
        [ 31,  32,  36]],

       [[200, 167, 103],
        [205, 182, 123],
        [200, 185, 138],
        ...,
        [ 36,  39,  50],
        [ 18,  21,  29],
        [ 37,  41,  38]],

       [[203, 170, 103],
        [204, 179, 119],
        [199, 184, 135],
        ...,
        [ 13,  16,  21],
        [ 15,  19,  18],
        [ 38,  44,  35]]], dtype=uint8)]"
Image_934.jpg,105,109,394,288,800,533,499,397,394,daskShared_local/images/Image_934.jpg,934,"[array([[[ 4,  9, 55],
        [ 4, 10, 55],
        [ 3, 11, 54],
        ...,
        [12, 22, 76],
        [12, 22, 75],
        [ 9, 22, 74]],

       [[ 5, 10, 55],
        [ 3, 10, 54],
        [ 5, 12, 56],
        ...,
        [11, 23, 75],
        [ 8, 20, 73],
        [ 6, 20, 72]],

       [[ 2, 10, 55],
        [ 5, 12, 57],
        [ 4, 12, 57],
        ...,
        [10, 22, 75],
        [ 9, 21, 74],
        [ 6, 18, 72]],

       ...,

       [[10, 17, 61],
        [ 8, 15, 58],
        [ 8, 15, 59],
        ...,
        [62, 63, 23],
        [50, 47,  5],
        [64, 56, 12]],

       [[ 6, 13, 58],
        [ 8, 15, 59],
        [ 9, 16, 60],
        ...,
        [41, 44,  9],
        [48, 43,  5],
        [57, 47,  6]],

       [[ 9, 17, 61],
        [ 9, 17, 60],
        [ 6, 14, 57],
        ...,
        [35, 39,  8],
        [45, 38,  4],
        [69, 53, 15]]], dtype=uint8)]"
Image_935.jpg,114,374,382,327,1715,1286,496,701,382,daskShared_local/images/Image_935.jpg,935,"[array([[[132, 136, 138],
        [134, 142, 144],
        [141, 146, 150],
        ...,
        [144, 163, 155],
        [150, 167, 155],
        [158, 173, 144]],

       [[136, 142, 140],
        [141, 149, 146],
        [145, 153, 151],
        ...,
        [120, 152, 159],
        [138, 165, 161],
        [154, 172, 164]],

       [[139, 143, 140],
        [145, 148, 147],
        [147, 153, 152],
        ...,
        [114, 129, 152],
        [110, 153, 160],
        [135, 165, 167]],

       ...,

       [[194, 200, 185],
        [192, 195, 183],
        [188, 191, 182],
        ...,
        [180, 187, 203],
        [190, 194, 210],
        [197, 198, 214]],

       [[188, 199, 187],
        [185, 196, 180],
        [183, 193, 178],
        ...,
        [178, 186, 198],
        [189, 188, 208],
        [194, 190, 211]],

       [[186, 198, 187],
        [184, 196, 182],
        [182, 195, 180],
        ...,
        [174, 184, 193],
        [184, 187, 205],
        [189, 192, 209]]], dtype=uint8)]"
Image_936.jpg,320,281,133,125,1280,720,453,406,133,daskShared_local/images/Image_936.jpg,936,"[array([[[  1,  61, 133],
        [  1,  61, 133],
        [  1,  61, 133],
        ...,
        [  0,  62, 137],
        [  0,  62, 137],
        [  0,  62, 137]],

       [[  1,  61, 133],
        [  1,  61, 133],
        [  1,  61, 133],
        ...,
        [  0,  62, 137],
        [  0,  62, 137],
        [  0,  62, 137]],

       [[  1,  61, 133],
        [  1,  61, 133],
        [  1,  61, 133],
        ...,
        [  0,  62, 137],
        [  0,  62, 137],
        [  0,  62, 137]],

       ...,

       [[ 31, 105, 130],
        [ 31, 105, 130],
        [ 31, 105, 130],
        ...,
        [ 20,  96, 132],
        [ 20,  96, 132],
        [ 20,  96, 132]],

       [[ 31, 105, 130],
        [ 31, 105, 130],
        [ 31, 105, 130],
        ...,
        [ 20,  96, 132],
        [ 20,  96, 132],
        [ 20,  96, 132]],

       [[ 32, 106, 131],
        [ 32, 106, 131],
        [ 32, 106, 131],
        ...,
        [ 20,  96, 132],
        [ 20,  96, 132],
        [ 20,  96, 132]]], dtype=uint8)]"
Image_937.jpg,351,13,612,525,1190,595,963,538,612,daskShared_local/images/Image_937.jpg,937,"[array([[[210, 226, 237],
        [208, 226, 235],
        [213, 230, 236],
        ...,
        [203, 216, 206],
        [202, 217, 206],
        [202, 217, 206]],

       [[205, 223, 233],
        [208, 225, 234],
        [210, 228, 235],
        ...,
        [205, 217, 207],
        [204, 217, 207],
        [203, 216, 206]],

       [[210, 228, 238],
        [213, 231, 242],
        [215, 234, 243],
        ...,
        [205, 217, 207],
        [204, 216, 206],
        [204, 216, 206]],

       ...,

       [[ 51,  32,  32],
        [ 50,  38,  37],
        [ 50,  38,  40],
        ...,
        [171, 120, 102],
        [176, 128, 117],
        [177, 129, 116]],

       [[ 47,  33,  33],
        [ 48,  35,  34],
        [ 45,  36,  33],
        ...,
        [167, 110,  95],
        [166, 110, 101],
        [170, 119, 108]],

       [[ 42,  30,  32],
        [ 44,  30,  32],
        [ 48,  34,  34],
        ...,
        [156,  91,  80],
        [158,  97,  89],
        [161, 107,  96]]], dtype=uint8)]"
Image_938.jpg,1609,518,876,574,4100,2660,2485,1092,876,daskShared_local/images/Image_938.jpg,938,"[array([[[179, 166, 153],
        [180, 168, 154],
        [175, 165, 155],
        ...,
        [136, 130, 117],
        [138, 132, 119],
        [140, 133, 121]],

       [[179, 165, 151],
        [180, 168, 157],
        [183, 173, 163],
        ...,
        [140, 134, 121],
        [140, 133, 121],
        [140, 134, 121]],

       [[179, 167, 153],
        [179, 168, 159],
        [181, 172, 163],
        ...,
        [137, 130, 117],
        [137, 129, 119],
        [136, 129, 116]],

       ...,

       [[ 54,  42,  36],
        [ 51,  40,  33],
        [ 51,  41,  36],
        ...,
        [150, 153, 156],
        [128, 129, 125],
        [122, 124, 121]],

       [[ 52,  35,  29],
        [ 52,  36,  28],
        [ 50,  35,  28],
        ...,
        [153, 156, 166],
        [134, 134, 136],
        [130, 129, 125]],

       [[ 50,  31,  24],
        [ 53,  36,  27],
        [ 51,  36,  27],
        ...,
        [159, 162, 169],
        [142, 142, 143],
        [133, 133, 126]]], dtype=uint8)]"
Image_939.jpg,337,129,194,193,770,422,531,322,194,daskShared_local/images/Image_939.jpg,939,"[array([[[128, 125, 110],
        [124, 118, 104],
        [115, 108,  98],
        ...,
        [ 35, 124, 214],
        [ 31, 120, 210],
        [ 28, 116, 206]],

       [[122, 108, 104],
        [120, 105, 102],
        [113, 100,  99],
        ...,
        [ 37, 126, 216],
        [ 34, 122, 212],
        [ 29, 117, 207]],

       [[108,  87,  84],
        [112,  92,  90],
        [109,  91,  91],
        ...,
        [ 38, 126, 216],
        [ 34, 122, 212],
        [ 31, 116, 207]],

       ...,

       [[ 66,  82,  35],
        [ 60,  74,  26],
        [ 58,  70,  22],
        ...,
        [  2,  11,  28],
        [  0,  12,  28],
        [  0,  12,  29]],

       [[ 50,  65,  26],
        [ 38,  51,  13],
        [ 33,  44,   5],
        ...,
        [  1,  10,  27],
        [  0,  11,  27],
        [  0,  11,  28]],

       [[ 25,  37,  15],
        [ 11,  21,   1],
        [  6,  15,   0],
        ...,
        [  0,   9,  26],
        [  0,  10,  26],
        [  0,  11,  28]]], dtype=uint8)]"
Image_94.jpg,104,109,146,142,500,375,250,251,146,daskShared_local/images/Image_94.jpg,94,"[array([[[ 51, 118, 144],
        [ 61, 128, 154],
        [ 76, 143, 169],
        ...,
        [ 43,  93, 117],
        [ 46,  96, 119],
        [ 46,  96, 119]],

       [[ 49, 116, 142],
        [ 57, 124, 150],
        [ 69, 136, 162],
        ...,
        [ 47,  97, 120],
        [ 50, 100, 123],
        [ 49,  99, 122]],

       [[ 50, 117, 143],
        [ 53, 120, 146],
        [ 59, 126, 152],
        ...,
        [ 51, 101, 124],
        [ 52, 102, 125],
        [ 51, 101, 124]],

       ...,

       [[ 29, 117, 139],
        [ 29, 117, 139],
        [ 29, 117, 139],
        ...,
        [190, 164, 145],
        [187, 160, 139],
        [181, 153, 132]],

       [[ 28, 116, 138],
        [ 27, 115, 137],
        [ 26, 114, 136],
        ...,
        [186, 161, 141],
        [183, 156, 135],
        [177, 150, 129]],

       [[ 27, 115, 137],
        [ 26, 114, 136],
        [ 24, 112, 134],
        ...,
        [181, 156, 136],
        [178, 151, 130],
        [173, 146, 125]]], dtype=uint8)]"
Image_940.jpg,429,197,210,200,900,600,639,397,210,daskShared_local/images/Image_940.jpg,940,"[array([[[  3, 134, 238],
        [  4, 135, 239],
        [  5, 134, 238],
        ...,
        [  1,  90, 206],
        [  1,  90, 206],
        [  1,  90, 206]],

       [[  5, 134, 238],
        [  3, 134, 238],
        [  4, 133, 237],
        ...,
        [  0,  89, 205],
        [  1,  90, 206],
        [  1,  90, 206]],

       [[  3, 132, 236],
        [  2, 133, 237],
        [  3, 132, 236],
        ...,
        [  0,  89, 207],
        [  1,  90, 208],
        [  2,  91, 207]],

       ...,

       [[202, 202, 157],
        [207, 210, 163],
        [207, 208, 158],
        ...,
        [ 20,  57, 100],
        [  7,  52, 124],
        [  7,  61, 157]],

       [[177, 165, 123],
        [173, 161, 121],
        [170, 156, 111],
        ...,
        [  4,  50, 130],
        [  2,  54, 154],
        [  2,  57, 167]],

       [[165, 153, 103],
        [185, 173, 123],
        [201, 187, 134],
        ...,
        [  9,  55, 144],
        [  1,  52, 156],
        [  0,  52, 165]]], dtype=uint8)]"
Image_941.jpg,103,102,141,140,500,375,244,242,141,daskShared_local/images/Image_941.jpg,941,"[array([[[105, 174, 183],
        [108, 175, 185],
        [111, 175, 187],
        ...,
        [ 42,  94, 118],
        [ 41,  93, 116],
        [ 39,  91, 115]],

       [[ 98, 172, 183],
        [105, 173, 184],
        [110, 173, 185],
        ...,
        [ 45,  97, 120],
        [ 44,  96, 119],
        [ 42,  94, 117]],

       [[ 81, 156, 173],
        [ 87, 157, 173],
        [ 93, 156, 173],
        ...,
        [ 49, 101, 124],
        [ 49, 101, 124],
        [ 49, 100, 123]],

       ...,

       [[ 27, 119, 142],
        [ 29, 121, 144],
        [ 32, 124, 147],
        ...,
        [205, 204, 201],
        [207, 209, 209],
        [209, 212, 214]],

       [[ 25, 117, 140],
        [ 28, 120, 143],
        [ 30, 122, 145],
        ...,
        [205, 205, 202],
        [207, 210, 209],
        [209, 213, 214]],

       [[ 24, 116, 139],
        [ 27, 119, 142],
        [ 29, 121, 144],
        ...,
        [205, 206, 203],
        [207, 211, 209],
        [209, 214, 214]]], dtype=uint8)]"
Image_942.jpg,334,275,244,224,750,740,578,499,244,daskShared_local/images/Image_942.jpg,942,"[array([[[ 37, 199, 220],
        [ 38, 197, 215],
        [ 40, 197, 209],
        ...,
        [ 12, 194, 215],
        [  8, 196, 213],
        [  6, 196, 212]],

       [[ 28, 198, 216],
        [ 34, 200, 214],
        [ 45, 206, 210],
        ...,
        [ 13, 194, 215],
        [  9, 197, 214],
        [  8, 199, 214]],

       [[ 40, 213, 230],
        [ 50, 216, 229],
        [ 64, 221, 225],
        ...,
        [ 13, 194, 215],
        [ 10, 198, 214],
        [  8, 200, 214]],

       ...,

       [[114, 182, 152],
        [120, 186, 161],
        [119, 185, 166],
        ...,
        [135, 191, 188],
        [133, 188, 189],
        [127, 182, 184]],

       [[117, 175, 141],
        [121, 180, 151],
        [120, 183, 160],
        ...,
        [140, 193, 197],
        [140, 192, 198],
        [139, 190, 196]],

       [[118, 163, 130],
        [120, 168, 138],
        [123, 180, 150],
        ...,
        [138, 187, 198],
        [138, 187, 197],
        [141, 190, 199]]], dtype=uint8)]"
Image_943.jpg,635,439,212,203,1024,672,847,642,212,daskShared_local/images/Image_943.jpg,943,"[array([[[127, 125, 128],
        [116, 114, 115],
        [112, 110, 111],
        ...,
        [ 78,  87,  66],
        [106, 114,  91],
        [124, 130, 104]],

       [[126, 124, 127],
        [116, 115, 117],
        [108, 108, 108],
        ...,
        [ 43,  56,  35],
        [ 56,  69,  43],
        [ 64,  75,  46]],

       [[115, 113, 116],
        [106, 106, 108],
        [ 98,  98, 100],
        ...,
        [ 46,  62,  45],
        [ 56,  71,  50],
        [ 61,  76,  53]],

       ...,

       [[ 34,  83, 138],
        [ 33,  82, 137],
        [ 32,  81, 136],
        ...,
        [ 18, 121, 231],
        [ 17, 119, 228],
        [ 16, 118, 226]],

       [[ 35,  85, 143],
        [ 34,  84, 142],
        [ 33,  82, 141],
        ...,
        [ 18, 120, 230],
        [ 15, 117, 226],
        [ 16, 117, 225]],

       [[ 33,  87, 149],
        [ 34,  88, 150],
        [ 33,  87, 149],
        ...,
        [ 17, 119, 227],
        [ 14, 115, 223],
        [ 15, 116, 224]]], dtype=uint8)]"
Image_944.jpg,310,109,233,299,1000,667,543,408,299,daskShared_local/images/Image_944.jpg,944,"[array([[[212, 186, 165],
        [220, 187, 161],
        [235, 210, 189],
        ...,
        [209, 196, 180],
        [168, 155, 139],
        [168, 155, 139]],

       [[224, 196, 172],
        [236, 211, 189],
        [241, 215, 190],
        ...,
        [245, 232, 216],
        [218, 205, 189],
        [186, 173, 157]],

       [[218, 191, 168],
        [209, 195, 162],
        [218, 188, 169],
        ...,
        [253, 244, 233],
        [252, 244, 232],
        [252, 247, 236]],

       ...,

       [[ 25, 107, 162],
        [ 27, 107, 161],
        [ 25, 107, 163],
        ...,
        [ 25,  19,   8],
        [ 27,  21,  13],
        [ 31,  27,  19]],

       [[ 22, 108, 162],
        [ 21, 108, 160],
        [ 26, 108, 164],
        ...,
        [ 39,  29,  15],
        [ 31,  20,  12],
        [ 26,  10,   9]],

       [[ 23, 112, 165],
        [ 25, 115, 165],
        [ 28, 110, 166],
        ...,
        [ 91,  78,  36],
        [ 81,  66,  32],
        [ 77,  53,  29]]], dtype=uint8)]"
Image_945.jpg,403,5,77,64,530,180,480,69,77,daskShared_local/images/Image_945.jpg,945,"[array([[[ 11,  30,  71],
        [ 10,  29,  71],
        [ 12,  31,  71],
        ...,
        [  2,  17,  60],
        [  1,  12,  59],
        [  1,  15,  60]],

       [[ 12,  31,  71],
        [ 10,  29,  71],
        [ 13,  32,  72],
        ...,
        [  1,  13,  57],
        [  0,   8,  57],
        [  1,  11,  57]],

       [[ 10,  30,  71],
        [  9,  29,  72],
        [ 11,  30,  70],
        ...,
        [  2,  19,  62],
        [  1,  14,  60],
        [  2,  17,  61]],

       ...,

       [[178, 109,  89],
        [187, 120,  94],
        [172, 100,  84],
        ...,
        [ 39,  30,  51],
        [ 32,  26,  45],
        [ 36,  28,  49]],

       [[201, 129, 116],
        [217, 148, 130],
        [189, 114, 106],
        ...,
        [ 50,  39,  60],
        [ 45,  38,  56],
        [ 48,  39,  59]],

       [[187, 117, 100],
        [199, 131, 109],
        [178, 106,  93],
        ...,
        [ 43,  34,  55],
        [ 37,  30,  50],
        [ 41,  32,  53]]], dtype=uint8)]"
Image_946.jpg,762,265,351,304,1200,906,1113,569,351,daskShared_local/images/Image_946.jpg,946,"[array([[[ 95,  90, 104],
        [ 78,  72,  89],
        [ 54,  48,  67],
        ...,
        [ 19,  51,  74],
        [ 19,  50,  72],
        [ 15,  46,  70]],

       [[ 84,  80,  96],
        [ 89,  86, 105],
        [ 63,  60,  83],
        ...,
        [ 16,  51,  73],
        [ 17,  49,  72],
        [ 19,  52,  75]],

       [[ 71,  68,  88],
        [ 83,  81, 103],
        [ 87,  87, 113],
        ...,
        [ 16,  52,  74],
        [ 14,  50,  72],
        [ 17,  53,  75]],

       ...,

       [[ 90, 141, 162],
        [ 98, 150, 171],
        [ 62, 115, 133],
        ...,
        [ 14,  55,  75],
        [ 16,  53,  72],
        [ 17,  52,  72]],

       [[107, 158, 179],
        [ 94, 144, 164],
        [ 71, 118, 136],
        ...,
        [ 18,  55,  76],
        [ 18,  53,  73],
        [ 21,  53,  73]],

       [[110, 158, 180],
        [106, 153, 176],
        [ 89, 133, 159],
        ...,
        [ 16,  52,  72],
        [ 16,  50,  71],
        [ 21,  51,  72]]], dtype=uint8)]"
Image_947.jpg,285,132,143,122,800,505,428,254,143,daskShared_local/images/Image_947.jpg,947,"[array([[[ 14,  50,  50],
        [ 13,  50,  50],
        [ 16,  54,  53],
        ...,
        [  3,  22,  31],
        [  6,  23,  33],
        [  8,  25,  35]],

       [[ 35,  70,  69],
        [ 34,  70,  69],
        [ 39,  75,  74],
        ...,
        [  6,  25,  34],
        [  8,  26,  36],
        [  9,  26,  36]],

       [[ 64,  97,  94],
        [ 62,  95,  93],
        [ 64,  97,  95],
        ...,
        [ 11,  30,  40],
        [ 12,  30,  40],
        [ 11,  29,  39]],

       ...,

       [[ 84,  90,  54],
        [ 84,  89,  54],
        [ 81,  85,  50],
        ...,
        [149, 144, 124],
        [134, 128, 108],
        [131, 123, 104]],

       [[ 87,  91,  56],
        [ 88,  92,  56],
        [ 89,  92,  56],
        ...,
        [123, 120, 103],
        [119, 115,  97],
        [122, 117,  99]],

       [[ 89,  93,  58],
        [ 91,  95,  59],
        [ 95,  97,  60],
        ...,
        [118, 116, 100],
        [123, 120, 104],
        [126, 123, 106]]], dtype=uint8)]"
Image_948.jpg,422,215,140,164,900,600,562,379,164,daskShared_local/images/Image_948.jpg,948,"[array([[[  2, 106, 161],
        [  3, 107, 162],
        [  4, 108, 163],
        ...,
        [  3, 117, 169],
        [  3, 117, 169],
        [  3, 117, 169]],

       [[  2, 106, 161],
        [  3, 107, 162],
        [  4, 108, 163],
        ...,
        [  4, 118, 170],
        [  4, 118, 170],
        [  4, 118, 170]],

       [[  2, 106, 161],
        [  3, 107, 162],
        [  4, 108, 163],
        ...,
        [  4, 118, 170],
        [  4, 118, 170],
        [  4, 118, 170]],

       ...,

       [[ 99,  99,  48],
        [102, 102,  52],
        [103, 103,  54],
        ...,
        [  7,  95, 143],
        [  7,  95, 143],
        [  7,  95, 143]],

       [[ 87,  87,  38],
        [ 85,  84,  36],
        [ 85,  84,  36],
        ...,
        [  7,  95, 143],
        [  7,  95, 143],
        [  7,  95, 143]],

       [[ 91,  90,  42],
        [ 85,  84,  38],
        [ 78,  77,  31],
        ...,
        [  7,  95, 143],
        [  7,  95, 143],
        [  7,  95, 143]]], dtype=uint8)]"
Image_949.jpg,760,150,243,193,1050,700,1003,343,243,daskShared_local/images/Image_949.jpg,949,"[array([[[ 21, 164, 157],
        [  1, 140, 130],
        [  5, 140, 127],
        ...,
        [ 18,  40,  39],
        [ 33,  46,  46],
        [ 29,  43,  43]],

       [[ 30, 192, 189],
        [  9, 163, 157],
        [  4, 138, 130],
        ...,
        [ 21,  29,  39],
        [ 33,  38,  46],
        [ 35,  47,  53]],

       [[ 30, 181, 181],
        [  7, 174, 164],
        [  3, 152, 143],
        ...,
        [ 42,  60,  73],
        [ 22,  34,  48],
        [ 37,  50,  63]],

       ...,

       [[ 34,  49,  52],
        [ 36,  51,  54],
        [ 38,  52,  55],
        ...,
        [ 26,  24,  32],
        [ 30,  24,  32],
        [ 31,  20,  36]],

       [[ 40,  55,  58],
        [ 31,  46,  49],
        [ 36,  50,  53],
        ...,
        [ 33,  29,  38],
        [ 45,  34,  45],
        [ 34,  25,  38]],

       [[ 43,  58,  59],
        [ 27,  41,  42],
        [ 34,  48,  49],
        ...,
        [ 29,  32,  39],
        [ 30,  33,  40],
        [ 42,  40,  49]]], dtype=uint8)]"
Image_95.jpg,328,275,248,226,750,740,576,501,248,daskShared_local/images/Image_95.jpg,95,"[array([[[ 31, 223, 236],
        [ 35, 219, 235],
        [ 41, 216, 233],
        ...,
        [ 13, 195, 216],
        [ 12, 194, 215],
        [ 12, 194, 215]],

       [[ 10, 214, 224],
        [ 15, 210, 222],
        [ 20, 206, 222],
        ...,
        [ 13, 195, 216],
        [ 12, 194, 215],
        [ 12, 194, 215]],

       [[ 11, 221, 228],
        [ 14, 217, 226],
        [ 18, 211, 223],
        ...,
        [ 13, 195, 216],
        [ 13, 194, 215],
        [ 13, 194, 215]],

       ...,

       [[103, 157,  94],
        [115, 167, 111],
        [125, 175, 126],
        ...,
        [140, 187, 199],
        [139, 186, 200],
        [135, 184, 198]],

       [[105, 151,  93],
        [113, 157, 106],
        [125, 165, 121],
        ...,
        [142, 185, 202],
        [140, 184, 203],
        [135, 180, 200]],

       [[114, 154, 101],
        [115, 154, 107],
        [122, 157, 117],
        ...,
        [145, 185, 206],
        [143, 185, 208],
        [140, 182, 206]]], dtype=uint8)]"
Image_950.jpg,355,103,307,284,1024,670,662,387,307,daskShared_local/images/Image_950.jpg,950,"[array([[[  5,  70, 120],
        [  4,  70, 117],
        [  3,  67, 113],
        ...,
        [  6,  18,  32],
        [  6,  18,  32],
        [  7,  19,  33]],

       [[  3,  67, 115],
        [  3,  67, 113],
        [  2,  66, 111],
        ...,
        [  7,  19,  33],
        [  4,  16,  30],
        [  5,  17,  31]],

       [[  0,  63, 110],
        [  1,  63, 107],
        [  3,  66, 109],
        ...,
        [  7,  18,  37],
        [  2,  14,  30],
        [  3,  15,  29]],

       ...,

       [[ 76, 141,  85],
        [ 78, 141,  88],
        [ 28,  83,  39],
        ...,
        [  8,  23,  28],
        [  5,  23,  27],
        [  5,  24,  28]],

       [[ 39,  84,  50],
        [ 25,  63,  26],
        [  4,  40,   0],
        ...,
        [  7,  21,  24],
        [  6,  21,  24],
        [  5,  22,  25]],

       [[ 15,  38,  23],
        [ 27,  40,  16],
        [ 34,  51,   6],
        ...,
        [  7,  19,  22],
        [  5,  17,  21],
        [  7,  21,  24]]], dtype=uint8)]"
Image_951.jpg,268,317,160,126,900,599,428,443,160,daskShared_local/images/Image_951.jpg,951,"[array([[[ 67, 139, 215],
        [ 67, 139, 215],
        [ 67, 139, 215],
        ...,
        [ 75, 139, 184],
        [ 87, 142, 180],
        [103, 153, 185]],

       [[ 68, 138, 215],
        [ 68, 138, 215],
        [ 68, 138, 215],
        ...,
        [ 84, 144, 186],
        [105, 157, 191],
        [133, 178, 206]],

       [[ 69, 138, 215],
        [ 69, 138, 215],
        [ 69, 138, 215],
        ...,
        [110, 168, 206],
        [141, 189, 219],
        [169, 210, 233]],

       ...,

       [[ 46,  86, 165],
        [ 46,  86, 165],
        [ 46,  86, 165],
        ...,
        [ 47,  90, 168],
        [ 47,  90, 168],
        [ 47,  90, 168]],

       [[ 47,  86, 165],
        [ 47,  86, 165],
        [ 47,  86, 165],
        ...,
        [ 47,  90, 168],
        [ 47,  90, 168],
        [ 47,  90, 168]],

       [[ 46,  85, 164],
        [ 46,  85, 164],
        [ 46,  85, 164],
        ...,
        [ 46,  89, 167],
        [ 46,  89, 167],
        [ 46,  89, 167]]], dtype=uint8)]"
Image_952.jpg,283,164,257,233,1000,541,540,397,257,daskShared_local/images/Image_952.jpg,952,"[array([[[ 40, 131, 165],
        [ 50, 123, 156],
        [ 55, 114, 149],
        ...,
        [  5,  90, 116],
        [ 13,  85, 109],
        [ 24,  81, 102]],

       [[ 42, 133, 168],
        [ 53, 125, 161],
        [ 59, 115, 152],
        ...,
        [  1,  88, 110],
        [ 10,  86, 105],
        [ 21,  82,  99]],

       [[ 44, 135, 173],
        [ 54, 127, 165],
        [ 61, 118, 157],
        ...,
        [  4,  82, 102],
        [ 13,  81,  99],
        [ 23,  78,  93]],

       ...,

       [[ 14,  71,  86],
        [  2,  45,  58],
        [  0,  31,  38],
        ...,
        [131, 148, 165],
        [185, 202, 224],
        [171, 188, 215]],

       [[ 11,  69,  89],
        [  1,  45,  61],
        [  0,  31,  40],
        ...,
        [154, 170, 192],
        [139, 161, 186],
        [ 96, 123, 151]],

       [[  1,  51,  68],
        [  2,  46,  61],
        [  1,  39,  51],
        ...,
        [141, 155, 175],
        [135, 157, 176],
        [137, 167, 186]]], dtype=uint8)]"
Image_953.jpg,389,176,156,136,770,578,545,312,156,daskShared_local/images/Image_953.jpg,953,"[array([[[ 68,  76,  79],
        [ 74,  83,  83],
        [ 79,  89,  87],
        ...,
        [130, 126, 123],
        [120, 117, 111],
        [110, 109, 100]],

       [[ 64,  71,  73],
        [ 70,  78,  78],
        [ 77,  86,  83],
        ...,
        [120, 116, 112],
        [112, 109, 103],
        [108, 108,  96]],

       [[ 71,  75,  78],
        [ 74,  80,  80],
        [ 79,  87,  84],
        ...,
        [106, 101,  98],
        [101,  98,  90],
        [ 98,  99,  85]],

       ...,

       [[142, 147, 151],
        [123, 129, 132],
        [107, 113, 117],
        ...,
        [163, 159, 165],
        [169, 166, 172],
        [ 98,  98, 104]],

       [[151, 155, 156],
        [126, 130, 131],
        [110, 114, 115],
        ...,
        [180, 168, 177],
        [204, 196, 205],
        [145, 147, 155]],

       [[153, 157, 158],
        [131, 135, 136],
        [110, 114, 115],
        ...,
        [183, 171, 179],
        [230, 222, 231],
        [190, 192, 199]]], dtype=uint8)]"
Image_954.jpg,296,350,178,167,1024,683,474,517,178,daskShared_local/images/Image_954.jpg,954,"[array([[[169, 175, 160],
        [148, 154, 141],
        [142, 148, 142],
        ...,
        [ 42,  46,  46],
        [ 42,  48,  42],
        [ 44,  50,  45]],

       [[186, 188, 171],
        [167, 170, 155],
        [154, 157, 147],
        ...,
        [ 55,  53,  50],
        [ 46,  49,  39],
        [ 43,  44,  37]],

       [[209, 207, 186],
        [191, 190, 171],
        [174, 175, 161],
        ...,
        [ 70,  60,  56],
        [ 62,  58,  47],
        [ 52,  50,  39]],

       ...,

       [[  0, 108, 131],
        [  0, 108, 131],
        [  0, 108, 131],
        ...,
        [  1, 114, 140],
        [  0, 113, 139],
        [  0, 113, 139]],

       [[  0, 108, 131],
        [  0, 108, 131],
        [  0, 108, 131],
        ...,
        [  1, 114, 140],
        [  0, 113, 139],
        [  0, 113, 139]],

       [[  0, 108, 131],
        [  0, 109, 132],
        [  0, 109, 132],
        ...,
        [  0, 114, 140],
        [  0, 113, 139],
        [  0, 113, 139]]], dtype=uint8)]"
Image_955.jpg,186,185,466,339,1599,1065,652,524,466,daskShared_local/images/Image_955.jpg,955,"[array([[[ 5,  1,  2],
        [ 5,  1,  2],
        [ 5,  1,  2],
        ...,
        [ 3,  1,  2],
        [ 3,  1,  2],
        [ 3,  1,  2]],

       [[ 5,  1,  2],
        [ 5,  1,  2],
        [ 5,  1,  2],
        ...,
        [ 2,  2,  2],
        [ 2,  2,  2],
        [ 2,  2,  2]],

       [[ 5,  1,  2],
        [ 5,  1,  2],
        [ 5,  1,  2],
        ...,
        [ 2,  2,  2],
        [ 2,  2,  2],
        [ 2,  2,  2]],

       ...,

       [[ 3,  1,  2],
        [ 3,  1,  2],
        [ 3,  1,  2],
        ...,
        [ 1,  2,  4],
        [ 4,  1,  5],
        [ 3,  1,  3]],

       [[ 3,  1,  2],
        [ 3,  1,  2],
        [ 3,  1,  2],
        ...,
        [ 1,  5, 12],
        [ 2,  3,  8],
        [ 1,  4,  3]],

       [[ 3,  1,  2],
        [ 3,  1,  2],
        [ 3,  1,  2],
        ...,
        [ 4, 16, 19],
        [ 8, 17, 16],
        [ 3, 16, 10]]], dtype=uint8)]"
Image_956.JPG,281,459,1524,1461,2560,1920,1805,1920,1524,daskShared_local/images/Image_956.JPG,956,"[array([[[ 82,  67,  24],
        [ 81,  66,  30],
        [ 82,  69,  34],
        ...,
        [173, 160, 130],
        [188, 172, 149],
        [200, 187, 156]],

       [[ 80,  63,  29],
        [ 82,  67,  28],
        [ 86,  70,  30],
        ...,
        [139, 127,  76],
        [159, 150, 113],
        [175, 166, 136]],

       [[ 81,  62,  23],
        [ 83,  67,  21],
        [ 92,  75,  26],
        ...,
        [121, 105,  61],
        [124, 113,  62],
        [142, 134,  96]],

       ...,

       [[ 79,  85,  34],
        [ 80,  84,  30],
        [ 76,  87,  24],
        ...,
        [ 92, 100,  31],
        [ 91, 100,  29],
        [ 87, 102,  26]],

       [[ 81,  88,  29],
        [ 78,  87,  30],
        [ 72,  88,  31],
        ...,
        [ 90,  99,  32],
        [ 91,  98,  31],
        [ 91, 100,  28]],

       [[ 84,  87,  29],
        [ 76,  88,  34],
        [ 73,  86,  33],
        ...,
        [ 91, 101,  27],
        [ 89, 101,  28],
        [ 91, 100,  30]]], dtype=uint8)]"
Image_957.jpg,287,407,195,197,1024,768,482,604,197,daskShared_local/images/Image_957.jpg,957,"[array([[[123, 106,  96],
        [ 91,  75,  59],
        [100,  84,  69],
        ...,
        [117, 104,  85],
        [ 94,  81,  65],
        [ 72,  56,  43]],

       [[164, 150, 144],
        [ 99,  82,  75],
        [ 81,  68,  59],
        ...,
        [113,  97,  81],
        [ 80,  64,  51],
        [ 62,  48,  37]],

       [[ 59,  37,  39],
        [ 42,  22,  21],
        [ 68,  49,  43],
        ...,
        [ 72,  50,  37],
        [ 82,  64,  52],
        [ 57,  40,  30]],

       ...,

       [[223, 203, 166],
        [231, 210, 165],
        [236, 212, 176],
        ...,
        [194, 165, 123],
        [210, 178, 139],
        [208, 176, 138]],

       [[212, 189, 148],
        [219, 197, 150],
        [230, 207, 165],
        ...,
        [198, 165, 122],
        [186, 153, 112],
        [179, 145, 108]],

       [[226, 201, 161],
        [224, 200, 156],
        [226, 202, 158],
        ...,
        [197, 163, 118],
        [217, 184, 141],
        [200, 168, 129]]], dtype=uint8)]"
Image_958.jpg,526,198,325,284,986,653,851,482,325,daskShared_local/images/Image_958.jpg,958,"[array([[[ 87,  98,  40],
        [ 80, 100,  42],
        [ 74,  93,  39],
        ...,
        [ 60, 124, 100],
        [ 59, 126, 102],
        [ 60, 127, 102]],

       [[ 85,  96,  40],
        [ 76,  95,  39],
        [ 70,  88,  35],
        ...,
        [ 59, 123,  99],
        [ 60, 125, 101],
        [ 61, 126, 102]],

       [[ 82,  95,  39],
        [ 75,  93,  38],
        [ 68,  85,  35],
        ...,
        [ 59, 122,  99],
        [ 59, 124, 100],
        [ 60, 125, 101]],

       ...,

       [[ 79,  96,  29],
        [ 70,  93,  35],
        [ 69,  92,  38],
        ...,
        [ 49,  75,  40],
        [ 50,  78,  38],
        [ 49,  77,  38]],

       [[ 81, 100,  36],
        [ 70,  93,  41],
        [ 68,  90,  42],
        ...,
        [ 48,  74,  39],
        [ 49,  77,  39],
        [ 48,  76,  38]],

       [[ 74,  92,  33],
        [ 66,  85,  41],
        [ 64,  82,  39],
        ...,
        [ 48,  74,  38],
        [ 46,  74,  36],
        [ 45,  73,  35]]], dtype=uint8)]"
Image_959.jpg,663,220,340,323,2121,1063,1003,543,340,daskShared_local/images/Image_959.jpg,959,"[array([[[139, 163, 169],
        [145, 166, 170],
        [141, 160, 161],
        ...,
        [149, 172, 186],
        [144, 167, 181],
        [145, 169, 181]],

       [[ 90, 122, 131],
        [120, 150, 156],
        [137, 163, 167],
        ...,
        [145, 168, 182],
        [145, 168, 182],
        [137, 160, 174]],

       [[ 72, 115, 126],
        [ 77, 116, 124],
        [ 89, 124, 129],
        ...,
        [147, 169, 182],
        [145, 167, 181],
        [138, 160, 173]],

       ...,

       [[ 62, 111, 129],
        [ 62, 110, 130],
        [ 57, 105, 125],
        ...,
        [163, 163, 150],
        [142, 142, 128],
        [155, 151, 137]],

       [[ 62, 110, 128],
        [ 59, 107, 127],
        [ 58, 106, 126],
        ...,
        [172, 169, 154],
        [144, 141, 124],
        [158, 153, 135]],

       [[ 59, 107, 126],
        [ 56, 104, 124],
        [ 59, 107, 127],
        ...,
        [152, 146, 128],
        [131, 124, 106],
        [159, 152, 133]]], dtype=uint8)]"
Image_96.jpg,628,443,214,199,1024,672,842,642,214,daskShared_local/images/Image_96.jpg,96,"[array([[[ 93,  96, 105],
        [ 90,  90,  99],
        [ 94,  93, 101],
        ...,
        [ 43,  60,  61],
        [ 45,  61,  56],
        [ 38,  54,  45]],

       [[ 77,  79,  91],
        [ 76,  76,  86],
        [ 86,  85,  93],
        ...,
        [ 58,  79,  84],
        [ 46,  66,  66],
        [ 34,  54,  49]],

       [[ 71,  71,  83],
        [ 71,  71,  81],
        [ 79,  76,  87],
        ...,
        [ 85, 111, 119],
        [ 68,  92, 100],
        [ 47,  69,  74]],

       ...,

       [[ 28,  83, 148],
        [ 30,  85, 149],
        [ 31,  86, 149],
        ...,
        [ 12, 114, 223],
        [ 18, 120, 229],
        [ 21, 123, 231]],

       [[ 31,  86, 151],
        [ 31,  86, 150],
        [ 29,  84, 148],
        ...,
        [ 13, 114, 222],
        [ 18, 120, 228],
        [ 23, 125, 233]],

       [[ 32,  90, 154],
        [ 31,  89, 152],
        [ 30,  88, 151],
        ...,
        [ 13, 114, 222],
        [ 17, 119, 227],
        [ 20, 122, 230]]], dtype=uint8)]"
Image_960.jpg,1055,1205,937,838,3840,2160,1992,2043,937,daskShared_local/images/Image_960.jpg,960,"[array([[[167, 140, 122],
        [162, 138, 122],
        [140, 121, 113],
        ...,
        [ 56,  47,  40],
        [ 65,  56,  45],
        [ 75,  65,  55]],

       [[125, 108,  95],
        [111,  97,  85],
        [106,  92,  86],
        ...,
        [ 62,  52,  47],
        [ 60,  49,  43],
        [ 65,  54,  49]],

       [[ 98,  86,  83],
        [ 98,  85,  82],
        [ 93,  78,  78],
        ...,
        [ 69,  57,  55],
        [ 65,  54,  50],
        [ 55,  45,  39]],

       ...,

       [[  4,  24,  31],
        [  5,  24,  31],
        [  5,  24,  31],
        ...,
        [  2,  17,  22],
        [  3,  18,  22],
        [  6,  21,  25]],

       [[  5,  24,  31],
        [  5,  24,  31],
        [  5,  24,  31],
        ...,
        [  3,  17,  22],
        [  3,  18,  22],
        [  5,  19,  25]],

       [[  3,  22,  28],
        [  4,  23,  29],
        [  4,  23,  29],
        ...,
        [  3,  17,  22],
        [  3,  17,  22],
        [  5,  18,  24]]], dtype=uint8)]"
Image_961.jpg,67,136,117,110,525,340,184,246,117,daskShared_local/images/Image_961.jpg,961,"[array([[[ 37,  90, 107],
        [ 36,  89, 106],
        [ 33,  86, 102],
        ...,
        [156, 184, 156],
        [157, 183, 152],
        [157, 182, 151]],

       [[ 37,  90, 107],
        [ 36,  89, 106],
        [ 32,  85, 101],
        ...,
        [167, 194, 166],
        [161, 187, 157],
        [159, 185, 154]],

       [[ 36,  89, 107],
        [ 35,  88, 105],
        [ 30,  83,  99],
        ...,
        [201, 227, 198],
        [176, 201, 171],
        [168, 194, 162]],

       ...,

       [[ 92, 120, 108],
        [ 84, 111,  99],
        [ 55,  83,  71],
        ...,
        [193, 216, 196],
        [210, 231, 212],
        [215, 236, 217]],

       [[ 55,  72,  62],
        [ 53,  70,  61],
        [ 49,  66,  57],
        ...,
        [ 76,  91,  78],
        [ 83,  98,  84],
        [ 85, 101,  86]],

       [[ 43,  57,  48],
        [ 44,  58,  49],
        [ 48,  61,  52],
        ...,
        [ 40,  52,  41],
        [ 44,  58,  44],
        [ 45,  59,  45]]], dtype=uint8)]"
Image_962.jpg,559,177,101,90,1000,700,660,267,101,daskShared_local/images/Image_962.jpg,962,"[array([[[  2, 159, 230],
        [  2, 159, 230],
        [  1, 159, 230],
        ...,
        [  0, 157, 229],
        [  0, 157, 230],
        [  0, 157, 230]],

       [[  2, 159, 230],
        [  2, 159, 230],
        [  1, 159, 230],
        ...,
        [  0, 157, 229],
        [  0, 157, 230],
        [  0, 157, 230]],

       [[  2, 159, 230],
        [  2, 159, 230],
        [  2, 159, 230],
        ...,
        [  0, 157, 229],
        [  0, 158, 230],
        [  0, 158, 230]],

       ...,

       [[136, 174, 191],
        [136, 174, 191],
        [152, 189, 201],
        ...,
        [  0, 149, 221],
        [  0, 150, 222],
        [  0, 150, 222]],

       [[101, 146, 164],
        [101, 146, 165],
        [114, 156, 170],
        ...,
        [  0, 150, 221],
        [  0, 150, 221],
        [  0, 150, 221]],

       [[ 99, 145, 163],
        [100, 145, 164],
        [112, 155, 169],
        ...,
        [  0, 150, 221],
        [  0, 150, 221],
        [  0, 150, 221]]], dtype=uint8)]"
Image_963.jpg,389,32,1105,992,1920,1080,1494,1024,1105,daskShared_local/images/Image_963.jpg,963,"[array([[[  0, 125, 157],
        [  0, 124, 156],
        [  0, 124, 156],
        ...,
        [  2,  93, 101],
        [  2,  87, 105],
        [  1,  78, 105]],

       [[  0, 125, 157],
        [  0, 124, 155],
        [  0, 123, 156],
        ...,
        [  2,  75,  80],
        [  1,  87,  92],
        [  1,  88, 100]],

       [[  0, 124, 156],
        [  0, 123, 155],
        [  0, 123, 154],
        ...,
        [  5,  60,  67],
        [  3,  66,  72],
        [  1,  74,  83]],

       ...,

       [[112, 105,  67],
        [101,  95,  55],
        [ 83,  79,  40],
        ...,
        [ 37,  32,  23],
        [ 43,  39,  26],
        [ 47,  43,  29]],

       [[ 96,  88,  50],
        [ 82,  78,  41],
        [ 75,  73,  38],
        ...,
        [ 50,  42,  30],
        [ 53,  45,  30],
        [ 53,  46,  31]],

       [[ 79,  75,  39],
        [ 75,  74,  38],
        [ 71,  72,  39],
        ...,
        [ 55,  47,  34],
        [ 58,  47,  35],
        [ 57,  50,  34]]], dtype=uint8)]"
Image_964.jpg,302,82,163,173,732,420,465,255,173,daskShared_local/images/Image_964.jpg,964,"[array([[[  0, 165, 215],
        [  0, 166, 216],
        [  1, 167, 217],
        ...,
        [  0, 188, 220],
        [  1, 184, 220],
        [  4, 181, 219]],

       [[  0, 166, 216],
        [  0, 166, 216],
        [  1, 167, 217],
        ...,
        [  0, 184, 214],
        [  0, 184, 217],
        [  1, 184, 219]],

       [[  0, 166, 216],
        [  0, 166, 216],
        [  1, 167, 217],
        ...,
        [  3, 181, 212],
        [  0, 182, 212],
        [  0, 185, 216]],

       ...,

       [[159, 120,  89],
        [164, 128,  96],
        [163, 128,  97],
        ...,
        [ 10,  82,  73],
        [  2,  57,  42],
        [  9,  49,  26]],

       [[198, 175, 149],
        [189, 166, 141],
        [159, 137, 112],
        ...,
        [  1,  63,  50],
        [  9,  64,  41],
        [ 33,  81,  50]],

       [[204, 198, 177],
        [210, 203, 183],
        [201, 195, 175],
        ...,
        [  5,  53,  40],
        [ 22,  68,  48],
        [ 48,  85,  59]]], dtype=uint8)]"
Image_965.jpg,440,367,212,218,1024,683,652,585,218,daskShared_local/images/Image_965.jpg,965,"[array([[[ 78,  66,  66],
        [ 93,  83,  88],
        [ 83,  73,  77],
        ...,
        [ 58,  39,  30],
        [ 57,  42,  32],
        [ 62,  52,  43]],

       [[114, 101, 103],
        [115,  93,  91],
        [ 98,  73,  68],
        ...,
        [ 52,  40,  36],
        [ 49,  38,  34],
        [ 55,  46,  39]],

       [[130, 114, 116],
        [122, 100,  97],
        [115,  92,  87],
        ...,
        [ 59,  47,  43],
        [ 51,  40,  36],
        [ 51,  42,  35]],

       ...,

       [[190, 159, 134],
        [237, 209, 184],
        [202, 177, 148],
        ...,
        [245, 213, 177],
        [211, 175, 134],
        [239, 225, 176]],

       [[207, 181, 158],
        [249, 242, 216],
        [218, 210, 181],
        ...,
        [242, 191, 148],
        [192, 141,  97],
        [241, 198, 152]],

       [[196, 175, 131],
        [221, 189, 152],
        [194, 165, 130],
        ...,
        [216, 164, 107],
        [242, 186, 131],
        [254, 219, 162]]], dtype=uint8)]"
Image_966.jpg,540,88,300,309,1024,770,840,397,309,daskShared_local/images/Image_966.jpg,966,"[array([[[  1, 113, 186],
        [  2, 114, 187],
        [  3, 115, 188],
        ...,
        [ 38,  49,  56],
        [ 53,  64,  73],
        [ 43,  56,  65]],

       [[  2, 113, 185],
        [  3, 114, 186],
        [  3, 114, 186],
        ...,
        [ 39,  52,  60],
        [ 39,  53,  62],
        [ 59,  74,  84]],

       [[  2, 113, 185],
        [  2, 113, 185],
        [  2, 113, 185],
        ...,
        [ 40,  55,  66],
        [ 39,  56,  67],
        [ 61,  79,  92]],

       ...,

       [[122, 121,  94],
        [ 82,  82,  68],
        [ 54,  55,  49],
        ...,
        [ 37,  35,  32],
        [ 36,  37,  32],
        [ 43,  47,  41]],

       [[145, 144, 117],
        [103, 103,  90],
        [ 49,  48,  43],
        ...,
        [ 46,  47,  43],
        [ 42,  45,  40],
        [ 46,  53,  46]],

       [[135, 132, 105],
        [106, 105,  91],
        [ 40,  40,  32],
        ...,
        [ 50,  53,  48],
        [ 53,  62,  55],
        [ 43,  55,  46]]], dtype=uint8)]"
Image_967.jpg,2228,254,633,544,3033,1757,2861,798,633,daskShared_local/images/Image_967.jpg,967,"[array([[[  0,  53, 217],
        [  0,  53, 217],
        [  0,  53, 217],
        ...,
        [  0,  53, 217],
        [  0,  53, 217],
        [  0,  53, 217]],

       [[  0,  53, 217],
        [  0,  53, 217],
        [  0,  53, 217],
        ...,
        [  0,  53, 217],
        [  0,  53, 217],
        [  0,  53, 217]],

       [[  0,  53, 217],
        [  0,  53, 217],
        [  0,  53, 217],
        ...,
        [  0,  53, 217],
        [  0,  53, 217],
        [  0,  53, 217]],

       ...,

       [[ 38,  42,  21],
        [ 40,  45,  22],
        [ 46,  54,  28],
        ...,
        [  0,  53, 217],
        [  0,  53, 217],
        [  0,  53, 217]],

       [[ 33,  36,  21],
        [ 33,  37,  21],
        [ 32,  39,  22],
        ...,
        [  0,  53, 217],
        [  0,  53, 217],
        [  0,  53, 217]],

       [[ 31,  34,  20],
        [ 27,  30,  18],
        [ 24,  29,  18],
        ...,
        [  0,  53, 217],
        [  0,  53, 217],
        [  0,  53, 217]]], dtype=uint8)]"
Image_968.jpg,521,376,179,162,1024,678,700,538,179,daskShared_local/images/Image_968.jpg,968,"[array([[[131, 120, 117],
        [128, 116, 113],
        [139, 124, 124],
        ...,
        [159, 131, 108],
        [138, 110,  86],
        [136, 107,  70]],

       [[124, 114, 112],
        [ 96,  81,  88],
        [111,  91, 103],
        ...,
        [158, 134, 101],
        [137, 117,  91],
        [181, 164, 134]],

       [[138, 133, 129],
        [103,  91,  98],
        [107,  90, 102],
        ...,
        [136, 111,  79],
        [174, 156, 126],
        [203, 189, 160]],

       ...,

       [[248, 242, 217],
        [244, 237, 210],
        [245, 232, 199],
        ...,
        [251, 234, 183],
        [248, 229, 181],
        [236, 217, 170]],

       [[246, 243, 220],
        [243, 238, 214],
        [250, 240, 212],
        ...,
        [245, 223, 171],
        [242, 220, 168],
        [240, 217, 166]],

       [[240, 227, 193],
        [241, 228, 195],
        [247, 235, 204],
        ...,
        [237, 208, 152],
        [240, 216, 156],
        [237, 213, 154]]], dtype=uint8)]"
Image_969.jpg,470,119,110,91,685,360,580,210,110,daskShared_local/images/Image_969.jpg,969,"[array([[[  0, 104, 144],
        [  0, 104, 144],
        [  0, 104, 144],
        ...,
        [  0, 101, 145],
        [  0, 101, 145],
        [  0, 101, 145]],

       [[  0, 104, 144],
        [  0, 104, 144],
        [  0, 105, 145],
        ...,
        [  0, 101, 145],
        [  0, 101, 145],
        [  0, 101, 145]],

       [[  0, 105, 145],
        [  0, 105, 145],
        [  0, 106, 146],
        ...,
        [  0, 101, 145],
        [  0, 101, 145],
        [  0, 101, 145]],

       ...,

       [[  1,  85, 121],
        [  1,  85, 121],
        [  1,  85, 121],
        ...,
        [  0,  82, 116],
        [  0,  82, 116],
        [  0,  82, 116]],

       [[  1,  85, 121],
        [  1,  85, 121],
        [  1,  85, 121],
        ...,
        [  0,  82, 116],
        [  0,  82, 116],
        [  0,  82, 116]],

       [[  1,  85, 121],
        [  1,  85, 121],
        [  1,  85, 121],
        ...,
        [  0,  82, 116],
        [  0,  82, 116],
        [  0,  82, 116]]], dtype=uint8)]"
Image_97.jpg,307,110,225,307,1000,667,532,417,307,daskShared_local/images/Image_97.jpg,97,"[array([[[ 54,  96, 138],
        [ 76, 109, 139],
        [113, 127, 140],
        ...,
        [249, 237, 221],
        [253, 241, 225],
        [239, 226, 210]],

       [[141, 143, 163],
        [184, 169, 170],
        [194, 164, 152],
        ...,
        [252, 245, 233],
        [253, 245, 233],
        [252, 244, 232]],

       [[224, 203, 183],
        [224, 197, 169],
        [216, 190, 159],
        ...,
        [251, 246, 234],
        [231, 225, 213],
        [210, 200, 188]],

       ...,

       [[ 59, 132, 184],
        [ 59, 132, 184],
        [ 59, 132, 184],
        ...,
        [116,  90,  40],
        [ 80,  64,  29],
        [ 58,  50,  30]],

       [[ 57, 133, 183],
        [ 57, 133, 183],
        [ 57, 133, 183],
        ...,
        [ 82,  71,  44],
        [ 55,  50,  30],
        [ 45,  43,  27]],

       [[ 52, 129, 178],
        [ 52, 128, 177],
        [ 51, 127, 176],
        ...,
        [ 50,  43,  27],
        [ 51,  49,  31],
        [ 39,  38,  20]]], dtype=uint8)]"
Image_970.jpg,323,260,140,141,1000,667,463,401,141,daskShared_local/images/Image_970.jpg,970,"[array([[[  1, 209, 228],
        [  1, 209, 227],
        [  0, 210, 227],
        ...,
        [ 85, 217, 239],
        [ 84, 216, 238],
        [ 76, 215, 237]],

       [[  3, 210, 228],
        [  2, 210, 227],
        [  1, 210, 227],
        ...,
        [ 68, 215, 238],
        [ 65, 215, 237],
        [ 60, 214, 237]],

       [[  4, 211, 227],
        [  4, 210, 227],
        [  5, 210, 227],
        ...,
        [ 40, 213, 235],
        [ 40, 213, 235],
        [ 44, 213, 236]],

       ...,

       [[182, 124,  23],
        [180, 127,  18],
        [176, 125,  10],
        ...,
        [ 28,  53,  81],
        [ 24,  34,  54],
        [ 22,  22,  37]],

       [[183, 127,  36],
        [184, 135,  38],
        [186, 140,  36],
        ...,
        [ 62,  73,  91],
        [ 57,  56,  67],
        [ 53,  41,  47]],

       [[183, 127,  43],
        [189, 139,  53],
        [197, 151,  58],
        ...,
        [ 87,  88,  95],
        [ 84,  76,  78],
        [ 81,  61,  59]]], dtype=uint8)]"
Image_971.jpg,579,53,173,168,930,500,752,221,173,daskShared_local/images/Image_971.jpg,971,"[array([[[  8, 146, 208],
        [  7, 145, 207],
        [  7, 145, 207],
        ...,
        [ 10, 146, 204],
        [  9, 145, 203],
        [  9, 145, 203]],

       [[ 10, 148, 211],
        [ 10, 148, 210],
        [  9, 147, 210],
        ...,
        [ 10, 146, 204],
        [ 10, 146, 204],
        [ 10, 146, 204]],

       [[ 12, 150, 213],
        [ 11, 149, 212],
        [ 10, 148, 211],
        ...,
        [  9, 145, 203],
        [  9, 145, 203],
        [ 10, 146, 204]],

       ...,

       [[215, 215, 213],
        [212, 212, 210],
        [189, 189, 187],
        ...,
        [  7, 135, 200],
        [  7, 135, 200],
        [  7, 135, 200]],

       [[165, 165, 163],
        [172, 172, 170],
        [171, 171, 169],
        ...,
        [  7, 135, 200],
        [  7, 135, 200],
        [  8, 136, 201]],

       [[162, 162, 160],
        [181, 181, 179],
        [207, 207, 205],
        ...,
        [  8, 136, 201],
        [  8, 136, 201],
        [  8, 136, 201]]], dtype=uint8)]"
Image_972.jpg,1290,629,331,274,2106,1578,1621,903,331,daskShared_local/images/Image_972.jpg,972,"[array([[[ 31, 145, 146],
        [ 29, 145, 144],
        [ 29, 145, 144],
        ...,
        [ 14, 144, 147],
        [ 17, 146, 149],
        [ 18, 145, 150]],

       [[ 29, 147, 147],
        [ 27, 145, 145],
        [ 30, 145, 144],
        ...,
        [ 22, 144, 145],
        [ 24, 146, 149],
        [ 19, 141, 147]],

       [[ 24, 146, 146],
        [ 26, 146, 145],
        [ 28, 146, 145],
        ...,
        [ 24, 145, 146],
        [ 23, 145, 148],
        [ 23, 145, 147]],

       ...,

       [[ 34, 159, 152],
        [ 28, 160, 154],
        [ 32, 160, 153],
        ...,
        [ 31, 167, 157],
        [ 32, 163, 156],
        [ 31, 161, 151]],

       [[ 36, 164, 153],
        [ 33, 165, 154],
        [ 32, 158, 154],
        ...,
        [ 37, 164, 157],
        [ 34, 159, 153],
        [ 35, 161, 155]],

       [[ 34, 156, 152],
        [ 32, 156, 152],
        [ 31, 156, 153],
        ...,
        [ 28, 165, 155],
        [ 32, 165, 156],
        [ 29, 163, 155]]], dtype=uint8)]"
Image_973.jpg,941,244,234,187,1600,1280,1175,431,234,daskShared_local/images/Image_973.jpg,973,"[array([[[  0,  98,  86],
        [  0,  99,  77],
        [  5, 103,  79],
        ...,
        [ 41, 169, 137],
        [ 43, 180, 146],
        [ 28, 172, 136]],

       [[  3, 113, 112],
        [  0, 108,  97],
        [  4, 105,  88],
        ...,
        [ 23, 167, 121],
        [ 33, 184, 137],
        [ 20, 178, 129]],

       [[  2, 113, 120],
        [  1, 107, 108],
        [  8, 105,  98],
        ...,
        [ 25, 169, 117],
        [ 34, 184, 129],
        [ 29, 185, 125]],

       ...,

       [[ 77,  24,   7],
        [118,  79,  78],
        [151, 126, 136],
        ...,
        [ 47, 185, 127],
        [ 39, 181, 125],
        [ 30, 176, 126]],

       [[142,  94,  77],
        [198, 161, 157],
        [211, 185, 185],
        ...,
        [ 44, 173, 112],
        [ 40, 173, 116],
        [ 34, 172, 120]],

       [[194, 145, 113],
        [222, 184, 149],
        [232, 204, 162],
        ...,
        [ 48, 168, 108],
        [ 51, 174, 116],
        [ 49, 178, 124]]], dtype=uint8)]"
Image_974.jpg,378,179,477,408,1280,854,855,587,477,daskShared_local/images/Image_974.jpg,974,"[array([[[110, 142, 168],
        [109, 141, 166],
        [109, 140, 165],
        ...,
        [ 18, 210, 246],
        [ 18, 210, 246],
        [ 18, 210, 246]],

       [[110, 141, 167],
        [107, 139, 164],
        [106, 137, 163],
        ...,
        [ 18, 210, 246],
        [ 18, 210, 246],
        [ 18, 210, 246]],

       [[106, 138, 164],
        [105, 137, 162],
        [103, 134, 160],
        ...,
        [ 18, 210, 246],
        [ 18, 210, 246],
        [ 18, 210, 246]],

       ...,

       [[ 32, 168, 205],
        [ 38, 168, 207],
        [ 35, 159, 199],
        ...,
        [  7, 189, 237],
        [  9, 190, 239],
        [  9, 189, 238]],

       [[ 47, 176, 211],
        [ 53, 175, 212],
        [ 49, 170, 208],
        ...,
        [  7, 189, 237],
        [  8, 190, 238],
        [ 10, 190, 239]],

       [[ 54, 178, 213],
        [ 61, 178, 213],
        [ 57, 175, 212],
        ...,
        [ 10, 192, 240],
        [ 12, 193, 241],
        [ 12, 192, 241]]], dtype=uint8)]"
Image_975.jpg,61,121,194,176,600,350,255,297,194,daskShared_local/images/Image_975.jpg,975,"[array([[[ 28,  48,  36],
        [ 27,  51,  38],
        [ 25,  53,  39],
        ...,
        [ 53,  43,  44],
        [ 45,  35,  36],
        [ 52,  41,  45]],

       [[ 27,  49,  36],
        [ 25,  52,  37],
        [ 24,  52,  37],
        ...,
        [ 40,  28,  38],
        [ 35,  24,  33],
        [ 38,  28,  39]],

       [[ 26,  50,  34],
        [ 25,  52,  35],
        [ 24,  53,  35],
        ...,
        [ 49,  39,  47],
        [ 48,  38,  47],
        [ 48,  38,  47]],

       ...,

       [[150, 136, 109],
        [153, 138, 111],
        [143, 133, 104],
        ...,
        [116,  65,  50],
        [109,  71,  48],
        [121,  97,  65]],

       [[147, 130, 102],
        [148, 127,  96],
        [153, 130,  98],
        ...,
        [125,  76,  48],
        [110,  63,  37],
        [106,  61,  37]],

       [[160, 145, 116],
        [169, 151, 121],
        [180, 159, 128],
        ...,
        [126,  81,  48],
        [126,  82,  53],
        [122,  81,  53]]], dtype=uint8)]"
Image_976.jpg,129,87,167,133,500,333,296,220,167,daskShared_local/images/Image_976.jpg,976,"[array([[[ 29,  44,  63],
        [ 29,  44,  63],
        [ 28,  43,  62],
        ...,
        [ 28,  46,  68],
        [ 27,  45,  67],
        [ 25,  43,  65]],

       [[ 29,  44,  63],
        [ 29,  44,  63],
        [ 28,  43,  62],
        ...,
        [ 29,  47,  69],
        [ 27,  45,  67],
        [ 26,  44,  66]],

       [[ 28,  43,  62],
        [ 28,  43,  62],
        [ 28,  43,  62],
        ...,
        [ 29,  47,  69],
        [ 27,  45,  67],
        [ 26,  44,  66]],

       ...,

       [[ 26,  44,  58],
        [ 25,  43,  57],
        [ 24,  42,  56],
        ...,
        [118, 135, 125],
        [118, 135, 125],
        [118, 135, 125]],

       [[ 25,  43,  57],
        [ 24,  42,  56],
        [ 24,  42,  56],
        ...,
        [120, 137, 127],
        [120, 137, 127],
        [119, 136, 126]],

       [[ 24,  42,  56],
        [ 24,  42,  56],
        [ 25,  43,  57],
        ...,
        [122, 139, 129],
        [122, 139, 129],
        [121, 138, 128]]], dtype=uint8)]"
Image_977.jpg,393,184,95,59,800,600,488,243,95,daskShared_local/images/Image_977.jpg,977,"[array([[[ 78, 119, 134],
        [ 78, 119, 134],
        [ 80, 121, 134],
        ...,
        [ 67, 124, 158],
        [ 70, 125, 154],
        [ 69, 125, 154]],

       [[ 78, 119, 134],
        [ 78, 119, 134],
        [ 80, 120, 134],
        ...,
        [ 66, 125, 157],
        [ 69, 126, 153],
        [ 69, 126, 153]],

       [[ 79, 121, 134],
        [ 78, 120, 134],
        [ 82, 121, 135],
        ...,
        [ 74, 119, 170],
        [ 78, 120, 163],
        [ 77, 120, 163]],

       ...,

       [[106, 113, 129],
        [107, 114, 129],
        [102, 110, 130],
        ...,
        [ 16, 132, 246],
        [ 17, 133, 244],
        [ 17, 133, 244]],

       [[104, 112, 125],
        [104, 113, 125],
        [100, 108, 126],
        ...,
        [ 16, 132, 243],
        [ 17, 133, 241],
        [ 17, 133, 241]],

       [[104, 112, 126],
        [104, 113, 126],
        [101, 109, 126],
        ...,
        [ 16, 132, 243],
        [ 17, 133, 241],
        [ 17, 133, 242]]], dtype=uint8)]"
Image_978.jpg,877,513,220,210,1920,1200,1097,723,220,daskShared_local/images/Image_978.jpg,978,"[array([[[  0, 112, 114],
        [  3, 112, 115],
        [  3, 112, 115],
        ...,
        [  0, 120, 121],
        [  0, 120, 121],
        [  0, 120, 121]],

       [[  1, 110, 113],
        [  4, 112, 115],
        [  4, 113, 115],
        ...,
        [  3, 123, 124],
        [  2, 122, 123],
        [  3, 123, 124]],

       [[  2, 110, 113],
        [  4, 110, 114],
        [  4, 111, 114],
        ...,
        [  6, 126, 127],
        [  5, 125, 126],
        [  4, 125, 126]],

       ...,

       [[113, 104,  75],
        [108,  98,  72],
        [122, 113,  88],
        ...,
        [132, 104,  56],
        [110,  80,  36],
        [182, 150, 112]],

       [[114, 104,  76],
        [ 88,  78,  53],
        [103,  93,  70],
        ...,
        [166, 133,  87],
        [107,  74,  30],
        [142, 109,  71]],

       [[133, 122,  96],
        [ 89,  79,  57],
        [ 86,  78,  57],
        ...,
        [185, 152, 109],
        [130,  96,  57],
        [117,  83,  47]]], dtype=uint8)]"
Image_979.jpg,164,5,106,107,498,272,270,112,107,daskShared_local/images/Image_979.jpg,979,"[array([[[  4,  31,  61],
        [  4,  31,  61],
        [  4,  31,  61],
        ...,
        [  0,  31,  54],
        [  0,  32,  55],
        [  0,  32,  55]],

       [[  3,  31,  62],
        [  3,  31,  62],
        [  3,  31,  62],
        ...,
        [  0,  31,  54],
        [  0,  32,  55],
        [  0,  32,  55]],

       [[  2,  31,  63],
        [  2,  31,  63],
        [  2,  31,  63],
        ...,
        [  0,  32,  55],
        [  0,  33,  55],
        [  0,  33,  55]],

       ...,

       [[100, 101, 103],
        [101, 102, 104],
        [103, 107, 113],
        ...,
        [180, 195, 191],
        [178, 193, 190],
        [178, 193, 189]],

       [[100, 100, 107],
        [100, 100, 108],
        [101, 104, 113],
        ...,
        [193, 208, 204],
        [199, 214, 210],
        [200, 215, 212]],

       [[100, 100, 108],
        [100, 100, 109],
        [100, 104, 113],
        ...,
        [195, 210, 206],
        [202, 217, 214],
        [203, 218, 215]]], dtype=uint8)]"
Image_98.jpg,398,5,80,64,530,180,478,69,80,daskShared_local/images/Image_98.jpg,98,"[array([[[  4,  25,  67],
        [  4,  25,  68],
        [  3,  24,  65],
        ...,
        [ 20,  37,  80],
        [  8,  27,  70],
        [ 14,  32,  75]],

       [[  5,  26,  68],
        [  6,  27,  70],
        [  4,  25,  67],
        ...,
        [ 18,  35,  80],
        [  5,  24,  68],
        [ 11,  29,  74]],

       [[  3,  24,  65],
        [  3,  24,  66],
        [  2,  23,  64],
        ...,
        [ 22,  38,  80],
        [ 11,  29,  72],
        [ 16,  34,  76]],

       ...,

       [[236, 204, 125],
        [237, 210, 125],
        [235, 198, 126],
        ...,
        [ 62,  58,  62],
        [ 74,  70,  72],
        [ 68,  64,  67]],

       [[246, 225, 155],
        [250, 235, 160],
        [241, 214, 150],
        ...,
        [ 64,  59,  61],
        [ 66,  61,  63],
        [ 65,  60,  62]],

       [[240, 213, 138],
        [243, 220, 140],
        [237, 205, 136],
        ...,
        [ 63,  58,  61],
        [ 71,  66,  68],
        [ 67,  62,  65]]], dtype=uint8)]"
Image_980.JPG,557,396,452,311,1600,1467,1009,707,452,daskShared_local/images/Image_980.JPG,980,"[array([[[ 44,  57,  63],
        [ 45,  59,  77],
        [ 35,  56, 101],
        ...,
        [ 91,  95,  85],
        [ 87,  91,  80],
        [ 84,  88,  76]],

       [[ 45,  59,  66],
        [ 36,  57,  69],
        [ 30,  67, 107],
        ...,
        [ 88,  92,  85],
        [ 84,  89,  81],
        [ 82,  88,  79]],

       [[ 49,  64,  70],
        [ 48,  62,  87],
        [ 36,  73, 110],
        ...,
        [ 81,  85,  79],
        [ 85,  92,  83],
        [ 90,  98,  87]],

       ...,

       [[221, 230, 208],
        [219, 229, 201],
        [219, 229, 198],
        ...,
        [252, 254, 252],
        [250, 251, 250],
        [252, 254, 252]],

       [[216, 227, 196],
        [218, 229, 195],
        [222, 234, 196],
        ...,
        [246, 248, 243],
        [246, 248, 243],
        [253, 254, 250]],

       [[216, 226, 196],
        [218, 232, 194],
        [222, 235, 193],
        ...,
        [245, 247, 242],
        [242, 244, 239],
        [242, 244, 239]]], dtype=uint8)]"
Image_981.jpg,674,283,292,330,1600,900,966,613,330,daskShared_local/images/Image_981.jpg,981,"[array([[[  0, 116, 200],
        [  0, 116, 201],
        [  0, 116, 201],
        ...,
        [  0, 121, 204],
        [  0, 121, 204],
        [  0, 121, 204]],

       [[  0, 117, 198],
        [  0, 116, 201],
        [  0, 116, 201],
        ...,
        [  0, 120, 203],
        [  0, 120, 203],
        [  0, 121, 204]],

       [[  0, 117, 198],
        [  0, 116, 201],
        [  0, 116, 201],
        ...,
        [  0, 120, 203],
        [  0, 120, 203],
        [  0, 121, 204]],

       ...,

       [[203, 197, 169],
        [212, 207, 168],
        [182, 178, 139],
        ...,
        [ 96, 104,  74],
        [126, 129, 100],
        [133, 136, 105]],

       [[168, 163, 133],
        [165, 161, 128],
        [159, 156, 123],
        ...,
        [ 76,  81,  57],
        [151, 154, 127],
        [154, 154, 124]],

       [[193, 191, 156],
        [208, 206, 175],
        [208, 206, 177],
        ...,
        [ 69,  72,  53],
        [127, 129, 106],
        [180, 180, 150]]], dtype=uint8)]"
Image_982.jpg,74,70,92,91,300,260,166,161,92,daskShared_local/images/Image_982.jpg,982,"[array([[[  1, 229, 254],
        [  1, 229, 254],
        [  1, 230, 253],
        ...,
        [  4, 195, 235],
        [  2, 197, 235],
        [  3, 197, 235]],

       [[  1, 230, 254],
        [  1, 229, 254],
        [  1, 230, 253],
        ...,
        [  3, 196, 235],
        [  2, 196, 235],
        [  2, 196, 235]],

       [[  2, 228, 253],
        [  2, 228, 253],
        [  2, 229, 253],
        ...,
        [ 10, 195, 233],
        [  4, 201, 235],
        [  5, 200, 235]],

       ...,

       [[  1, 186, 240],
        [  1, 186, 239],
        [  1, 185, 240],
        ...,
        [  5,  88,  73],
        [  5,  97,  86],
        [  5,  96,  84]],

       [[  0, 186, 238],
        [  0, 186, 238],
        [  0, 185, 239],
        ...,
        [ 12,  97,  85],
        [ 12, 124, 115],
        [ 12, 120, 111]],

       [[  0, 186, 238],
        [  0, 186, 238],
        [  0, 185, 239],
        ...,
        [ 11,  95,  84],
        [ 11, 120, 111],
        [ 11, 116, 107]]], dtype=uint8)]"
Image_983.jpg,324,269,94,87,800,600,418,356,94,daskShared_local/images/Image_983.jpg,983,"[array([[[  1, 158, 255],
        [  1, 158, 255],
        [  1, 158, 254],
        ...,
        [  1, 162, 253],
        [  1, 162, 253],
        [  1, 162, 253]],

       [[  1, 158, 255],
        [  1, 158, 255],
        [  1, 158, 254],
        ...,
        [  1, 162, 253],
        [  1, 162, 253],
        [  1, 162, 253]],

       [[  1, 158, 255],
        [  1, 158, 255],
        [  1, 158, 255],
        ...,
        [  1, 162, 253],
        [  1, 162, 253],
        [  1, 162, 253]],

       ...,

       [[107, 157, 158],
        [104, 154, 156],
        [131, 181, 176],
        ...,
        [ 24,  28,  31],
        [ 19,  23,  24],
        [ 19,  23,  25]],

       [[102, 151, 155],
        [ 99, 148, 152],
        [127, 175, 174],
        ...,
        [ 24,  28,  30],
        [ 18,  22,  23],
        [ 19,  23,  24]],

       [[102, 152, 155],
        [ 99, 149, 153],
        [128, 176, 174],
        ...,
        [ 24,  28,  30],
        [ 18,  22,  23],
        [ 19,  23,  24]]], dtype=uint8)]"
Image_984.jpg,290,225,334,301,1000,664,624,526,334,daskShared_local/images/Image_984.jpg,984,"[array([[[188, 192, 195],
        [189, 193, 196],
        [190, 194, 197],
        ...,
        [177, 165, 159],
        [183, 165, 156],
        [162, 142, 131]],

       [[189, 193, 196],
        [190, 194, 197],
        [191, 195, 198],
        ...,
        [159, 148, 143],
        [176, 158, 154],
        [175, 156, 150]],

       [[188, 192, 195],
        [188, 192, 195],
        [189, 193, 196],
        ...,
        [155, 143, 141],
        [157, 143, 141],
        [176, 159, 159]],

       ...,

       [[174, 168, 160],
        [164, 158, 151],
        [157, 150, 143],
        ...,
        [181, 167, 154],
        [181, 167, 155],
        [182, 168, 155]],

       [[175, 171, 168],
        [173, 169, 166],
        [166, 163, 158],
        ...,
        [183, 169, 156],
        [184, 170, 159],
        [182, 168, 157]],

       [[194, 193, 193],
        [192, 192, 191],
        [187, 187, 185],
        ...,
        [175, 161, 150],
        [179, 165, 154],
        [184, 170, 161]]], dtype=uint8)]"
Image_985.jpg,315,150,176,193,1200,735,491,343,193,daskShared_local/images/Image_985.jpg,985,"[array([[[ 84, 160, 186],
        [ 84, 160, 186],
        [ 85, 161, 187],
        ...,
        [ 84,  73,  79],
        [ 81,  71,  80],
        [ 72,  66,  76]],

       [[ 95, 169, 194],
        [ 96, 171, 196],
        [ 94, 168, 193],
        ...,
        [109,  89,  96],
        [106,  90,  98],
        [ 90,  78,  88]],

       [[107, 179, 203],
        [105, 178, 202],
        [105, 177, 201],
        ...,
        [ 84,  65,  71],
        [102,  86,  96],
        [ 94,  82,  92]],

       ...,

       [[143, 182, 181],
        [144, 179, 181],
        [143, 176, 181],
        ...,
        [ 42,  21,  23],
        [ 42,  20,  21],
        [ 83,  57,  57]],

       [[142, 177, 183],
        [141, 174, 181],
        [142, 170, 181],
        ...,
        [ 80,  52,  48],
        [ 63,  35,  32],
        [ 55,  27,  24]],

       [[142, 176, 186],
        [141, 173, 184],
        [142, 170, 182],
        ...,
        [ 68,  36,  25],
        [ 48,  18,  10],
        [ 36,   7,   3]]], dtype=uint8)]"
Image_986.jpg,332,225,902,644,1500,1125,1234,869,902,daskShared_local/images/Image_986.jpg,986,"[array([[[ 96, 171, 172],
        [ 97, 171, 171],
        [ 97, 170, 171],
        ...,
        [117, 142, 150],
        [119, 140, 149],
        [119, 140, 144]],

       [[ 96, 170, 172],
        [ 97, 170, 172],
        [ 97, 170, 171],
        ...,
        [118, 140, 147],
        [119, 138, 148],
        [118, 138, 144]],

       [[ 96, 171, 169],
        [ 96, 171, 168],
        [ 95, 171, 169],
        ...,
        [120, 141, 147],
        [121, 139, 150],
        [121, 138, 146]],

       ...,

       [[ 97, 186, 232],
        [ 99, 185, 230],
        [ 96, 183, 226],
        ...,
        [111, 142, 140],
        [110, 139, 138],
        [117, 136, 129]],

       [[ 98, 189, 235],
        [ 99, 187, 233],
        [ 99, 184, 229],
        ...,
        [112, 143, 143],
        [108, 135, 137],
        [115, 133, 124]],

       [[101, 192, 239],
        [101, 190, 236],
        [101, 186, 232],
        ...,
        [114, 145, 144],
        [106, 134, 133],
        [111, 131, 122]]], dtype=uint8)]"
Image_987.jpg,194,425,46,49,1024,683,240,474,49,daskShared_local/images/Image_987.jpg,987,"[array([[[ 87,  95,  41],
        [ 83,  92,  37],
        [ 83,  92,  36],
        ...,
        [  2, 191, 197],
        [  2, 191, 197],
        [  2, 191, 197]],

       [[ 91,  97,  40],
        [ 88,  95,  37],
        [ 88,  95,  37],
        ...,
        [  2, 191, 197],
        [  2, 191, 197],
        [  2, 191, 197]],

       [[ 91,  97,  40],
        [ 88,  95,  37],
        [ 88,  95,  37],
        ...,
        [  2, 191, 197],
        [  2, 191, 197],
        [  2, 191, 197]],

       ...,

       [[ 86, 158, 124],
        [ 84, 156, 120],
        [ 84, 156, 120],
        ...,
        [191, 214, 162],
        [191, 214, 162],
        [192, 215, 165]],

       [[ 86, 158, 123],
        [ 84, 156, 120],
        [ 84, 156, 119],
        ...,
        [191, 214, 162],
        [191, 214, 162],
        [192, 215, 164]],

       [[ 85, 150, 113],
        [ 84, 148, 109],
        [ 84, 148, 109],
        ...,
        [189, 210, 151],
        [189, 210, 151],
        [190, 210, 153]]], dtype=uint8)]"
Image_988.jpg,1026,1453,1144,823,4613,2968,2170,2276,1144,daskShared_local/images/Image_988.jpg,988,"[array([[[132, 155, 158],
        [137, 162, 165],
        [140, 168, 169],
        ...,
        [ 35,  30,  34],
        [ 48,  42,  48],
        [ 56,  50,  51]],

       [[128, 158, 159],
        [137, 165, 168],
        [148, 172, 175],
        ...,
        [ 40,  35,  41],
        [ 48,  42,  48],
        [ 53,  47,  50]],

       [[127, 157, 158],
        [136, 165, 167],
        [150, 174, 177],
        ...,
        [ 39,  35,  40],
        [ 41,  37,  42],
        [ 45,  40,  43]],

       ...,

       [[ 52,  54,  55],
        [ 49,  52,  52],
        [ 60,  67,  66],
        ...,
        [125, 116, 102],
        [105,  98,  87],
        [ 88,  81,  69]],

       [[ 56,  61,  62],
        [ 58,  63,  64],
        [ 60,  64,  65],
        ...,
        [155, 141, 124],
        [127, 121, 106],
        [122, 122, 108]],

       [[ 58,  64,  66],
        [ 65,  78,  77],
        [ 68,  79,  77],
        ...,
        [150, 143, 129],
        [124, 116, 102],
        [106, 102,  90]]], dtype=uint8)]"
Image_989.jpg,411,349,312,255,1536,1024,723,604,312,daskShared_local/images/Image_989.jpg,989,"[array([[[ 10, 142, 242],
        [ 10, 143, 242],
        [  9, 143, 242],
        ...,
        [ 14, 175, 247],
        [ 20, 189, 254],
        [ 16, 184, 249]],

       [[ 15, 147, 247],
        [ 15, 147, 246],
        [ 16, 148, 246],
        ...,
        [ 13, 175, 247],
        [ 14, 183, 248],
        [ 11, 177, 243]],

       [[ 17, 146, 247],
        [ 17, 148, 247],
        [ 18, 150, 248],
        ...,
        [ 12, 174, 247],
        [ 16, 184, 249],
        [ 16, 181, 247]],

       ...,

       [[ 10,  60, 207],
        [ 10,  60, 207],
        [ 10,  60, 207],
        ...,
        [ 20, 103, 111],
        [ 20, 101, 111],
        [ 29,  92, 103]],

       [[  9,  59, 206],
        [  9,  59, 206],
        [  9,  59, 206],
        ...,
        [ 17,  82,  85],
        [  9,  51,  47],
        [ 15,  57,  53]],

       [[  9,  60, 205],
        [  9,  60, 205],
        [  9,  60, 205],
        ...,
        [ 25,  54,  49],
        [ 45,  48,  43],
        [ 18,  39,  27]]], dtype=uint8)]"
Image_99.jpg,739,260,377,308,1200,906,1116,568,377,daskShared_local/images/Image_99.jpg,99,"[array([[[144, 135, 144],
        [164, 153, 160],
        [182, 171, 177],
        ...,
        [ 16,  49,  70],
        [ 12,  45,  66],
        [ 14,  48,  69]],

       [[179, 168, 174],
        [184, 172, 177],
        [189, 177, 182],
        ...,
        [ 16,  47,  69],
        [ 16,  48,  69],
        [ 15,  50,  70]],

       [[171, 158, 160],
        [181, 167, 171],
        [189, 174, 180],
        ...,
        [ 18,  50,  73],
        [ 17,  48,  71],
        [ 11,  45,  67]],

       ...,

       [[ 58,  90, 101],
        [ 69, 105, 114],
        [ 70,  98, 108],
        ...,
        [ 19,  53,  73],
        [ 29,  56,  74],
        [ 41,  69,  83]],

       [[ 64,  93, 106],
        [ 79, 109, 118],
        [ 96, 118, 126],
        ...,
        [ 17,  50,  70],
        [ 22,  50,  68],
        [ 31,  55,  71]],

       [[ 57,  83,  97],
        [ 78, 100, 111],
        [136, 153, 161],
        ...,
        [ 19,  51,  72],
        [ 23,  50,  69],
        [ 32,  54,  72]]], dtype=uint8)]"
Image_990.jpg,606,219,398,447,1600,1070,1004,666,447,daskShared_local/images/Image_990.jpg,990,"[array([[[ 22,  75, 145],
        [ 22,  75, 145],
        [ 22,  75, 145],
        ...,
        [ 28,  69, 133],
        [ 30,  68, 133],
        [ 30,  68, 133]],

       [[ 22,  75, 145],
        [ 22,  75, 145],
        [ 22,  75, 145],
        ...,
        [ 28,  69, 133],
        [ 30,  68, 133],
        [ 30,  68, 133]],

       [[ 19,  76, 145],
        [ 20,  76, 145],
        [ 23,  75, 145],
        ...,
        [ 28,  69, 133],
        [ 28,  69, 133],
        [ 28,  69, 133]],

       ...,

       [[199, 166, 127],
        [190, 161, 119],
        [157, 131,  97],
        ...,
        [225, 184, 144],
        [241, 215, 196],
        [251, 230, 220]],

       [[183, 149, 115],
        [199, 165, 120],
        [220, 186, 136],
        ...,
        [217, 176, 131],
        [239, 201, 178],
        [230, 196, 176]],

       [[147, 111,  73],
        [180, 142,  91],
        [224, 186, 124],
        ...,
        [242, 206, 159],
        [245, 203, 169],
        [237, 197, 163]]], dtype=uint8)]"
Image_991.jpg,294,165,225,203,1000,664,519,368,225,daskShared_local/images/Image_991.jpg,991,"[array([[[  1,  80, 146],
        [  1,  80, 146],
        [  0,  81, 148],
        ...,
        [  0,  99, 170],
        [  0, 100, 170],
        [  0, 100, 170]],

       [[  1,  80, 147],
        [  1,  80, 147],
        [  1,  81, 147],
        ...,
        [  0, 101, 168],
        [  1,  99, 169],
        [  0,  98, 170]],

       [[  1,  80, 148],
        [  1,  80, 147],
        [  0,  79, 147],
        ...,
        [  0, 100, 168],
        [  0,  99, 169],
        [  1,  98, 171]],

       ...,

       [[ 36,  50,  39],
        [ 33,  41,  34],
        [ 33,  38,  33],
        ...,
        [201, 198, 172],
        [188, 182, 157],
        [163, 137, 103]],

       [[ 37,  44,  37],
        [ 38,  42,  35],
        [ 41,  42,  37],
        ...,
        [184, 171, 147],
        [165, 138, 104],
        [174, 148, 103]],

       [[ 32,  37,  33],
        [ 42,  47,  42],
        [ 48,  52,  45],
        ...,
        [172, 148, 118],
        [179, 152, 108],
        [204, 189, 153]]], dtype=uint8)]"
Image_992.jpg,399,136,217,191,869,574,616,327,217,daskShared_local/images/Image_992.jpg,992,"[array([[[ 81, 176, 244],
        [ 85, 174, 246],
        [ 67, 168, 239],
        ...,
        [ 68, 167, 242],
        [ 74, 164, 240],
        [ 79, 162, 240]],

       [[ 69, 172, 241],
        [ 81, 167, 240],
        [ 75, 170, 240],
        ...,
        [ 82, 165, 243],
        [ 84, 163, 242],
        [ 85, 162, 241]],

       [[ 64, 165, 234],
        [ 77, 166, 240],
        [ 77, 172, 241],
        ...,
        [ 86, 163, 244],
        [ 85, 163, 244],
        [ 84, 164, 243]],

       ...,

       [[ 16,  69,  49],
        [  2,  55,  31],
        [  1,  55,  30],
        ...,
        [  0, 109, 181],
        [  0, 109, 181],
        [  0, 109, 181]],

       [[  7,  51,  36],
        [  2,  50,  33],
        [ 13,  60,  43],
        ...,
        [  0, 108, 181],
        [  0, 108, 181],
        [  0, 108, 181]],

       [[  8,  27,  20],
        [  5,  47,  37],
        [ 24,  59,  51],
        ...,
        [  0, 108, 181],
        [  0, 108, 181],
        [  0, 108, 181]]], dtype=uint8)]"
Image_993.jpg,455,234,159,163,900,586,614,397,163,daskShared_local/images/Image_993.jpg,993,"[array([[[ 89, 194, 219],
        [ 66, 179, 207],
        [ 44, 165, 194],
        ...,
        [ 99, 203, 227],
        [100, 202, 227],
        [100, 202, 227]],

       [[158, 221, 245],
        [149, 214, 241],
        [140, 207, 237],
        ...,
        [ 98, 202, 227],
        [ 98, 201, 226],
        [ 98, 201, 226]],

       [[188, 224, 241],
        [190, 223, 243],
        [191, 223, 245],
        ...,
        [ 95, 201, 227],
        [ 95, 201, 227],
        [ 96, 201, 227]],

       ...,

       [[  0,  53,  46],
        [  0,  57,  52],
        [  4,  56,  57],
        ...,
        [  1, 163, 209],
        [  1, 163, 209],
        [  1, 163, 209]],

       [[  4,  62,  54],
        [  1,  65,  58],
        [  5,  58,  58],
        ...,
        [  1, 163, 209],
        [  1, 163, 209],
        [  1, 163, 209]],

       [[ 15,  78,  70],
        [  4,  74,  67],
        [  1,  57,  56],
        ...,
        [  1, 163, 209],
        [  1, 163, 209],
        [  1, 163, 209]]], dtype=uint8)]"
Image_994.jpg,417,132,235,239,1024,686,652,371,239,daskShared_local/images/Image_994.jpg,994,"[array([[[ 36, 190, 240],
        [ 38, 190, 240],
        [ 37, 189, 239],
        ...,
        [  1, 159, 220],
        [  1, 159, 220],
        [  1, 159, 220]],

       [[ 34, 187, 237],
        [ 38, 190, 240],
        [ 37, 189, 239],
        ...,
        [  2, 158, 219],
        [  2, 158, 219],
        [  2, 158, 219]],

       [[ 34, 187, 237],
        [ 40, 192, 242],
        [ 39, 191, 241],
        ...,
        [  2, 158, 219],
        [  2, 158, 219],
        [  2, 158, 219]],

       ...,

       [[188, 158, 145],
        [192, 175, 168],
        [218, 203, 199],
        ...,
        [  2, 114, 181],
        [  2, 114, 182],
        [  3, 114, 182]],

       [[206, 184, 174],
        [198, 171, 162],
        [210, 187, 180],
        ...,
        [  1, 114, 180],
        [  1, 114, 180],
        [  2, 115, 181]],

       [[219, 200, 187],
        [207, 182, 175],
        [208, 187, 181],
        ...,
        [  3, 116, 182],
        [  3, 116, 182],
        [  3, 116, 182]]], dtype=uint8)]"
Image_995.jpg,446,219,178,192,1200,630,624,411,192,daskShared_local/images/Image_995.jpg,995,"[array([[[ 25,  98, 167],
        [ 22,  95, 164],
        [ 25,  98, 167],
        ...,
        [ 21,  50,  50],
        [ 29,  54,  55],
        [ 41,  62,  67]],

       [[ 27, 100, 169],
        [ 29, 102, 171],
        [ 28, 101, 170],
        ...,
        [ 21,  51,  51],
        [ 24,  48,  50],
        [ 33,  52,  58]],

       [[ 29, 102, 171],
        [ 31, 104, 173],
        [ 29, 104, 172],
        ...,
        [ 28,  57,  55],
        [ 26,  47,  50],
        [ 22,  39,  46]],

       ...,

       [[ 40,  92, 113],
        [ 23,  74,  95],
        [ 30,  77, 100],
        ...,
        [ 20,  21,  23],
        [ 15,  19,  20],
        [ 16,  20,  21]],

       [[ 35,  87, 106],
        [ 23,  74,  95],
        [ 29,  77,  99],
        ...,
        [ 23,  27,  28],
        [ 23,  30,  29],
        [ 21,  27,  27]],

       [[ 49, 100, 119],
        [ 28,  79,  98],
        [ 32,  80, 102],
        ...,
        [ 32,  38,  36],
        [ 36,  45,  42],
        [ 30,  41,  37]]], dtype=uint8)]"
Image_996.jpg,1851,598,1251,1202,4752,3168,3102,1800,1251,daskShared_local/images/Image_996.jpg,996,"[array([[[ 58,  68,  75],
        [ 60,  72,  75],
        [ 64,  75,  77],
        ...,
        [ 50, 124, 149],
        [ 49, 123, 150],
        [ 48, 121, 151]],

       [[ 56,  64,  71],
        [ 58,  67,  69],
        [ 61,  70,  68],
        ...,
        [ 52, 126, 150],
        [ 53, 125, 150],
        [ 52, 124, 151]],

       [[ 62,  72,  72],
        [ 61,  71,  67],
        [ 61,  69,  61],
        ...,
        [ 54, 127, 150],
        [ 55, 127, 151],
        [ 53, 126, 150]],

       ...,

       [[ 50, 134, 153],
        [ 52, 134, 155],
        [ 53, 135, 155],
        ...,
        [150, 135,  99],
        [192, 187, 143],
        [202, 207, 173]],

       [[ 56, 136, 151],
        [ 56, 138, 153],
        [ 59, 140, 155],
        ...,
        [194, 189, 153],
        [199, 198, 172],
        [184, 183, 162]],

       [[ 56, 131, 141],
        [ 56, 130, 142],
        [ 58, 132, 145],
        ...,
        [203, 203, 178],
        [193, 190, 167],
        [177, 171, 151]]], dtype=uint8)]"
Image_997.jpg,724,433,433,357,2119,1414,1157,790,433,daskShared_local/images/Image_997.jpg,997,"[array([[[ 91, 141, 174],
        [ 89, 142, 174],
        [ 94, 147, 179],
        ...,
        [ 87, 152, 181],
        [ 83, 148, 178],
        [ 81, 146, 176]],

       [[ 91, 141, 174],
        [ 89, 142, 174],
        [ 93, 146, 178],
        ...,
        [ 93, 158, 186],
        [ 86, 151, 181],
        [ 82, 147, 177]],

       [[ 88, 139, 170],
        [ 87, 138, 170],
        [ 91, 142, 174],
        ...,
        [ 96, 161, 191],
        [ 87, 153, 185],
        [ 84, 150, 181]],

       ...,

       [[ 84, 176, 201],
        [ 84, 176, 201],
        [ 86, 178, 203],
        ...,
        [ 45, 125, 132],
        [118, 140, 137],
        [128, 135, 121]],

       [[ 83, 175, 200],
        [ 83, 175, 200],
        [ 86, 178, 203],
        ...,
        [ 76, 139, 143],
        [118, 138, 133],
        [135, 146, 149]],

       [[ 81, 175, 200],
        [ 82, 175, 200],
        [ 84, 178, 203],
        ...,
        [104, 162, 170],
        [119, 155, 156],
        [122, 153, 171]]], dtype=uint8)]"
Image_998.png,239,30,85,88,589,295,324,118,88,daskShared_local/images/Image_998.png,998,"[array([[[  0, 169, 193],
        [  0, 169, 194],
        [  0, 168, 192],
        ...,
        [  0, 167, 186],
        [  0, 169, 187],
        [  0, 168, 187]],

       [[  0, 168, 193],
        [  0, 168, 193],
        [  0, 167, 192],
        ...,
        [  0, 167, 185],
        [  0, 168, 186],
        [  0, 168, 186]],

       [[  0, 171, 194],
        [  0, 171, 195],
        [  0, 170, 193],
        ...,
        [  0, 168, 190],
        [  0, 171, 192],
        [  0, 170, 191]],

       ...,

       [[ 59,  33,  31],
        [ 62,  35,  32],
        [ 52,  28,  30],
        ...,
        [116,  82,  82],
        [150, 110, 108],
        [142, 103, 101]],

       [[ 52,  28,  30],
        [ 55,  30,  30],
        [ 45,  24,  29],
        ...,
        [168, 142, 142],
        [194, 166, 167],
        [188, 160, 161]],

       [[ 54,  30,  30],
        [ 57,  31,  31],
        [ 47,  25,  29],
        ...,
        [155, 127, 127],
        [183, 152, 152],
        [176, 146, 146]]], dtype=uint8)]"
Image_999.jpeg,635,145,261,256,1200,800,896,401,261,daskShared_local/images/Image_999.jpeg,999,"[array([[[167, 214, 223],
        [164, 211, 220],
        [166, 213, 224],
        ...,
        [179, 213, 230],
        [177, 212, 229],
        [175, 210, 227]],

       [[163, 213, 217],
        [165, 215, 220],
        [168, 219, 223],
        ...,
        [175, 215, 232],
        [171, 213, 229],
        [170, 213, 229]],

       [[167, 215, 221],
        [168, 216, 222],
        [169, 216, 222],
        ...,
        [173, 212, 229],
        [170, 213, 229],
        [171, 214, 230]],

       ...,

       [[215, 170, 130],
        [135,  84,  87],
        [ 85,  36,  27],
        ...,
        [196, 152,  56],
        [170, 125,  34],
        [187, 141,  55]],

       [[188, 151,  80],
        [109,  67,  42],
        [ 83,  42,   0],
        ...,
        [194, 155,  59],
        [173, 132,  44],
        [178, 137,  53]],

       [[128,  96,  10],
        [ 74,  38,   4],
        [120,  88,  13],
        ...,
        [157, 126,  35],
        [147, 115,  31],
        [144, 112,  31]]], dtype=uint8)]"
